{
	"nom": "Mer d'Ibukuro",
	"tileset": "Ventre",
	"largeur": 20,
	"hauteur": 15,
	"fondSonore": {
		"nomFichierSonore": "008-Wave01.ogg",
		"volume": 1.00,
		"tempo": 1.50
	},
	"couche0": [
	[-008,-008,-008,-008,-008,-008,-008,-008,-008,-008,-008,-008,-008,-008,-008,-008,-008,-008,-008,-008],
	[-008,-008,-008,-008,-008,-008,-008,-008,-008,-008,-008,-008,-008,-008,-008,-008,-008,-008,-008,-008],
	[-008,-008,-008,-008,-008,-008,-008,-008,-008,-008,-008,-008,-008,-008,-008,-008,-008,-008,-008,-008],
	[-008,-008,-008,-008,-008,-008,-008,-008,-008,-008,-008,-008,-008,-008,-008,-008,-008,-008,-008,-008],
	[-008,-008,-008,-008,-008,-008,-008,-008,-008,-008,-008,-008,-008,-008,-008,-008,-008,-008,-008,-008],
	[-008,-008,-008,-008,-008,-008,-008,-008,-008,-008,-008,-008,-008,-008,-008,-008,-008,-008,-008,-008],
	[-008,-008,-008,-008,-008,-008,-008,-008,-008,-008,-008,-008,-008,-008,-008,-008,-008,-008,-008,-008],
	[-008,-008,-008,-008,-008,-008,-008,-008,-008,-008,-008,-008,-008,-008,-008,-008,-008,-008,-008,-008],
	[-008,-008,-008,-008,-008,-008,-008,-008,-008,-008,-008,-008,-008,-008,-008,-008,-008,-008,-008,-008],
	[-008,-008,-008,-008,-008,-008,-008,-008,-008,-008,-008,-008,-008,-008,-008,-008,-008,-008,-008,-008],
	[-008,-008,-008,-008,-008,-008,-008,-008,-008,-008,-008,-008,-008,-008,-008,-008,-008,-008,-008,-008],
	[-008,-008,-008,-008,-008,-008,-008,-008,-008,-008,-008,-008,-008,-008,-008,-008,-008,-008,-008,-008],
	[-008,-008,-008,-008,-008,-008,-008,-008,-008,-008,-008,-008,-008,-008,-008,-008,-008,-008,-008,-008],
	[-008,-008,-008,-008,-008,-008,-008,-008,-008,-008,-008,-008,-008,-008,-008,-008,-008,-008,-008,-008],
	[-008,-008,-008,-008,-008,-008,-008,-008,-008,-008,-008,-008,-008,-008,-008,-008,-008,-008,-008,-008]
	],
	"couche1": [
	[-001,-001,-001,-001,-001,-001,-001,-001,-001,-001,-001,-001,-001,-001,-001,-001,-001,-001,-001,-001],
	[-001,-001,-001,-001,-001,-001,-001,-001,-001,-001,-001,-001,-001,-001,-001,-001,-001,-001,-001,-001],
	[-001,-001,-001,-001,-001,-001,-001,-001,-001,-001,-001,-001,-001,-001,-001,-001,-001,-001,-001,-001],
	[-001,-001,-001,-001,-001,-001,-001,-001,-001,-001,-001,-001,-001,-001,-001,-001,-001,-001,-001,-001],
	[-001,-001,-001,-001,-001,-001,-001,-001,-001,-001,-001,-001,-001,-001,-001,-001,-001,-001,-001,-001],
	[-001,-001,-001,-001,-001,-001,-001,-001,-001,-001,-001,-001,-001,-001,-001,-001,-001,-001,-001,-001],
	[-001,-001,-001,-001,-001,-001,-001,-001,0120,0121,0122,-001,-001,-001,-001,-001,-001,-001,-001,-001],
	[-001,-001,-001,-001,-001,-001,-001,-001,0128,0129,0130,-001,-001,-001,-001,-001,-001,-001,-001,-001],
	[-001,-001,-001,-001,-001,-001,-001,-001,0136,0137,0138,-001,-001,-001,-001,-001,-001,-001,-001,-001],
	[-001,-001,-001,-001,-001,-001,-001,-001,-001,-001,-001,-001,-001,-001,-001,-001,-001,-001,-001,-001],
	[-001,-001,-001,-001,-001,-001,-001,-001,-001,-001,-001,-001,-001,-001,-001,-001,-001,-001,-001,-001],
	[-001,-001,-001,-001,-001,-001,-001,-001,-001,-001,-001,-001,-001,-001,-001,-001,-001,-001,-001,-001],
	[-001,-001,-001,-001,-001,-001,-001,-001,-001,-001,-001,-001,-001,-001,-001,-001,-001,-001,-001,-001],
	[-001,-001,-001,-001,-001,-001,-001,-001,-001,-001,-001,-001,-001,-001,-001,-001,-001,-001,-001,-001],
	[-001,-001,-001,-001,-001,-001,-001,-001,-001,-001,-001,-001,-001,-001,-001,-001,-001,-001,-001,-001]
	],
	"couche2": [
	[-001,-001,-001,-001,-001,-001,-001,-001,-001,-001,-001,-001,-001,-001,-001,-001,-001,-001,-001,-001],
	[-001,-001,-001,-001,-001,-001,-001,-001,-001,-001,-001,-001,-001,-001,-001,-001,-001,-001,-001,-001],
	[-001,-001,-001,-001,-001,-001,-001,-001,-001,-001,-001,-001,-001,-001,-001,-001,-001,-001,-001,-001],
	[-001,-001,-001,-001,-001,-001,-001,-001,-001,-001,-001,-001,-001,-001,-001,-001,-001,-001,-001,-001],
	[-001,-001,-001,-001,-001,-001,-001,-001,-001,-001,-001,-001,-001,-001,-001,-001,-001,-001,-001,-001],
	[-001,-001,-001,-001,-001,-001,-001,-001,-001,-001,-001,-001,-001,-001,-001,-001,-001,-001,-001,-001],
	[-001,-001,-001,-001,-001,-001,-001,-001,-001,-001,-001,-001,-001,-001,-001,-001,-001,-001,-001,-001],
	[-001,-001,-001,-001,-001,-001,-001,-001,-001,-001,-001,-001,-001,-001,-001,-001,-001,-001,-001,-001],
	[-001,-001,-001,-001,-001,-001,-001,-001,-001,-001,-001,-001,-001,-001,-001,-001,-001,-001,-001,-001],
	[-001,-001,-001,-001,-001,-001,-001,-001,-001,-001,-001,-001,-001,-001,-001,-001,-001,-001,-001,-001],
	[-001,-001,-001,-001,-001,-001,-001,-001,-001,-001,-001,-001,-001,-001,-001,-001,-001,-001,-001,-001],
	[-001,-001,-001,-001,-001,-001,-001,-001,-001,-001,-001,-001,-001,-001,-001,-001,-001,-001,-001,-001],
	[-001,-001,-001,-001,-001,-001,-001,-001,-001,-001,-001,-001,-001,-001,-001,-001,-001,-001,-001,-001],
	[-001,-001,-001,-001,-001,-001,-001,-001,-001,-001,-001,-001,-001,-001,-001,-001,-001,-001,-001,-001],
	[-001,-001,-001,-001,-001,-001,-001,-001,-001,-001,-001,-001,-001,-001,-001,-001,-001,-001,-001,-001]
	],
	"events": [
	]
}
