{
	"nom": "Precipice aux patelles",
	"tileset": "Zone Enneigée",
	"largeur": 21,
	"hauteur": 35,
	"couche0": [
	[0168,0168,0168,0168,0168,0168,0168,0168,0168,0168,0168,0168,0168,0168,0168,0168,0168,0168,0168,0168,0168],
	[0168,0168,0168,0168,0168,0168,0168,0168,0168,0168,0168,0168,0168,0168,0168,0168,0168,0168,0168,0168,0168],
	[0168,0168,0168,0168,0168,0168,0168,0168,0168,0168,0168,0168,0168,0168,0168,0168,0168,0168,0168,0168,0168],
	[0168,0168,0168,0168,0168,0168,0168,0168,0168,0168,0168,0168,0168,0168,0168,0168,0168,0168,0168,0168,0168],
	[0168,0168,0168,0168,0168,0168,0168,0168,0168,0168,0168,0168,0168,0168,0168,0168,0168,0168,0168,0168,0168],
	[0168,0168,0169,0170,0170,0170,0170,0170,0170,0170,0170,0170,0170,0170,0170,0170,0170,0170,0170,0170,0170],
	[0168,0168,0184,0009,0010,0010,0010,0010,0010,0010,0010,0010,0010,0010,0010,0010,0010,0010,0010,0010,0010],
	[0168,0168,0184,0024,0009,0010,0010,0010,0010,0010,0010,0010,0010,0010,0010,0010,0010,0010,0010,0010,0010],
	[0168,0168,0184,0024,0024,0009,0010,0010,0010,0010,0010,0010,0010,0010,0010,0010,0010,0010,0010,0010,0010],
	[0168,0168,0184,0024,0024,0024,0000,0000,0189,0190,0002,0000,0000,0000,0000,0000,0000,0000,0000,0000,0000],
	[0168,0168,0184,0024,0024,0024,0189,0190,-006,-006,0000,0000,0001,0000,0000,0002,0000,0000,0000,0000,0000],
	[0168,0168,0184,0024,0024,0024,0000,-006,-006,-006,0000,-006,-006,0189,0190,0053,0058,0058,0058,0058,0058],
	[0168,0168,0184,0024,0024,0024,0000,-006,-006,-006,0000,-006,-006,0000,0053,0061,0000,0053,0058,0058,0058],
	[0168,0168,0184,0024,0024,0024,0000,-006,-006,-006,0000,-006,-006,0000,0030,0053,0058,0061,0189,0190,0053],
	[0168,0168,0184,0024,0024,0024,0000,-006,-006,-006,0000,-006,-006,0000,0030,0030,0053,0058,0058,0058,0061],
	[0168,0168,0184,0024,0024,0024,0000,-006,-006,-006,0000,-006,-006,0000,0030,0030,0030,0189,0190,0195,0202],
	[0168,0168,0184,0024,0024,0024,0000,-006,-006,-006,0000,-006,-006,0000,0030,0030,0030,0195,0202,0203,0168],
	[0169,0170,0177,0024,0024,0024,0000,-006,-006,-006,0000,-006,-006,0000,0030,0030,0030,0188,0168,0168,0168],
	[0177,0009,0010,0017,0024,0024,0000,-006,-006,-006,0000,-006,-006,0000,0030,0030,0030,0188,0168,0168,0168],
	[0010,0017,0009,0010,0017,0024,0000,-006,-006,-006,0000,-006,-006,0000,0030,0030,0030,0188,0168,0168,0168],
	[0010,0010,0017,0189,0190,0024,0000,-006,-006,-006,0000,-006,-006,0000,0030,0030,0030,0188,0168,0168,0168],
	[0010,0010,0011,0011,0011,0017,0189,0190,-006,-006,0000,-006,-006,0000,0030,0030,0030,0188,0168,0168,0168],
	[0000,0000,0000,0000,0000,0000,0002,0001,0000,0000,0001,0189,0190,0000,0030,0030,0030,0188,0168,0168,0168],
	[0000,0000,0000,0000,0000,0000,0000,0000,0000,0000,0000,0002,0189,0190,0030,0030,0030,0188,0168,0168,0168],
	[0059,0059,0059,0059,0059,0059,0059,0059,0059,0059,0059,0059,0059,0059,0061,0030,0030,0188,0168,0168,0168],
	[0059,0059,0059,0059,0059,0059,0059,0059,0059,0059,0059,0059,0059,0059,0059,0061,0030,0188,0168,0168,0168],
	[0059,0059,0059,0059,0059,0059,0059,0059,0059,0059,0059,0059,0059,0059,0059,0059,0061,0188,0168,0168,0168],
	[0189,0190,0000,0195,0202,0202,0202,0202,0202,0202,0202,0202,0202,0202,0202,0202,0202,0196,0168,0168,0168],
	[0202,0202,0202,0196,0168,0168,0168,0168,0168,0168,0168,0168,0168,0168,0168,0168,0168,0168,0168,0168,0168],
	[0168,0168,0168,0168,0168,0168,0168,0168,0168,0168,0168,0168,0168,0168,0168,0168,0168,0168,0168,0168,0168],
	[0168,0168,0168,0168,0168,0168,0168,0168,0168,0168,0168,0168,0168,0168,0168,0168,0168,0168,0168,0168,0168],
	[0168,0168,0168,0168,0168,0168,0168,0168,0168,0168,0168,0168,0168,0168,0168,0168,0168,0168,0168,0168,0168],
	[0168,0168,0168,0168,0168,0168,0168,0168,0168,0168,0168,0168,0168,0168,0168,0168,0168,0168,0168,0168,0168],
	[0168,0168,0168,0168,0168,0168,0168,0168,0168,0168,0168,0168,0168,0168,0168,0168,0168,0168,0168,0168,0168],
	[0168,0168,0168,0168,0168,0168,0168,0168,0168,0168,0168,0168,0168,0168,0168,0168,0168,0168,0168,0168,0168]
	],
	"couche1": [
	[-001,-001,-001,-001,-001,-001,-001,-001,-001,-001,-001,-001,-001,-001,-001,-001,-001,-001,-001,-001,-001],
	[-001,-001,-001,-001,-001,-001,-001,-001,-001,-001,-001,-001,-001,-001,-001,-001,-001,-001,-001,-001,-001],
	[-001,-001,-001,-001,-001,-001,-001,-001,-001,-001,-001,-001,-001,-001,-001,-001,-001,-001,-001,-001,-001],
	[-001,-001,-001,-001,-001,-001,-001,-001,-001,-001,-001,-001,-001,-001,-001,-001,-001,-001,-001,-001,-001],
	[-001,-001,-001,-001,-001,-001,-001,-001,-001,-001,-001,-001,-001,-001,-001,-001,-001,-001,-001,-001,-001],
	[-001,-001,-001,-001,-001,-001,-001,-001,-001,-001,-001,-001,-001,-001,-001,-001,-001,-001,-001,-001,-001],
	[-001,-001,-001,-001,-001,-001,-001,-001,-001,-001,-001,-001,-001,-001,-001,-001,-001,-001,-001,-001,-001],
	[-001,-001,-001,-001,-001,-001,-001,-001,-001,-001,-001,-001,-001,-001,-001,-001,-001,-001,-001,-001,-001],
	[-001,-001,-001,-001,-001,-001,-001,-001,0181,0182,-001,-001,-001,-001,-001,-001,-001,-001,-001,-001,-001],
	[-001,-001,-001,-001,-001,-001,0181,0182,-001,-001,-001,-001,-001,-001,-001,-001,-001,-001,-001,-001,-001],
	[-001,-001,-001,-001,-001,-001,-001,-001,-001,-001,-001,-001,-001,0181,0182,-001,-001,-001,-001,-001,-001],
	[-001,-001,-001,-001,-001,-001,-001,-001,-001,-001,-001,-001,-001,-001,-001,-001,-001,-001,-001,-001,-001],
	[-001,-001,-001,-001,-001,-001,-001,-001,-001,-001,-001,-001,-001,-001,-001,-001,-001,-001,0181,0182,-001],
	[-001,-001,-001,-001,-001,-001,-001,-001,-001,-001,-001,-001,-001,-001,-001,-001,-001,-001,-001,-001,-001],
	[-001,-001,-001,-001,-001,-001,-001,-001,-001,-001,-001,-001,-001,-001,-001,-001,-001,0181,0182,-001,-001],
	[-001,-001,-001,-001,-001,-001,-001,-001,-001,-001,-001,-001,-001,-001,-001,-001,-001,-001,-001,-001,-001],
	[-001,-001,-001,-001,-001,-001,-001,-001,-001,-001,-001,-001,-001,-001,-001,-001,-001,-001,-001,-001,-001],
	[-001,-001,-001,-001,-001,-001,-001,-001,-001,-001,-001,-001,-001,-001,-001,-001,-001,-001,-001,-001,-001],
	[-001,-001,-001,-001,-001,-001,-001,-001,-001,-001,-001,-001,-001,-001,-001,-001,-001,-001,-001,-001,-001],
	[-001,-001,-001,0181,0182,-001,-001,-001,-001,-001,-001,-001,-001,-001,-001,-001,-001,-001,-001,-001,-001],
	[-001,-001,-001,-001,-001,-001,0181,0182,-001,-001,-001,-001,-001,-001,-001,-001,-001,-001,-001,-001,-001],
	[-001,-001,-001,-001,-001,-001,-001,-001,-001,-001,-001,0181,0182,-001,-001,-001,-001,-001,-001,-001,-001],
	[-001,-001,-001,-001,-001,-001,-001,-001,-001,-001,-001,-001,0181,0182,-001,-001,-001,-001,-001,-001,-001],
	[-001,-001,-001,-001,-001,-001,-001,-001,-001,-001,-001,-001,-001,-001,-001,-001,-001,-001,-001,-001,-001],
	[-001,-001,-001,-001,-001,-001,-001,-001,-001,-001,-001,-001,-001,-001,-001,-001,-001,-001,-001,-001,-001],
	[-001,-001,-001,-001,-001,-001,-001,-001,-001,-001,-001,-001,-001,-001,-001,-001,-001,-001,-001,-001,-001],
	[0181,0182,-001,-001,-001,-001,-001,-001,-001,-001,-001,-001,-001,-001,-001,-001,-001,-001,-001,-001,-001],
	[-001,-001,-001,-001,-001,-001,-001,-001,-001,-001,-001,-001,-001,-001,-001,-001,-001,-001,-001,-001,-001],
	[-001,-001,-001,-001,-001,-001,-001,-001,-001,-001,-001,-001,-001,-001,-001,-001,-001,-001,-001,-001,-001],
	[-001,-001,-001,-001,-001,-001,-001,-001,-001,-001,-001,-001,-001,-001,-001,-001,-001,-001,-001,-001,-001],
	[-001,-001,-001,-001,-001,-001,-001,-001,-001,-001,-001,-001,-001,-001,-001,-001,-001,-001,-001,-001,-001],
	[-001,-001,-001,-001,-001,-001,-001,-001,-001,-001,-001,-001,-001,-001,-001,-001,-001,-001,-001,-001,-001],
	[-001,-001,-001,-001,-001,-001,-001,-001,-001,-001,-001,-001,-001,-001,-001,-001,-001,-001,-001,-001,-001],
	[-001,-001,-001,-001,-001,-001,-001,-001,-001,-001,-001,-001,-001,-001,-001,-001,-001,-001,-001,-001,-001],
	[-001,-001,-001,-001,-001,-001,-001,-001,-001,-001,-001,-001,-001,-001,-001,-001,-001,-001,-001,-001,-001]
	],
	"couche2": [
	[-001,-001,-001,-001,-001,-001,-001,-001,-001,-001,-001,-001,-001,-001,-001,-001,-001,-001,-001,-001,-001],
	[-001,-001,-001,-001,-001,-001,-001,-001,-001,-001,-001,-001,-001,-001,-001,-001,-001,-001,-001,-001,-001],
	[-001,-001,-001,-001,-001,-001,-001,-001,-001,-001,-001,-001,-001,-001,-001,-001,-001,-001,-001,-001,-001],
	[-001,-001,-001,-001,-001,-001,-001,-001,-001,-001,-001,-001,-001,-001,-001,-001,-001,-001,-001,-001,-001],
	[-001,-001,-001,-001,-001,-001,-001,-001,-001,-001,-001,-001,-001,-001,-001,-001,-001,-001,-001,-001,-001],
	[-001,-001,-001,-001,-001,-001,-001,-001,-001,-001,-001,-001,-001,-001,-001,-001,-001,-001,-001,-001,-001],
	[-001,-001,-001,-001,-001,-001,-001,-001,-001,-001,-001,-001,-001,-001,-001,-001,-001,-001,-001,-001,-001],
	[-001,-001,-001,-001,-001,-001,-001,-001,-001,-001,-001,-001,-001,-001,-001,-001,-001,-001,-001,-001,-001],
	[-001,-001,-001,-001,-001,-001,-001,-001,-001,-001,-001,-001,-001,-001,-001,-001,-001,-001,-001,-001,-001],
	[-001,-001,-001,-001,-001,-001,-001,-001,-001,0174,-001,-001,-001,-001,-001,-001,-001,-001,-001,-001,-001],
	[-001,-001,-001,-001,-001,-001,-001,-001,-001,-001,-001,-001,-001,0173,-001,-001,-001,-001,-001,-001,-001],
	[-001,-001,-001,-001,-001,-001,-001,-001,-001,-001,-001,-001,-001,-001,0174,-001,-001,-001,-001,-001,-001],
	[-001,-001,-001,-001,-001,-001,-001,-001,-001,-001,-001,-001,-001,-001,-001,-001,-001,-001,-001,-001,-001],
	[-001,-001,-001,-001,-001,-001,-001,-001,-001,-001,-001,-001,-001,-001,-001,-001,-001,-001,-001,-001,-001],
	[-001,-001,-001,-001,-001,-001,-001,-001,-001,-001,-001,-001,-001,-001,-001,-001,-001,-001,-001,-001,-001],
	[-001,-001,-001,-001,-001,-001,-001,-001,-001,-001,-001,-001,-001,-001,-001,-001,-001,-001,-001,-001,-001],
	[-001,-001,-001,-001,-001,-001,-001,-001,-001,-001,-001,-001,-001,-001,-001,-001,-001,-001,-001,-001,-001],
	[-001,-001,-001,-001,-001,-001,-001,-001,-001,-001,-001,-001,-001,-001,-001,-001,-001,-001,-001,-001,-001],
	[-001,-001,-001,-001,-001,-001,-001,-001,-001,-001,-001,-001,-001,-001,-001,-001,-001,-001,-001,-001,-001],
	[-001,-001,-001,-001,-001,-001,-001,-001,-001,-001,-001,-001,-001,-001,-001,-001,-001,-001,-001,-001,-001],
	[-001,-001,-001,-001,-001,-001,0173,-001,-001,-001,-001,-001,-001,-001,-001,-001,-001,-001,-001,-001,-001],
	[-001,-001,-001,-001,-001,-001,-001,0174,-001,-001,-001,0173,-001,-001,-001,-001,-001,-001,-001,-001,-001],
	[-001,-001,-001,-001,-001,-001,-001,-001,-001,-001,-001,-001,-001,-001,-001,-001,-001,-001,-001,-001,-001],
	[-001,-001,-001,-001,-001,-001,-001,-001,-001,-001,-001,-001,-001,-001,-001,-001,-001,-001,-001,-001,-001],
	[-001,-001,-001,-001,-001,-001,-001,-001,-001,-001,-001,-001,-001,-001,-001,-001,-001,-001,-001,-001,-001],
	[-001,-001,-001,-001,-001,-001,-001,-001,-001,-001,-001,-001,-001,-001,-001,-001,-001,-001,-001,-001,-001],
	[-001,-001,-001,-001,-001,-001,-001,-001,-001,-001,-001,-001,-001,-001,-001,-001,-001,-001,-001,-001,-001],
	[-001,-001,-001,-001,-001,-001,-001,-001,-001,-001,-001,-001,-001,-001,-001,-001,-001,-001,-001,-001,-001],
	[-001,-001,-001,-001,-001,-001,-001,-001,-001,-001,-001,-001,-001,-001,-001,-001,-001,-001,-001,-001,-001],
	[-001,-001,-001,-001,-001,-001,-001,-001,-001,-001,-001,-001,-001,-001,-001,-001,-001,-001,-001,-001,-001],
	[-001,-001,-001,-001,-001,-001,-001,-001,-001,-001,-001,-001,-001,-001,-001,-001,-001,-001,-001,-001,-001],
	[-001,-001,-001,-001,-001,-001,-001,-001,-001,-001,-001,-001,-001,-001,-001,-001,-001,-001,-001,-001,-001],
	[-001,-001,-001,-001,-001,-001,-001,-001,-001,-001,-001,-001,-001,-001,-001,-001,-001,-001,-001,-001,-001],
	[-001,-001,-001,-001,-001,-001,-001,-001,-001,-001,-001,-001,-001,-001,-001,-001,-001,-001,-001,-001,-001],
	[-001,-001,-001,-001,-001,-001,-001,-001,-001,-001,-001,-001,-001,-001,-001,-001,-001,-001,-001,-001,-001]
	],
	"events": [
	{
		"id": 5,
		"nom": "Clone[21][6]",
		"x": 13,
		"y": 17
	},
	{
		"id": 22,
		"nom": "Clone[21][6]",
		"x": 13,
		"y": 12
	},
	{
		"id": 6,
		"nom": "Clone[21][6]",
		"x": 13,
		"y": 16
	},
	{
		"id": 17,
		"nom": "Clone[21][6]",
		"x": 6,
		"y": 11
	},
	{
		"id": 18,
		"nom": "EV018",
		"x": 20,
		"y": 9,
		"pages": [
		{
			"conditions": [
			{
				"nom": "ArriveeAuContact"
			}
			],
			"commandes": [
			{
				"nom": "ChangerDeMap",
				"variable": false,
				"numeroNouvelleMap": 665,
				"xDebutHeros": 1,
				"yDebutHeros": 7
			}
			],
			"vitesse": "moderee",
			"frequence": "basse",
			"animeEnMouvement": true,
			"animeALArret": false,
			"directionFixe": false,
			"traversable": false,
			"auDessusDeTout": false
		}
		]
	},
	{
		"id": 2,
		"nom": "Clone[21][6]",
		"x": 13,
		"y": 20
	},
	{
		"id": 13,
		"nom": "Clone[21][6]",
		"x": 6,
		"y": 15
	},
	{
		"id": 24,
		"nom": "EV024",
		"x": 0,
		"y": 23,
		"pages": [
		{
			"conditions": [
			{
				"nom": "ArriveeAuContact"
			}
			],
			"commandes": [
			{
				"nom": "ChangerDeMap",
				"variable": false,
				"numeroNouvelleMap": 657,
				"xDebutHeros": 23,
				"yDebutHeros": 6
			}
			],
			"vitesse": "moderee",
			"frequence": "basse",
			"animeEnMouvement": true,
			"animeALArret": false,
			"directionFixe": false,
			"traversable": false,
			"auDessusDeTout": false
		}
		]
	},
	{
		"id": 19,
		"nom": "EV019",
		"x": 20,
		"y": 10,
		"pages": [
		{
			"conditions": [
			{
				"nom": "ArriveeAuContact"
			}
			],
			"commandes": [
			{
				"nom": "ChangerDeMap",
				"variable": false,
				"numeroNouvelleMap": 665,
				"xDebutHeros": 1,
				"yDebutHeros": 8
			}
			],
			"vitesse": "moderee",
			"frequence": "basse",
			"animeEnMouvement": true,
			"animeALArret": false,
			"directionFixe": false,
			"traversable": false,
			"auDessusDeTout": false
		}
		]
	},
	{
		"id": 14,
		"nom": "Clone[21][6]",
		"x": 6,
		"y": 14
	},
	{
		"id": 9,
		"nom": "Clone[21][6]",
		"x": 6,
		"y": 19
	},
	{
		"id": 20,
		"nom": "EV020",
		"x": 0,
		"y": 22,
		"pages": [
		{
			"conditions": [
			{
				"nom": "ArriveeAuContact"
			}
			],
			"commandes": [
			{
				"nom": "ChangerDeMap",
				"variable": false,
				"numeroNouvelleMap": 657,
				"xDebutHeros": 23,
				"yDebutHeros": 5
			}
			],
			"vitesse": "moderee",
			"frequence": "basse",
			"animeEnMouvement": true,
			"animeALArret": false,
			"directionFixe": false,
			"traversable": false,
			"auDessusDeTout": false
		}
		]
	},
	{
		"id": 10,
		"nom": "Clone[21][6]",
		"x": 6,
		"y": 18
	},
	{
		"id": 21,
		"nom": "Clone[21][6]",
		"x": 13,
		"y": 13
	}
	]
}
