{
	"nom": "Salle aux Ecailles",
	"tileset": "Ventre",
	"largeur": 25,
	"hauteur": 25,
	"fondSonore": {
		"nomFichierSonore": "InterieurDeLaBaleine.ogg",
		"volume": 0.80,
		"tempo": 1.00
	},
	"couche0": [
	[0809,0809,0809,0809,0809,0809,0809,0809,0809,0809,0809,0809,0809,0809,0809,0809,0809,0809,0809,0809,0809,0809,0809,0809,0809],
	[0809,0809,0809,0809,0809,0809,0809,0809,0809,0809,0809,0809,0809,0809,0809,0809,0809,0809,0809,0809,0809,0809,0809,0809,0809],
	[0809,0809,0809,0809,0809,0809,0809,0809,0809,0809,0809,0809,0809,0809,0809,0809,0809,0809,0809,0809,0809,0809,0809,0809,0809],
	[0809,0809,0809,0809,0809,0809,0809,0809,0809,0809,0809,0809,0809,0809,0809,0809,0809,0809,0809,0809,0809,0809,0809,0809,0809],
	[0809,0809,0809,0809,0809,0809,0809,0809,0809,0809,0809,0809,0809,0809,0809,0809,0809,0809,0809,0809,0809,0809,0809,0809,0809],
	[0809,0809,0809,0809,0809,0809,0809,0809,0809,0809,0809,0809,0809,0809,0809,0809,0809,0809,0809,0809,0809,0809,0809,0809,0809],
	[0809,0809,0809,0809,0809,0809,0809,0809,0809,0809,0809,0809,0809,0809,0809,0809,0809,0809,0809,0809,0809,0809,0809,0809,0809],
	[0809,0809,0809,0809,0809,0809,0800,0801,0801,0801,0801,0801,0801,0801,0801,0801,0801,0801,0802,0809,0809,0809,0809,0809,0809],
	[0809,0809,0809,0809,0809,0809,0808,0016,0010,0010,0010,0010,0010,0010,0010,0010,0010,0013,0810,0809,0809,0809,0809,0809,0809],
	[0809,0809,0809,0809,0809,0809,0808,0024,0001,0001,0001,0001,0001,0001,0001,0008,0052,0030,0810,0809,0809,0809,0809,0809,0809],
	[0809,0809,0809,0809,0809,0809,0808,0024,0001,0001,0001,-007,-007,-007,-007,-007,0001,0030,0810,0809,0809,0809,0809,0809,0809],
	[0809,0809,0809,0809,0809,0809,0808,0024,0001,-007,-007,-007,-007,-007,-007,-007,0001,0030,0810,0809,0809,0809,0809,0809,0809],
	[0809,0809,0809,0809,0809,0809,0808,0041,0001,-007,-007,-007,-007,-007,-007,-007,0001,0030,0810,0809,0809,0809,0809,0809,0809],
	[0809,0809,0809,0809,0809,0809,0808,0024,0001,-007,-007,-007,-007,-007,-007,-007,0001,0030,0810,0809,0809,0809,0809,0809,0809],
	[0809,0809,0809,0809,0809,0809,0808,0024,0001,0001,0001,-007,-007,-007,-007,-007,0001,0030,0810,0809,0809,0809,0809,0809,0809],
	[0809,0809,0809,0809,0809,0809,0808,0024,0008,0001,0001,0001,0001,0001,0001,0001,0001,0030,0810,0809,0809,0809,0809,0809,0809],
	[0809,0809,0809,0809,0809,0809,0808,0057,0058,0058,0058,0058,0058,0058,0058,0058,0058,0054,0810,0809,0809,0809,0809,0809,0809],
	[0809,0809,0809,0809,0809,0809,0816,0817,0817,0817,0817,0817,0817,0817,0817,0817,0817,0817,0818,0809,0809,0809,0809,0809,0809],
	[0809,0809,0809,0809,0809,0809,0809,0809,0809,0809,0809,0809,0809,0809,0809,0809,0809,0809,0809,0809,0809,0809,0809,0809,0809],
	[0809,0809,0809,0809,0809,0809,0809,0809,0809,0809,0809,0809,0809,0809,0809,0809,0809,0809,0809,0809,0809,0809,0809,0809,0809],
	[0809,0809,0809,0809,0809,0809,0809,0809,0809,0809,0809,0809,0809,0809,0809,0809,0809,0809,0809,0809,0809,0809,0809,0809,0809],
	[0809,0809,0809,0809,0809,0809,0809,0809,0809,0809,0809,0809,0809,0809,0809,0809,0809,0809,0809,0809,0809,0809,0809,0809,0809],
	[0809,0809,0809,0809,0809,0809,0809,0809,0809,0809,0809,0809,0809,0809,0809,0809,0809,0809,0809,0809,0809,0809,0809,0809,0809],
	[0809,0809,0809,0809,0809,0809,0809,0809,0809,0809,0809,0809,0809,0809,0809,0809,0809,0809,0809,0809,0809,0809,0809,0809,0809],
	[0809,0809,0809,0809,0809,0809,0809,0809,0809,0809,0809,0809,0809,0809,0809,0809,0809,0809,0809,0809,0809,0809,0809,0809,0809]
	],
	"couche1": [
	[-001,-001,-001,-001,-001,-001,-001,-001,-001,-001,-001,-001,-001,-001,-001,-001,-001,-001,-001,-001,-001,-001,-001,-001,-001],
	[-001,-001,-001,-001,-001,-001,-001,-001,-001,-001,-001,-001,-001,-001,-001,-001,-001,-001,-001,-001,-001,-001,-001,-001,-001],
	[-001,-001,-001,-001,-001,-001,-001,-001,-001,-001,-001,-001,-001,-001,-001,-001,-001,-001,-001,-001,-001,-001,-001,-001,-001],
	[-001,-001,-001,-001,-001,-001,-001,-001,-001,-001,-001,-001,-001,-001,-001,-001,-001,-001,-001,-001,-001,-001,-001,-001,-001],
	[-001,-001,-001,-001,-001,-001,-001,-001,-001,-001,-001,-001,-001,-001,-001,-001,-001,-001,-001,-001,-001,-001,-001,-001,-001],
	[-001,-001,-001,-001,-001,-001,-001,-001,-001,-001,-001,-001,-001,-001,-001,-001,-001,-001,-001,-001,-001,-001,-001,-001,-001],
	[-001,-001,-001,-001,-001,-001,-001,-001,-001,-001,-001,-001,-001,-001,-001,-001,-001,-001,-001,-001,-001,-001,-001,-001,-001],
	[-001,-001,-001,-001,-001,-001,-001,-001,-001,-001,-001,-001,-001,-001,-001,-001,-001,-001,-001,-001,-001,-001,-001,-001,-001],
	[-001,-001,-001,-001,-001,-001,-001,-001,-001,-001,-001,-001,-001,-001,-001,-001,0044,-001,-001,-001,-001,-001,-001,-001,-001],
	[-001,-001,-001,-001,-001,-001,-001,-001,-001,-001,-001,-001,-001,-001,-001,-001,-001,-001,-001,-001,-001,-001,-001,-001,-001],
	[-001,-001,-001,-001,-001,-001,-001,-001,-001,-001,-001,-001,-001,-001,-001,-001,-001,-001,-001,-001,-001,-001,-001,-001,-001],
	[-001,-001,-001,-001,-001,-001,-001,0019,-001,-001,-001,-001,-001,-001,-001,-001,-001,-001,-001,-001,-001,-001,-001,-001,-001],
	[-001,-001,-001,-001,-001,-001,-001,0033,-001,-001,-001,-001,-001,-001,-001,-001,-001,-001,-001,-001,-001,-001,-001,-001,-001],
	[-001,-001,-001,-001,-001,-001,-001,-001,-001,-001,-001,-001,-001,-001,-001,-001,-001,-001,-001,-001,-001,-001,-001,-001,-001],
	[-001,-001,-001,-001,-001,-001,-001,-001,-001,-001,-001,-001,-001,-001,-001,-001,-001,-001,-001,-001,-001,-001,-001,-001,-001],
	[-001,-001,-001,-001,-001,-001,-001,-001,-001,-001,-001,-001,-001,-001,-001,-001,-001,-001,-001,-001,-001,-001,-001,-001,-001],
	[-001,-001,-001,-001,-001,-001,-001,-001,-001,-001,-001,-001,-001,-001,-001,-001,-001,-001,-001,-001,-001,-001,-001,-001,-001],
	[-001,-001,-001,-001,-001,-001,-001,-001,-001,-001,-001,-001,-001,-001,-001,-001,-001,-001,-001,-001,-001,-001,-001,-001,-001],
	[-001,-001,-001,-001,-001,-001,-001,-001,-001,-001,-001,-001,-001,-001,-001,-001,-001,-001,-001,-001,-001,-001,-001,-001,-001],
	[-001,-001,-001,-001,-001,-001,-001,-001,-001,-001,-001,-001,-001,-001,-001,-001,-001,-001,-001,-001,-001,-001,-001,-001,-001],
	[-001,-001,-001,-001,-001,-001,-001,-001,-001,-001,-001,-001,-001,-001,-001,-001,-001,-001,-001,-001,-001,-001,-001,-001,-001],
	[-001,-001,-001,-001,-001,-001,-001,-001,-001,-001,-001,-001,-001,-001,-001,-001,-001,-001,-001,-001,-001,-001,-001,-001,-001],
	[-001,-001,-001,-001,-001,-001,-001,-001,-001,-001,-001,-001,-001,-001,-001,-001,-001,-001,-001,-001,-001,-001,-001,-001,-001],
	[-001,-001,-001,-001,-001,-001,-001,-001,-001,-001,-001,-001,-001,-001,-001,-001,-001,-001,-001,-001,-001,-001,-001,-001,-001],
	[-001,-001,-001,-001,-001,-001,-001,-001,-001,-001,-001,-001,-001,-001,-001,-001,-001,-001,-001,-001,-001,-001,-001,-001,-001]
	],
	"couche2": [
	[-001,-001,-001,-001,-001,-001,-001,-001,-001,-001,-001,-001,-001,-001,-001,-001,-001,-001,-001,-001,-001,-001,-001,-001,-001],
	[-001,-001,-001,-001,-001,-001,-001,-001,-001,-001,-001,-001,-001,-001,-001,-001,-001,-001,-001,-001,-001,-001,-001,-001,-001],
	[-001,-001,-001,-001,-001,-001,-001,-001,-001,-001,-001,-001,-001,-001,-001,-001,-001,-001,-001,-001,-001,-001,-001,-001,-001],
	[-001,-001,-001,-001,-001,-001,-001,-001,-001,-001,-001,-001,-001,-001,-001,-001,-001,-001,-001,-001,-001,-001,-001,-001,-001],
	[-001,-001,-001,-001,-001,-001,-001,-001,-001,-001,-001,-001,-001,-001,-001,-001,-001,-001,-001,-001,-001,-001,-001,-001,-001],
	[-001,-001,-001,-001,-001,-001,-001,-001,-001,-001,-001,-001,-001,-001,-001,-001,-001,-001,-001,-001,-001,-001,-001,-001,-001],
	[-001,-001,-001,-001,-001,-001,-001,-001,-001,-001,-001,-001,-001,-001,-001,-001,-001,-001,-001,-001,-001,-001,-001,-001,-001],
	[-001,-001,-001,-001,-001,-001,-001,-001,-001,-001,-001,-001,-001,-001,-001,-001,-001,-001,-001,-001,-001,-001,-001,-001,-001],
	[-001,-001,-001,-001,-001,-001,-001,-001,-001,-001,-001,-001,-001,-001,-001,-001,-001,-001,-001,-001,-001,-001,-001,-001,-001],
	[-001,-001,-001,-001,-001,-001,-001,-001,-001,-001,-001,-001,-001,-001,-001,-001,-001,-001,-001,-001,-001,-001,-001,-001,-001],
	[-001,-001,-001,-001,-001,-001,-001,-001,-001,-001,-001,-001,-001,-001,-001,-001,-001,-001,-001,-001,-001,-001,-001,-001,-001],
	[-001,-001,-001,-001,-001,-001,-001,-001,-001,-001,-001,-001,-001,-001,-001,-001,-001,-001,-001,-001,-001,-001,-001,-001,-001],
	[-001,-001,-001,-001,-001,-001,-001,-001,-001,-001,-001,-001,-001,-001,-001,-001,-001,-001,-001,-001,-001,-001,-001,-001,-001],
	[-001,-001,-001,-001,-001,-001,-001,-001,-001,-001,-001,-001,-001,-001,-001,-001,-001,-001,-001,-001,-001,-001,-001,-001,-001],
	[-001,-001,-001,-001,-001,-001,-001,-001,-001,-001,-001,-001,-001,-001,-001,-001,-001,-001,-001,-001,-001,-001,-001,-001,-001],
	[-001,-001,-001,-001,-001,-001,-001,-001,-001,-001,-001,-001,-001,-001,-001,-001,-001,-001,-001,-001,-001,-001,-001,-001,-001],
	[-001,-001,-001,-001,-001,-001,-001,-001,-001,-001,-001,-001,-001,-001,-001,-001,-001,-001,-001,-001,-001,-001,-001,-001,-001],
	[-001,-001,-001,-001,-001,-001,-001,-001,-001,-001,-001,-001,-001,-001,-001,-001,-001,-001,-001,-001,-001,-001,-001,-001,-001],
	[-001,-001,-001,-001,-001,-001,-001,-001,-001,-001,-001,-001,-001,-001,-001,-001,-001,-001,-001,-001,-001,-001,-001,-001,-001],
	[-001,-001,-001,-001,-001,-001,-001,-001,-001,-001,-001,-001,-001,-001,-001,-001,-001,-001,-001,-001,-001,-001,-001,-001,-001],
	[-001,-001,-001,-001,-001,-001,-001,-001,-001,-001,-001,-001,-001,-001,-001,-001,-001,-001,-001,-001,-001,-001,-001,-001,-001],
	[-001,-001,-001,-001,-001,-001,-001,-001,-001,-001,-001,-001,-001,-001,-001,-001,-001,-001,-001,-001,-001,-001,-001,-001,-001],
	[-001,-001,-001,-001,-001,-001,-001,-001,-001,-001,-001,-001,-001,-001,-001,-001,-001,-001,-001,-001,-001,-001,-001,-001,-001],
	[-001,-001,-001,-001,-001,-001,-001,-001,-001,-001,-001,-001,-001,-001,-001,-001,-001,-001,-001,-001,-001,-001,-001,-001,-001],
	[-001,-001,-001,-001,-001,-001,-001,-001,-001,-001,-001,-001,-001,-001,-001,-001,-001,-001,-001,-001,-001,-001,-001,-001,-001]
	],
	"events": [
	{
		"id": 5,
		"nom": "Clone[341][163]",
		"x": 13,
		"y": 14
	},
	{
		"id": 11,
		"nom": "Clone[341][163]",
		"x": 15,
		"y": 12
	},
	{
		"id": 6,
		"nom": "Clone[341][163]",
		"x": 13,
		"y": 12
	},
	{
		"id": 12,
		"nom": "Clone[341][163]",
		"x": 15,
		"y": 14
	},
	{
		"id": 1,
		"nom": "Clone[341][161]",
		"x": 12,
		"y": 11
	},
	{
		"id": 7,
		"nom": "Clone[341][161]",
		"x": 12,
		"y": 13
	},
	{
		"id": 2,
		"nom": "Clone[341][163]",
		"x": 11,
		"y": 10
	},
	{
		"id": 13,
		"nom": "Clone[341][161]",
		"x": 14,
		"y": 11
	},
	{
		"id": 8,
		"nom": "Clone[341][163]",
		"x": 13,
		"y": 10
	},
	{
		"id": 3,
		"nom": "Clone[341][163]",
		"x": 11,
		"y": 12
	},
	{
		"id": 14,
		"nom": "Clone[341][039]",
		"x": 9,
		"y": 10
	},
	{
		"id": 9,
		"nom": "Clone[341][163]",
		"x": 15,
		"y": 10
	},
	{
		"id": 4,
		"nom": "Clone[341][163]",
		"x": 11,
		"y": 14
	},
	{
		"id": 15,
		"nom": "EV015",
		"x": 7,
		"y": 12,
		"pages": [
		{
			"conditions": [
			{
				"nom": "ArriveeAuContact"
			}
			],
			"commandes": [
			{
				"nom": "ChangerDeMap",
				"variable": false,
				"numeroNouvelleMap": 14,
				"xDebutHeros": 5,
				"yDebutHeros": 14
			}
			],
			"directionInitiale": 1,
			"vitesse": "moderee",
			"frequence": "basse",
			"animeEnMouvement": false,
			"animeALArret": false,
			"directionFixe": true,
			"traversable": true,
			"auDessusDeTout": false
		}
		]
	},
	{
		"id": 10,
		"nom": "Clone[341][161]",
		"x": 14,
		"y": 13
	}
	]
}
