{
	"nom": "Salle à la Mare",
	"tileset": "Ventre",
	"largeur": 27,
	"hauteur": 25,
	"fondSonore": {
		"nomFichierSonore": "InterieurDeLaBaleine.ogg",
		"volume": 0.80,
		"tempo": 1.00
	},
	"couche0": [
	[0809,0809,0809,0809,0809,0809,0809,0809,0809,0809,0809,0809,0809,0809,0809,0809,0809,0809,0809,0809,0809,0809,0809,0809,0809,0809,0809],
	[0809,0809,0809,0809,0809,0809,0809,0809,0809,0809,0809,0809,0809,0809,0809,0809,0809,0809,0809,0809,0809,0809,0809,0809,0809,0809,0809],
	[0809,0809,0809,0809,0809,0809,0809,0809,0809,0809,0809,0809,0809,0809,0809,0809,0809,0809,0809,0809,0809,0809,0809,0809,0809,0809,0809],
	[0809,0809,0809,0809,0809,0809,0809,0809,0809,0809,0809,0809,0809,0809,0809,0809,0809,0809,0809,0809,0809,0809,0809,0809,0809,0809,0809],
	[0809,0809,0809,0809,0809,0809,0809,0809,0809,0809,0809,0809,0809,0809,0809,0809,0809,0809,0809,0809,0809,0809,0809,0809,0809,0809,0809],
	[0809,0809,0809,0809,0809,0809,0809,0809,0809,0809,0809,0809,0809,0809,0809,0809,0809,0809,0809,0809,0809,0809,0809,0809,0809,0809,0809],
	[0809,0809,0809,0809,0809,0809,0809,0809,0809,0809,0809,0809,0809,0809,0809,0809,0809,0809,0809,0809,0809,0809,0809,0809,0809,0809,0809],
	[0809,0809,0809,0809,0809,0809,0800,0801,0801,0801,0801,0801,0801,0801,0801,0801,0801,0801,0801,0801,0802,0809,0809,0809,0809,0809,0809],
	[0809,0809,0809,0809,0809,0809,0808,0009,0010,0010,0010,0010,0010,0010,0010,0010,0010,0010,0010,0022,0810,0809,0809,0809,0809,0809,0809],
	[0809,0809,0809,0809,0809,0809,0808,0040,0002,1135,0052,-002,-002,-008,-008,-008,-008,-008,-008,0030,0810,0809,0809,0809,0809,0809,0809],
	[0809,0809,0809,0809,0809,0809,0808,0040,1135,0001,0008,-002,-002,-008,-008,-008,-008,-008,-008,0030,0810,0809,0809,0809,0809,0809,0809],
	[0809,0809,0809,0809,0809,0809,0808,0040,0001,0001,-002,-002,-002,-008,-008,-008,-002,-002,-002,0030,0810,0809,0809,0809,0809,0809,0809],
	[0809,0809,0809,0809,0809,0809,0808,0041,0001,0001,-002,-002,-002,-008,-008,-008,-002,-002,-002,0030,0810,0809,0809,0809,0809,0809,0809],
	[0809,0809,0809,0809,0809,0809,0808,0040,0001,0001,-002,-002,-002,-008,-008,-008,-002,-002,-002,0030,0810,0809,0809,0809,0809,0809,0809],
	[0809,0809,0809,0809,0809,0809,0808,0040,1127,0001,-002,-002,-002,-008,-008,-008,-008,-008,-008,0030,0810,0809,0809,0809,0809,0809,0809],
	[0809,0809,0809,0809,0809,0809,0808,0040,0002,1127,0052,0008,-002,-008,-008,-008,-008,-008,-008,0030,0810,0809,0809,0809,0809,0809,0809],
	[0809,0809,0809,0809,0809,0809,0808,0048,0060,0060,0060,0060,0060,0060,0060,0060,0060,0060,0060,0061,0810,0809,0809,0809,0809,0809,0809],
	[0809,0809,0809,0809,0809,0809,0816,0817,0817,0817,0817,0817,0817,0817,0817,0817,0817,0817,0817,0817,0818,0809,0809,0809,0809,0809,0809],
	[0809,0809,0809,0809,0809,0809,0809,0809,0809,0809,0809,0809,0809,0809,0809,0809,0809,0809,0809,0809,0809,0809,0809,0809,0809,0809,0809],
	[0809,0809,0809,0809,0809,0809,0809,0809,0809,0809,0809,0809,0809,0809,0809,0809,0809,0809,0809,0809,0809,0809,0809,0809,0809,0809,0809],
	[0809,0809,0809,0809,0809,0809,0809,0809,0809,0809,0809,0809,0809,0809,0809,0809,0809,0809,0809,0809,0809,0809,0809,0809,0809,0809,0809],
	[0809,0809,0809,0809,0809,0809,0809,0809,0809,0809,0809,0809,0809,0809,0809,0809,0809,0809,0809,0809,0809,0809,0809,0809,0809,0809,0809],
	[0809,0809,0809,0809,0809,0809,0809,0809,0809,0809,0809,0809,0809,0809,0809,0809,0809,0809,0809,0809,0809,0809,0809,0809,0809,0809,0809],
	[0809,0809,0809,0809,0809,0809,0809,0809,0809,0809,0809,0809,0809,0809,0809,0809,0809,0809,0809,0809,0809,0809,0809,0809,0809,0809,0809],
	[0809,0809,0809,0809,0809,0809,0809,0809,0809,0809,0809,0809,0809,0809,0809,0809,0809,0809,0809,0809,0809,0809,0809,0809,0809,0809,0809]
	],
	"couche1": [
	[-001,-001,-001,-001,-001,-001,-001,-001,-001,-001,-001,-001,-001,-001,-001,-001,-001,-001,-001,-001,-001,-001,-001,-001,-001,-001,-001],
	[-001,-001,-001,-001,-001,-001,-001,-001,-001,-001,-001,-001,-001,-001,-001,-001,-001,-001,-001,-001,-001,-001,-001,-001,-001,-001,-001],
	[-001,-001,-001,-001,-001,-001,-001,-001,-001,-001,-001,-001,-001,-001,-001,-001,-001,-001,-001,-001,-001,-001,-001,-001,-001,-001,-001],
	[-001,-001,-001,-001,-001,-001,-001,-001,-001,-001,-001,-001,-001,-001,-001,-001,-001,-001,-001,-001,-001,-001,-001,-001,-001,-001,-001],
	[-001,-001,-001,-001,-001,-001,-001,-001,-001,-001,-001,-001,-001,-001,-001,-001,-001,-001,-001,-001,-001,-001,-001,-001,-001,-001,-001],
	[-001,-001,-001,-001,-001,-001,-001,-001,-001,-001,-001,-001,-001,-001,-001,-001,-001,-001,-001,-001,-001,-001,-001,-001,-001,-001,-001],
	[-001,-001,-001,-001,-001,-001,-001,-001,-001,-001,-001,-001,-001,-001,-001,-001,-001,-001,-001,-001,-001,-001,-001,-001,-001,-001,-001],
	[-001,-001,-001,-001,-001,-001,-001,-001,-001,-001,-001,-001,-001,-001,-001,-001,-001,-001,-001,-001,-001,-001,-001,-001,-001,-001,-001],
	[-001,-001,-001,-001,-001,-001,-001,-001,-001,-001,0044,-001,-001,-001,-001,-001,-001,-001,-001,-001,-001,-001,-001,-001,-001,-001,-001],
	[-001,-001,-001,-001,-001,-001,-001,-001,-001,-001,-001,-001,-001,-001,-001,-001,-001,-001,-001,-001,-001,-001,-001,-001,-001,-001,-001],
	[-001,-001,-001,-001,-001,-001,-001,-001,-001,-001,-001,-001,-001,-001,-001,-001,-001,-001,-001,-001,-001,-001,-001,-001,-001,-001,-001],
	[-001,-001,-001,-001,-001,-001,-001,0019,-001,-001,-001,-001,-001,-001,-001,-001,0390,-001,-001,-001,-001,-001,-001,-001,-001,-001,-001],
	[-001,-001,-001,-001,-001,-001,-001,0033,-001,-001,-001,-001,-001,-001,-001,-001,-001,-001,-001,-001,-001,-001,-001,-001,-001,-001,-001],
	[-001,-001,-001,-001,-001,-001,-001,-001,-001,-001,-001,-001,-001,-001,-001,-001,0398,-001,-001,-001,-001,-001,-001,-001,-001,-001,-001],
	[-001,-001,-001,-001,-001,-001,-001,-001,-001,-001,0044,-001,-001,-001,-001,-001,-001,-001,-001,-001,-001,-001,-001,-001,-001,-001,-001],
	[-001,-001,-001,-001,-001,-001,-001,-001,-001,-001,-001,-001,-001,-001,-001,-001,-001,-001,-001,-001,-001,-001,-001,-001,-001,-001,-001],
	[-001,-001,-001,-001,-001,-001,-001,-001,-001,-001,-001,-001,-001,-001,-001,-001,-001,-001,-001,-001,-001,-001,-001,-001,-001,-001,-001],
	[-001,-001,-001,-001,-001,-001,-001,-001,-001,-001,-001,-001,-001,-001,-001,-001,-001,-001,-001,-001,-001,-001,-001,-001,-001,-001,-001],
	[-001,-001,-001,-001,-001,-001,-001,-001,-001,-001,-001,-001,-001,-001,-001,-001,-001,-001,-001,-001,-001,-001,-001,-001,-001,-001,-001],
	[-001,-001,-001,-001,-001,-001,-001,-001,-001,-001,-001,-001,-001,-001,-001,-001,-001,-001,-001,-001,-001,-001,-001,-001,-001,-001,-001],
	[-001,-001,-001,-001,-001,-001,-001,-001,-001,-001,-001,-001,-001,-001,-001,-001,-001,-001,-001,-001,-001,-001,-001,-001,-001,-001,-001],
	[-001,-001,-001,-001,-001,-001,-001,-001,-001,-001,-001,-001,-001,-001,-001,-001,-001,-001,-001,-001,-001,-001,-001,-001,-001,-001,-001],
	[-001,-001,-001,-001,-001,-001,-001,-001,-001,-001,-001,-001,-001,-001,-001,-001,-001,-001,-001,-001,-001,-001,-001,-001,-001,-001,-001],
	[-001,-001,-001,-001,-001,-001,-001,-001,-001,-001,-001,-001,-001,-001,-001,-001,-001,-001,-001,-001,-001,-001,-001,-001,-001,-001,-001],
	[-001,-001,-001,-001,-001,-001,-001,-001,-001,-001,-001,-001,-001,-001,-001,-001,-001,-001,-001,-001,-001,-001,-001,-001,-001,-001,-001]
	],
	"couche2": [
	[-001,-001,-001,-001,-001,-001,-001,-001,-001,-001,-001,-001,-001,-001,-001,-001,-001,-001,-001,-001,-001,-001,-001,-001,-001,-001,-001],
	[-001,-001,-001,-001,-001,-001,-001,-001,-001,-001,-001,-001,-001,-001,-001,-001,-001,-001,-001,-001,-001,-001,-001,-001,-001,-001,-001],
	[-001,-001,-001,-001,-001,-001,-001,-001,-001,-001,-001,-001,-001,-001,-001,-001,-001,-001,-001,-001,-001,-001,-001,-001,-001,-001,-001],
	[-001,-001,-001,-001,-001,-001,-001,-001,-001,-001,-001,-001,-001,-001,-001,-001,-001,-001,-001,-001,-001,-001,-001,-001,-001,-001,-001],
	[-001,-001,-001,-001,-001,-001,-001,-001,-001,-001,-001,-001,-001,-001,-001,-001,-001,-001,-001,-001,-001,-001,-001,-001,-001,-001,-001],
	[-001,-001,-001,-001,-001,-001,-001,-001,-001,-001,-001,-001,-001,-001,-001,-001,-001,-001,-001,-001,-001,-001,-001,-001,-001,-001,-001],
	[-001,-001,-001,-001,-001,-001,-001,-001,-001,-001,-001,-001,-001,-001,-001,-001,-001,-001,-001,-001,-001,-001,-001,-001,-001,-001,-001],
	[-001,-001,-001,-001,-001,-001,-001,-001,-001,-001,-001,-001,-001,-001,-001,-001,-001,-001,-001,-001,-001,-001,-001,-001,-001,-001,-001],
	[-001,-001,-001,-001,-001,-001,-001,-001,-001,-001,-001,-001,0164,-001,-001,-001,-001,-001,-001,-001,-001,-001,-001,-001,-001,-001,-001],
	[-001,-001,-001,-001,-001,-001,-001,-001,-001,-001,-001,-001,0172,-001,-001,-001,-001,-001,-001,-001,-001,-001,-001,-001,-001,-001,-001],
	[-001,-001,-001,-001,-001,-001,-001,-001,-001,-001,-001,-001,0300,-001,-001,-001,-001,-001,-001,-001,-001,-001,-001,-001,-001,-001,-001],
	[-001,-001,-001,-001,-001,-001,-001,-001,-001,-001,-001,-001,-001,-001,-001,-001,-001,-001,-001,-001,-001,-001,-001,-001,-001,-001,-001],
	[-001,-001,-001,-001,-001,-001,-001,-001,-001,-001,-001,0308,-001,-001,-001,-001,0171,0164,-001,-001,-001,-001,-001,-001,-001,-001,-001],
	[-001,-001,-001,-001,-001,-001,-001,-001,-001,-001,-001,-001,0171,-001,-001,-001,-001,0172,-001,-001,-001,-001,-001,-001,-001,-001,-001],
	[-001,-001,-001,-001,-001,-001,-001,-001,-001,-001,-001,-001,-001,-001,-001,-001,-001,-001,-001,-001,-001,-001,-001,-001,-001,-001,-001],
	[-001,-001,-001,-001,-001,-001,-001,-001,-001,-001,-001,-001,-001,-001,-001,-001,-001,-001,-001,-001,-001,-001,-001,-001,-001,-001,-001],
	[-001,-001,-001,-001,-001,-001,-001,-001,-001,-001,-001,-001,-001,-001,-001,-001,-001,-001,-001,-001,-001,-001,-001,-001,-001,-001,-001],
	[-001,-001,-001,-001,-001,-001,-001,-001,-001,-001,-001,-001,-001,-001,-001,-001,-001,-001,-001,-001,-001,-001,-001,-001,-001,-001,-001],
	[-001,-001,-001,-001,-001,-001,-001,-001,-001,-001,-001,-001,-001,-001,-001,-001,-001,-001,-001,-001,-001,-001,-001,-001,-001,-001,-001],
	[-001,-001,-001,-001,-001,-001,-001,-001,-001,-001,-001,-001,-001,-001,-001,-001,-001,-001,-001,-001,-001,-001,-001,-001,-001,-001,-001],
	[-001,-001,-001,-001,-001,-001,-001,-001,-001,-001,-001,-001,-001,-001,-001,-001,-001,-001,-001,-001,-001,-001,-001,-001,-001,-001,-001],
	[-001,-001,-001,-001,-001,-001,-001,-001,-001,-001,-001,-001,-001,-001,-001,-001,-001,-001,-001,-001,-001,-001,-001,-001,-001,-001,-001],
	[-001,-001,-001,-001,-001,-001,-001,-001,-001,-001,-001,-001,-001,-001,-001,-001,-001,-001,-001,-001,-001,-001,-001,-001,-001,-001,-001],
	[-001,-001,-001,-001,-001,-001,-001,-001,-001,-001,-001,-001,-001,-001,-001,-001,-001,-001,-001,-001,-001,-001,-001,-001,-001,-001,-001],
	[-001,-001,-001,-001,-001,-001,-001,-001,-001,-001,-001,-001,-001,-001,-001,-001,-001,-001,-001,-001,-001,-001,-001,-001,-001,-001,-001]
	],
	"events": [
	{
		"id": 5,
		"nom": "Clone[341][008]",
		"x": 17,
		"y": 11
	},
	{
		"id": 6,
		"nom": "Clone[582][99]",
		"x": 11,
		"y": 11
	},
	{
		"id": 1,
		"nom": "Clone[341][001]",
		"x": 8,
		"y": 15
	},
	{
		"id": 7,
		"nom": "Clone[582][99]",
		"x": 15,
		"y": 15
	},
	{
		"id": 2,
		"nom": "Clone[341][001]",
		"x": 9,
		"y": 15
	},
	{
		"id": 8,
		"nom": "Clone[582][99]",
		"x": 18,
		"y": 9
	},
	{
		"id": 3,
		"nom": "Clone[341][001]",
		"x": 8,
		"y": 9
	},
	{
		"id": 9,
		"nom": "Clone[582][37]",
		"x": 13,
		"y": 11
	},
	{
		"id": 15,
		"nom": "EV015",
		"x": 7,
		"y": 12,
		"pages": [
		{
			"conditions": [
			{
				"nom": "ArriveeAuContact"
			}
			],
			"commandes": [
			{
				"nom": "ChangerDeMap",
				"variable": false,
				"numeroNouvelleMap": 20,
				"xDebutHeros": 33,
				"yDebutHeros": 18
			}
			],
			"directionInitiale": 1,
			"vitesse": "moderee",
			"frequence": "basse",
			"animeEnMouvement": false,
			"animeALArret": false,
			"directionFixe": true,
			"traversable": true,
			"auDessusDeTout": false
		}
		]
	},
	{
		"id": 4,
		"nom": "Clone[341][001]",
		"x": 9,
		"y": 9
	},
	{
		"id": 10,
		"nom": "Clone[582][37]",
		"x": 14,
		"y": 10
	}
	]
}
