{
	"nom": "Tunnel descendant",
	"tileset": "Ventre",
	"largeur": 40,
	"hauteur": 30,
	"musique": {
		"nomFichierSonore": "",
		"volume": 1.00,
		"tempo": 1.00
	},
	"fondSonore": {
		"nomFichierSonore": "",
		"volume": 0.80,
		"tempo": 1.00
	},
	"couche0": [
	[0809,0809,0809,0809,0809,0809,0809,0809,0809,0809,0809,0809,0809,0809,0809,0809,0809,0809,0809,0809,0809,0809,0809,0809,0809,0809,0809,0809,0809,0809,0809,0809,0809,0809,0809,0809,0809,0809,0809,0809],
	[0809,0809,0809,0809,0809,0809,0809,0809,0809,0809,0809,0809,0809,0809,0809,0809,0809,0809,0809,0809,0809,0809,0809,0809,0809,0809,0809,0809,0809,0809,0809,0809,0809,0809,0809,0809,0809,0809,0809,0809],
	[0809,0809,0809,0809,0809,0809,0809,0809,0809,0809,0809,0809,0809,0809,0809,0809,0809,0809,0809,0809,0809,0809,0809,0809,0809,0809,0809,0809,0809,0809,0809,0809,0809,0809,0809,0809,0809,0809,0809,0809],
	[0809,0809,0809,0809,0809,0809,0809,0809,0809,0809,0809,0809,0809,0809,0809,0809,0809,0809,0809,0809,0809,0809,0809,0809,0809,0809,0809,0809,0809,0809,0809,0809,0809,0809,0809,0809,0809,0809,0809,0809],
	[0809,0809,0809,0809,0809,0809,0809,0809,0809,0809,0809,0809,0809,0809,0809,0809,0809,0809,0809,0809,0809,0809,0809,0809,0809,0809,0809,0809,0809,0809,0809,0809,0809,0809,0809,0809,0809,0809,0809,0809],
	[0809,0809,0809,0809,0809,0809,0809,0809,0809,0809,0809,0809,0809,0809,0809,0809,0809,0809,0809,0809,0809,0809,0809,0809,0809,0809,0809,0809,0809,0809,0809,0809,0809,0809,0809,0809,0809,0809,0809,0809],
	[0809,0809,0809,0809,0809,0809,0809,0809,0809,0809,0809,0809,0809,0809,0809,0809,0809,0809,0809,0809,0809,0809,0809,0809,0809,0809,0809,0809,0809,0809,0809,0809,0809,0809,0809,0809,0809,0809,0809,0809],
	[0809,0809,0809,0809,0809,0809,0809,0809,0809,0809,0809,0809,0809,0809,0809,0809,0809,0809,0809,0809,0809,0809,0809,0809,0809,0809,0809,0809,0809,0809,0809,0809,0809,0809,0809,0809,0809,0809,0809,0809],
	[0809,0809,0809,0809,0809,0809,0809,0809,0809,0809,0809,0809,0809,0809,0809,0809,0809,0809,0809,0809,0809,0809,0809,0809,0809,0809,0809,0809,0809,0809,0809,0809,0809,0809,0809,0809,0809,0809,0809,0809],
	[0809,0809,0809,0809,0809,0809,0809,0809,0809,0809,0800,0801,0801,0801,0801,0801,0801,0801,0801,0801,0801,0801,0801,0801,0801,0802,0809,0809,0809,0809,0809,0809,0809,0809,0809,0809,0809,0809,0809,0809],
	[0809,0809,0809,0809,0809,0809,0809,0809,0809,0800,0017,0000,0000,0000,0000,0000,0000,0000,0000,0000,0000,0000,0000,0000,0000,0810,0809,0809,0809,0809,0809,0809,0809,0809,0809,0809,0809,0809,0809,0809],
	[0809,0809,0809,0809,0809,0809,0809,0809,0800,0017,0000,0000,0053,0817,0817,0817,0817,0817,0817,0817,0817,0817,0817,0049,0000,0810,0809,0809,0809,0809,0809,0809,0809,0809,0809,0809,0809,0809,0809,0809],
	[0809,0809,0809,0809,0809,0809,0809,0809,0808,0016,0011,0022,0810,0809,0809,0809,0809,0809,0809,0809,0809,0809,0809,0808,0000,0810,0809,0809,0809,0809,0809,0809,0809,0809,0809,0809,0809,0809,0809,0809],
	[0809,0809,0809,0809,0809,0809,0809,0809,0808,0032,0000,0038,0810,0809,0809,0809,0809,0809,0809,0809,0809,0809,0809,0808,0000,0810,0809,0809,0809,0809,0809,0809,0809,0809,0809,0809,0809,0809,0809,0809],
	[0809,0809,0809,0809,0809,0809,0809,0809,0808,0032,0000,0038,0021,0801,0801,0801,0801,0801,0801,0802,0809,0809,0809,0816,0051,0818,0809,0809,0809,0809,0809,0809,0809,0809,0809,0809,0809,0809,0809,0809],
	[0809,0809,0809,0809,0809,0809,0809,0809,0808,0032,0000,0021,0011,0011,0011,0011,0011,0011,0022,0021,0802,0809,0809,0809,0809,0809,0809,0809,0809,0809,0809,0809,0809,0809,0809,0809,0809,0809,0809,0809],
	[0809,0809,0809,0809,0809,0809,0809,0800,0017,0032,0000,0052,0000,0000,0000,0000,0052,0000,0021,0022,0810,0809,0809,0809,0809,0809,0809,0809,0809,0809,0809,0809,0809,0809,0809,0809,0809,0809,0809,0809],
	[0809,0809,0809,0809,0809,0809,0809,0808,0016,0017,0000,0008,0000,0000,0000,0000,0008,0000,0000,0038,0810,0809,0809,0809,0809,0809,0809,0809,0809,0809,0809,0809,0809,0809,0809,0809,0809,0809,0809,0809],
	[0809,0809,0809,0809,0809,0809,0809,0808,0032,0000,0000,0000,0000,0000,0000,0000,0000,0000,0053,0061,0810,0809,0809,0809,0809,0809,0809,0809,0809,0809,0809,0809,0809,0809,0809,0809,0809,0809,0809,0809],
	[0809,0809,0809,0809,0809,0809,0809,0808,0057,0049,0000,0008,0000,0000,0000,0000,0008,0000,0021,0022,0810,0809,0809,0809,0809,0809,0809,0809,0809,0809,0809,0809,0809,0809,0809,0809,0809,0809,0809,0809],
	[0809,0809,0809,0809,0809,0809,0809,0816,0049,0057,0059,0059,0059,0059,0059,0049,0016,0011,0022,0038,0810,0809,0809,0809,0809,0809,0809,0809,0809,0809,0809,0809,0809,0809,0809,0809,0809,0809,0809,0809],
	[0809,0809,0809,0809,0809,0809,0809,0809,0816,0817,0817,0817,0817,0817,0049,0032,0032,0000,0038,0038,0810,0809,0809,0809,0809,0809,0809,0809,0809,0809,0809,0809,0809,0809,0809,0809,0809,0809,0809,0809],
	[0809,0809,0809,0809,0809,0809,0809,0809,0809,0809,0809,0809,0809,0809,0808,0032,0032,0000,0038,0038,0810,0809,0809,0809,0809,0809,0809,0809,0809,0809,0809,0809,0809,0809,0809,0809,0809,0809,0809,0809],
	[0809,0809,0809,0809,0809,0809,0809,0809,0809,0809,0809,0809,0809,0809,0808,0032,0032,0000,0038,0038,0810,0809,0809,0809,0809,0809,0809,0809,0809,0809,0809,0809,0809,0809,0809,0809,0809,0809,0809,0809],
	[0809,0809,0809,0809,0809,0809,0809,0809,0809,0809,0809,0809,0809,0809,0808,0032,0032,0000,0038,0038,0810,0809,0809,0809,0809,0809,0809,0809,0809,0809,0809,0809,0809,0809,0809,0809,0809,0809,0809,0809],
	[0809,0809,0809,0809,0809,0809,0809,0809,0809,0809,0809,0809,0809,0809,0808,0032,0032,0000,0038,0038,0810,0809,0809,0809,0809,0809,0809,0809,0809,0809,0809,0809,0809,0809,0809,0809,0809,0809,0809,0809],
	[0809,0809,0809,0809,0809,0809,0809,0809,0809,0809,0809,0809,0809,0809,0808,0032,0057,0051,0061,0038,0810,0809,0809,0809,0809,0809,0809,0809,0809,0809,0809,0809,0809,0809,0809,0809,0809,0809,0809,0809],
	[0809,0809,0809,0809,0809,0809,0809,0809,0809,0809,0809,0809,0809,0809,0808,0057,0059,0059,0059,0061,0810,0809,0809,0809,0809,0809,0809,0809,0809,0809,0809,0809,0809,0809,0809,0809,0809,0809,0809,0809],
	[0809,0809,0809,0809,0809,0809,0809,0809,0809,0809,0809,0809,0809,0809,0816,0817,0817,0817,0817,0817,0818,0809,0809,0809,0809,0809,0809,0809,0809,0809,0809,0809,0809,0809,0809,0809,0809,0809,0809,0809],
	[0809,0809,0809,0809,0809,0809,0809,0809,0809,0809,0809,0809,0809,0809,0809,0809,0809,0809,0809,0809,0809,0809,0809,0809,0809,0809,0809,0809,0809,0809,0809,0809,0809,0809,0809,0809,0809,0809,0809,0809]
	],
	"couche1": [
	[-001,-001,-001,-001,-001,-001,-001,-001,-001,-001,-001,-001,-001,-001,-001,-001,-001,-001,-001,-001,-001,-001,-001,-001,-001,-001,-001,-001,-001,-001,-001,-001,-001,-001,-001,-001,-001,-001,-001,-001],
	[-001,-001,-001,-001,-001,-001,-001,-001,-001,-001,-001,-001,-001,-001,-001,-001,-001,-001,-001,-001,-001,-001,-001,-001,-001,-001,-001,-001,-001,-001,-001,-001,-001,-001,-001,-001,-001,-001,-001,-001],
	[-001,-001,-001,-001,-001,-001,-001,-001,-001,-001,-001,-001,-001,-001,-001,-001,-001,-001,-001,-001,-001,-001,-001,-001,-001,-001,-001,-001,-001,-001,-001,-001,-001,-001,-001,-001,-001,-001,-001,-001],
	[-001,-001,-001,-001,-001,-001,-001,-001,-001,-001,-001,-001,-001,-001,-001,-001,-001,-001,-001,-001,-001,-001,-001,-001,-001,-001,-001,-001,-001,-001,-001,-001,-001,-001,-001,-001,-001,-001,-001,-001],
	[-001,-001,-001,-001,-001,-001,-001,-001,-001,-001,-001,-001,-001,-001,-001,-001,-001,-001,-001,-001,-001,-001,-001,-001,-001,-001,-001,-001,-001,-001,-001,-001,-001,-001,-001,-001,-001,-001,-001,-001],
	[-001,-001,-001,-001,-001,-001,-001,-001,-001,-001,-001,-001,-001,-001,-001,-001,-001,-001,-001,-001,-001,-001,-001,-001,-001,-001,-001,-001,-001,-001,-001,-001,-001,-001,-001,-001,-001,-001,-001,-001],
	[-001,-001,-001,-001,-001,-001,-001,-001,-001,-001,-001,-001,-001,-001,-001,-001,-001,-001,-001,-001,-001,-001,-001,-001,-001,-001,-001,-001,-001,-001,-001,-001,-001,-001,-001,-001,-001,-001,-001,-001],
	[-001,-001,-001,-001,-001,-001,-001,-001,-001,-001,-001,-001,-001,-001,-001,-001,-001,-001,-001,-001,-001,-001,-001,-001,-001,-001,-001,-001,-001,-001,-001,-001,-001,-001,-001,-001,-001,-001,-001,-001],
	[-001,-001,-001,-001,-001,-001,-001,-001,-001,-001,-001,-001,-001,-001,-001,-001,-001,-001,-001,-001,-001,-001,-001,-001,-001,-001,-001,-001,-001,-001,-001,-001,-001,-001,-001,-001,-001,-001,-001,-001],
	[-001,-001,-001,-001,-001,-001,-001,-001,-001,-001,-001,-001,-001,-001,-001,-001,-001,-001,-001,-001,-001,-001,-001,-001,-001,-001,-001,-001,-001,-001,-001,-001,-001,-001,-001,-001,-001,-001,-001,-001],
	[-001,-001,-001,-001,-001,-001,-001,-001,-001,-001,-001,-001,-001,-001,-001,-001,-001,-001,-001,-001,-001,-001,-001,-001,-001,-001,-001,-001,-001,-001,-001,-001,-001,-001,-001,-001,-001,-001,-001,-001],
	[-001,-001,-001,-001,-001,-001,-001,-001,-001,-001,-001,-001,-001,-001,-001,-001,-001,-001,-001,-001,-001,-001,-001,-001,-001,-001,-001,-001,-001,-001,-001,-001,-001,-001,-001,-001,-001,-001,-001,-001],
	[-001,-001,-001,-001,-001,-001,-001,-001,-001,-001,-005,-001,-001,-001,-001,-001,-001,-001,-001,-001,-001,-001,-001,-001,-001,-001,-001,-001,-001,-001,-001,-001,-001,-001,-001,-001,-001,-001,-001,-001],
	[-001,-001,-001,-001,-001,-001,-001,-001,-001,-001,-001,-001,-001,-001,-001,-001,-001,-001,-001,-001,-001,-001,-001,-001,-001,-001,-001,-001,-001,-001,-001,-001,-001,-001,-001,-001,-001,-001,-001,-001],
	[-001,-001,-001,-001,-001,-001,-001,-001,-001,-001,-001,-001,-001,-001,-001,-001,-001,-001,-001,-001,-001,-001,-001,-001,0050,-001,-001,-001,-001,-001,-001,-001,-001,-001,-001,-001,-001,-001,-001,-001],
	[-001,-001,-001,-001,-001,-001,-001,-001,-001,-001,-001,0044,-001,-001,-001,-001,0044,-001,-001,-001,-001,-001,-001,-001,-001,-001,-001,-001,-001,-001,-001,-001,-001,-001,-001,-001,-001,-001,-001,-001],
	[-001,-001,-001,-001,-001,-001,-001,-001,-001,-001,-001,-001,-001,-001,-001,-001,-001,-001,-001,-001,-001,-001,-001,-001,-001,-001,-001,-001,-001,-001,-001,-001,-001,-001,-001,-001,-001,-001,-001,-001],
	[-001,-001,-001,-001,-001,-001,-001,-001,-001,-001,-001,-001,-001,-001,-001,-001,-001,-001,-001,-001,-001,-001,-001,-001,-001,-001,-001,-001,-001,-001,-001,-001,-001,-001,-001,-001,-001,-001,-001,-001],
	[-001,-001,-001,-001,-001,-001,-001,-001,-001,-001,-001,-001,-001,-001,-001,-001,-001,-001,-001,-001,-001,-001,-001,-001,-001,-001,-001,-001,-001,-001,-001,-001,-001,-001,-001,-001,-001,-001,-001,-001],
	[-001,-001,-001,-001,-001,-001,-001,-001,-001,-001,-001,-001,-001,-001,-001,-001,-001,-001,-001,-001,-001,-001,-001,-001,-001,-001,-001,-001,-001,-001,-001,-001,-001,-001,-001,-001,-001,-001,-001,-001],
	[-001,-001,-001,-001,-001,-001,-001,-001,-001,-001,-001,-001,-001,-001,-001,-001,-001,-005,-001,-001,-001,-001,-001,-001,-001,-001,-001,-001,-001,-001,-001,-001,-001,-001,-001,-001,-001,-001,-001,-001],
	[-001,-001,-001,-001,-001,-001,-001,-001,-001,-001,-001,-001,-001,-001,-001,-001,-001,-001,-001,-001,-001,-001,-001,-001,-001,-001,-001,-001,-001,-001,-001,-001,-001,-001,-001,-001,-001,-001,-001,-001],
	[-001,-001,-001,-001,-001,-001,-001,-001,-001,-001,-001,-001,-001,-001,-001,-001,-001,-001,-001,-001,-001,-001,-001,-001,-001,-001,-001,-001,-001,-001,-001,-001,-001,-001,-001,-001,-001,-001,-001,-001],
	[-001,-001,-001,-001,-001,-001,-001,-001,-001,-001,-001,-001,-001,-001,-001,-001,-001,-001,-001,-001,-001,-001,-001,-001,-001,-001,-001,-001,-001,-001,-001,-001,-001,-001,-001,-001,-001,-001,-001,-001],
	[-001,-001,-001,-001,-001,-001,-001,-001,-001,-001,-001,-001,-001,-001,-001,-001,-001,-001,-001,-001,-001,-001,-001,-001,-001,-001,-001,-001,-001,-001,-001,-001,-001,-001,-001,-001,-001,-001,-001,-001],
	[-001,-001,-001,-001,-001,-001,-001,-001,-001,-001,-001,-001,-001,-001,-001,-001,-001,-001,-001,-001,-001,-001,-001,-001,-001,-001,-001,-001,-001,-001,-001,-001,-001,-001,-001,-001,-001,-001,-001,-001],
	[-001,-001,-001,-001,-001,-001,-001,-001,-001,-001,-001,-001,-001,-001,-001,-001,-001,0050,-001,-001,-001,-001,-001,-001,-001,-001,-001,-001,-001,-001,-001,-001,-001,-001,-001,-001,-001,-001,-001,-001],
	[-001,-001,-001,-001,-001,-001,-001,-001,-001,-001,-001,-001,-001,-001,-001,-001,-001,-001,-001,-001,-001,-001,-001,-001,-001,-001,-001,-001,-001,-001,-001,-001,-001,-001,-001,-001,-001,-001,-001,-001],
	[-001,-001,-001,-001,-001,-001,-001,-001,-001,-001,-001,-001,-001,-001,-001,-001,-001,-001,-001,-001,-001,-001,-001,-001,-001,-001,-001,-001,-001,-001,-001,-001,-001,-001,-001,-001,-001,-001,-001,-001],
	[-001,-001,-001,-001,-001,-001,-001,-001,-001,-001,-001,-001,-001,-001,-001,-001,-001,-001,-001,-001,-001,-001,-001,-001,-001,-001,-001,-001,-001,-001,-001,-001,-001,-001,-001,-001,-001,-001,-001,-001]
	],
	"couche2": [
	[-001,-001,-001,-001,-001,-001,-001,-001,-001,-001,-001,-001,-001,-001,-001,-001,-001,-001,-001,-001,-001,-001,-001,-001,-001,-001,-001,-001,-001,-001,-001,-001,-001,-001,-001,-001,-001,-001,-001,-001],
	[-001,-001,-001,-001,-001,-001,-001,-001,-001,-001,-001,-001,-001,-001,-001,-001,-001,-001,-001,-001,-001,-001,-001,-001,-001,-001,-001,-001,-001,-001,-001,-001,-001,-001,-001,-001,-001,-001,-001,-001],
	[-001,-001,-001,-001,-001,-001,-001,-001,-001,-001,-001,-001,-001,-001,-001,-001,-001,-001,-001,-001,-001,-001,-001,-001,-001,-001,-001,-001,-001,-001,-001,-001,-001,-001,-001,-001,-001,-001,-001,-001],
	[-001,-001,-001,-001,-001,-001,-001,-001,-001,-001,-001,-001,-001,-001,-001,-001,-001,-001,-001,-001,-001,-001,-001,-001,-001,-001,-001,-001,-001,-001,-001,-001,-001,-001,-001,-001,-001,-001,-001,-001],
	[-001,-001,-001,-001,-001,-001,-001,-001,-001,-001,-001,-001,-001,-001,-001,-001,-001,-001,-001,-001,-001,-001,-001,-001,-001,-001,-001,-001,-001,-001,-001,-001,-001,-001,-001,-001,-001,-001,-001,-001],
	[-001,-001,-001,-001,-001,-001,-001,-001,-001,-001,-001,-001,-001,-001,-001,-001,-001,-001,-001,-001,-001,-001,-001,-001,-001,-001,-001,-001,-001,-001,-001,-001,-001,-001,-001,-001,-001,-001,-001,-001],
	[-001,-001,-001,-001,-001,-001,-001,-001,-001,-001,-001,-001,-001,-001,-001,-001,-001,-001,-001,-001,-001,-001,-001,-001,-001,-001,-001,-001,-001,-001,-001,-001,-001,-001,-001,-001,-001,-001,-001,-001],
	[-001,-001,-001,-001,-001,-001,-001,-001,-001,-001,-001,-001,-001,-001,-001,-001,-001,-001,-001,-001,-001,-001,-001,-001,-001,-001,-001,-001,-001,-001,-001,-001,-001,-001,-001,-001,-001,-001,-001,-001],
	[-001,-001,-001,-001,-001,-001,-001,-001,-001,-001,-001,-001,-001,-001,-001,-001,-001,-001,-001,-001,-001,-001,-001,-001,-001,-001,-001,-001,-001,-001,-001,-001,-001,-001,-001,-001,-001,-001,-001,-001],
	[-001,-001,-001,-001,-001,-001,-001,-001,-001,-001,-001,-001,-001,-001,-001,-001,-001,-001,-001,-001,-001,-001,-001,-001,-001,-001,-001,-001,-001,-001,-001,-001,-001,-001,-001,-001,-001,-001,-001,-001],
	[-001,-001,-001,-001,-001,-001,-001,-001,-001,-001,-001,-001,-001,-001,-001,-001,-001,-001,-001,-001,-001,-001,-001,-001,-001,-001,-001,-001,-001,-001,-001,-001,-001,-001,-001,-001,-001,-001,-001,-001],
	[-001,-001,-001,-001,-001,-001,-001,-001,-001,-001,-001,-001,-001,-001,-001,-001,-001,-001,-001,-001,-001,-001,-001,-001,-001,-001,-001,-001,-001,-001,-001,-001,-001,-001,-001,-001,-001,-001,-001,-001],
	[-001,-001,-001,-001,-001,-001,-001,-001,-001,-001,-001,-001,-001,-001,-001,-001,-001,-001,-001,-001,-001,-001,-001,-001,-001,-001,-001,-001,-001,-001,-001,-001,-001,-001,-001,-001,-001,-001,-001,-001],
	[-001,-001,-001,-001,-001,-001,-001,-001,-001,-001,-001,-001,-001,-001,-001,-001,-001,-001,-001,-001,-001,-001,-001,-001,-001,-001,-001,-001,-001,-001,-001,-001,-001,-001,-001,-001,-001,-001,-001,-001],
	[-001,-001,-001,-001,-001,-001,-001,-001,-001,-001,-001,-001,-001,-001,-001,-001,-001,-001,-001,-001,-001,-001,-001,-001,-001,-001,-001,-001,-001,-001,-001,-001,-001,-001,-001,-001,-001,-001,-001,-001],
	[-001,-001,-001,-001,-001,-001,-001,-001,-001,-001,-001,-001,-001,-001,-001,-001,-001,-001,-001,-001,-001,-001,-001,-001,-001,-001,-001,-001,-001,-001,-001,-001,-001,-001,-001,-001,-001,-001,-001,-001],
	[-001,-001,-001,-001,-001,-001,-001,-001,-001,-001,-001,-001,-001,-001,-001,-001,-001,-001,-001,-001,-001,-001,-001,-001,-001,-001,-001,-001,-001,-001,-001,-001,-001,-001,-001,-001,-001,-001,-001,-001],
	[-001,-001,-001,-001,-001,-001,-001,-001,-001,-001,-001,-001,-001,-001,-001,-001,-001,-001,-001,-001,-001,-001,-001,-001,-001,-001,-001,-001,-001,-001,-001,-001,-001,-001,-001,-001,-001,-001,-001,-001],
	[-001,-001,-001,-001,-001,-001,-001,-001,-001,-001,-001,-001,-001,-001,-001,-001,-001,-001,-001,-001,-001,-001,-001,-001,-001,-001,-001,-001,-001,-001,-001,-001,-001,-001,-001,-001,-001,-001,-001,-001],
	[-001,-001,-001,-001,-001,-001,-001,-001,-001,-001,-001,-001,-001,-001,-001,-001,-001,-001,-001,-001,-001,-001,-001,-001,-001,-001,-001,-001,-001,-001,-001,-001,-001,-001,-001,-001,-001,-001,-001,-001],
	[-001,-001,-001,-001,-001,-001,-001,-001,-001,-001,-001,-001,-001,-001,-001,-001,-001,-001,-001,-001,-001,-001,-001,-001,-001,-001,-001,-001,-001,-001,-001,-001,-001,-001,-001,-001,-001,-001,-001,-001],
	[-001,-001,-001,-001,-001,-001,-001,-001,-001,-001,-001,-001,-001,-001,-001,-001,-001,-001,-001,-001,-001,-001,-001,-001,-001,-001,-001,-001,-001,-001,-001,-001,-001,-001,-001,-001,-001,-001,-001,-001],
	[-001,-001,-001,-001,-001,-001,-001,-001,-001,-001,-001,-001,-001,-001,-001,-001,-001,-001,-001,-001,-001,-001,-001,-001,-001,-001,-001,-001,-001,-001,-001,-001,-001,-001,-001,-001,-001,-001,-001,-001],
	[-001,-001,-001,-001,-001,-001,-001,-001,-001,-001,-001,-001,-001,-001,-001,-001,-001,-001,-001,-001,-001,-001,-001,-001,-001,-001,-001,-001,-001,-001,-001,-001,-001,-001,-001,-001,-001,-001,-001,-001],
	[-001,-001,-001,-001,-001,-001,-001,-001,-001,-001,-001,-001,-001,-001,-001,-001,-001,-001,-001,-001,-001,-001,-001,-001,-001,-001,-001,-001,-001,-001,-001,-001,-001,-001,-001,-001,-001,-001,-001,-001],
	[-001,-001,-001,-001,-001,-001,-001,-001,-001,-001,-001,-001,-001,-001,-001,-001,-001,-001,-001,-001,-001,-001,-001,-001,-001,-001,-001,-001,-001,-001,-001,-001,-001,-001,-001,-001,-001,-001,-001,-001],
	[-001,-001,-001,-001,-001,-001,-001,-001,-001,-001,-001,-001,-001,-001,-001,-001,-001,-001,-001,-001,-001,-001,-001,-001,-001,-001,-001,-001,-001,-001,-001,-001,-001,-001,-001,-001,-001,-001,-001,-001],
	[-001,-001,-001,-001,-001,-001,-001,-001,-001,-001,-001,-001,-001,-001,-001,-001,-001,-001,-001,-001,-001,-001,-001,-001,-001,-001,-001,-001,-001,-001,-001,-001,-001,-001,-001,-001,-001,-001,-001,-001],
	[-001,-001,-001,-001,-001,-001,-001,-001,-001,-001,-001,-001,-001,-001,-001,-001,-001,-001,-001,-001,-001,-001,-001,-001,-001,-001,-001,-001,-001,-001,-001,-001,-001,-001,-001,-001,-001,-001,-001,-001],
	[-001,-001,-001,-001,-001,-001,-001,-001,-001,-001,-001,-001,-001,-001,-001,-001,-001,-001,-001,-001,-001,-001,-001,-001,-001,-001,-001,-001,-001,-001,-001,-001,-001,-001,-001,-001,-001,-001,-001,-001]
	],
	"events": [
	{
		"id": 5,
		"nom": "Clone[341][0021]",
		"x": 12,
		"y": 19
	},
	{
		"id": 11,
		"nom": "Clone[021][015]",
		"x": 6,
		"y": 7
	},
	{
		"id": 6,
		"nom": "Clone[341][0021]",
		"x": 12,
		"y": 17
	},
	{
		"id": 1,
		"nom": "Clone[341][0021]",
		"x": 15,
		"y": 16
	},
	{
		"id": 7,
		"nom": "Clone[341][0021]",
		"x": 13,
		"y": 16
	},
	{
		"id": 2,
		"nom": "Clone[341][0021]",
		"x": 14,
		"y": 17
	},
	{
		"id": 8,
		"nom": "Clone[341][0021]",
		"x": 15,
		"y": 18
	},
	{
		"id": 3,
		"nom": "Clone[341][0021]",
		"x": 13,
		"y": 18
	},
	{
		"id": 9,
		"nom": "Clone[341][0021]",
		"x": 14,
		"y": 19
	},
	{
		"id": 4,
		"nom": "EV004",
		"x": 24,
		"y": 14,
		"pages": [
		{
			"conditions": [
			{
				"nom": "ArriveeAuContact"
			}
			],
			"commandes": [
			{
				"nom": "ChangerDeMap",
				"variable": false,
				"numeroNouvelleMap": 32,
				"xDebutHeros": 19,
				"yDebutHeros": 12
			}
			],
			"vitesse": 8,
			"frequence": 8,
			"animeEnMouvement": true,
			"animeALArret": false,
			"directionFixe": false,
			"traversable": false,
			"auDessusDeTout": false
		}
		]
	},
	{
		"id": 10,
		"nom": "EV010",
		"x": 17,
		"y": 26,
		"pages": [
		{
			"conditions": [
			{
				"nom": "ArriveeAuContact"
			}
			],
			"commandes": [
			{
				"nom": "ChangerDeMap",
				"variable": false,
				"numeroNouvelleMap": 17,
				"xDebutHeros": 16,
				"yDebutHeros": 13
			}
			],
			"vitesse": 8,
			"frequence": 8,
			"animeEnMouvement": true,
			"animeALArret": false,
			"directionFixe": false,
			"traversable": false,
			"auDessusDeTout": false
		}
		]
	}
	]
}
