{
	"nom": "Salle 21 (miroirs et prisme)",
	"tileset": "Pyramide",
	"largeur": 21,
	"hauteur": 15,
	"couche0": [
	[0036,0037,0004,0016,0017,0018,0004,0038,0039,0036,0037,0005,0004,0005,0004,0005,0016,0017,0018,0038,0039],
	[0044,0045,0012,0024,0025,0026,0012,0046,0047,0044,0045,0013,0012,0013,0012,0013,0024,0025,0026,0046,0047],
	[0006,0007,0008,0008,0008,0008,0008,0020,0021,0006,0007,0019,0002,0002,0035,0008,0008,0008,0008,0028,0029],
	[0014,0015,0008,0008,0008,0008,0008,0028,0029,0014,0015,0027,0002,0002,0043,0008,0008,0008,0008,0020,0021],
	[0006,0007,0008,-004,0008,-004,0008,0020,0021,0006,0007,0027,0000,0019,0043,0010,0008,0008,0008,0028,0029],
	[0014,0015,0008,-004,0008,-004,0008,0028,0029,0014,0015,0027,0002,0068,0043,0008,0008,0008,0008,0020,0021],
	[0006,0007,0008,-004,0008,-004,0008,0020,0021,0006,0007,0027,0002,0002,0069,0002,0002,0002,0035,0028,0029],
	[0014,0015,0008,0008,0008,0008,0008,0028,0029,0014,0015,0027,0000,0019,0002,0035,0000,0019,0043,0020,0021],
	[0006,0007,-004,-004,0008,-004,-004,0020,0021,0006,0007,0027,0002,0068,0002,0069,0002,0068,0043,0028,0029],
	[0014,0015,0008,0008,0008,0008,0008,0028,0029,0014,0015,0027,0002,0002,0035,0008,0008,0008,0008,0020,0021],
	[0048,0049,0008,-004,0008,-004,0008,0020,0021,0006,0007,0027,0002,0002,0043,0008,0008,0008,0008,0050,0051],
	[0056,0057,0008,-004,0008,-004,0008,0028,0029,0014,0015,0027,0002,0002,0043,0008,0008,0008,0008,0058,0059],
	[0064,0065,0008,-004,0008,-004,0008,0020,0021,0006,0015,0071,0002,0002,0070,0008,0008,0008,0008,0066,0067],
	[0014,0015,0008,0008,0008,0008,0008,0020,0021,0052,0053,0022,0023,0022,0023,0022,0032,0033,0034,0054,0055],
	[0006,0007,-004,-004,-004,-004,-004,0028,0029,0060,0061,0030,0031,0030,0031,0030,0040,0041,0042,0062,0063]
	],
	"couche1": [
	[-001,-001,-001,-001,-001,-001,-001,-001,-001,-001,-001,-001,-001,-001,-001,-001,-001,-001,-001,-001,-001],
	[-001,-001,-001,-001,-001,-001,-001,-001,-001,-001,-001,-001,-001,-001,-001,-001,-001,-001,-001,-001,-001],
	[-001,-001,-001,-001,-001,-001,-001,-001,-001,-001,-001,-001,-001,-001,-001,-001,-001,-001,-001,-001,-001],
	[-001,-001,-001,-001,-001,-001,-001,-001,-001,-001,-001,-001,-001,-001,-001,-001,-001,-001,-001,-001,-001],
	[-001,-001,-001,-001,-001,-001,-001,-001,-001,-001,-001,-001,-001,-001,-001,-001,-001,-001,-001,-001,-001],
	[-001,-001,-001,-001,-001,-001,-001,-001,-001,-001,-001,-001,-001,-001,-001,-001,-001,-001,-001,-001,-001],
	[-001,-001,-001,-001,-001,-001,-001,-001,-001,-001,-001,-001,-001,-001,-001,-001,-001,-001,-001,-001,-001],
	[-001,-001,-001,-001,-001,-001,-001,-001,-001,-001,-001,-001,-001,-001,-001,-001,-001,-001,-001,-001,-001],
	[-001,-001,-001,-001,-001,-001,-001,-001,-001,-001,-001,-001,-001,-001,-001,-001,-001,-001,-001,-001,-001],
	[-001,-001,-001,-001,-001,-001,-001,-001,-001,-001,-001,-001,-001,-001,-001,-001,-001,-001,-001,-001,-001],
	[-001,-001,-001,-001,-001,-001,-001,-001,-001,-001,-001,-001,-001,-001,-001,-001,-001,-001,-001,-001,-001],
	[-001,-001,-001,-001,-001,-001,-001,-001,-001,-001,-001,-001,-001,-001,-001,-001,-001,-001,-001,-001,-001],
	[-001,-001,-001,-001,-001,-001,-001,-001,-001,-001,-001,-001,-001,-001,-001,-001,-001,-001,-001,-001,-001],
	[-001,-001,-001,-001,-001,-001,-001,-001,-001,-001,-001,-001,-001,-001,-001,-001,-001,-001,-001,-001,-001],
	[-001,-001,-001,-001,-001,-001,-001,-001,-001,-001,-001,-001,-001,-001,-001,-001,-001,-001,-001,-001,-001]
	],
	"couche2": [
	[-001,-001,-001,-001,-001,-001,-001,-001,-001,-001,-001,-001,-001,-001,-001,-001,-001,-001,-001,-001,-001],
	[-001,-001,-001,-001,-001,-001,-001,-001,-001,-001,-001,-001,-001,-001,-001,-001,-001,-001,-001,-001,-001],
	[-001,-001,-001,-001,-001,-001,-001,-001,-001,-001,-001,-001,-001,-001,-001,-001,-001,-001,-001,-001,-001],
	[-001,-001,-001,-001,-001,-001,-001,-001,-001,-001,-001,-001,-001,-001,-001,-001,-001,-001,-001,-001,-001],
	[-001,-001,-001,-001,-001,-001,-001,-001,-001,-001,-001,-001,-001,-001,-001,-001,-001,-001,-001,-001,-001],
	[-001,-001,-001,-001,-001,-001,-001,-001,-001,-001,-001,-001,-001,-001,-001,-001,-001,-001,-001,-001,-001],
	[-001,-001,-001,-001,-001,-001,-001,-001,-001,-001,-001,-001,-001,-001,-001,-001,-001,-001,-001,-001,-001],
	[-001,-001,-001,-001,-001,-001,-001,-001,-001,-001,-001,-001,-001,-001,-001,-001,-001,-001,-001,-001,-001],
	[-001,-001,-001,-001,-001,-001,-001,-001,-001,-001,-001,-001,-001,-001,-001,-001,-001,-001,-001,-001,-001],
	[-001,-001,-001,-001,-001,-001,-001,-001,-001,-001,-001,-001,-001,-001,-001,-001,-001,-001,-001,-001,-001],
	[-001,-001,-001,-001,-001,-001,-001,-001,-001,-001,-001,-001,-001,-001,-001,-001,-001,-001,-001,-001,-001],
	[-001,-001,-001,-001,-001,-001,-001,-001,-001,-001,-001,-001,-001,-001,-001,-001,-001,-001,-001,-001,-001],
	[-001,-001,-001,-001,-001,-001,-001,-001,-001,-001,-001,-001,-001,-001,-001,-001,-001,-001,-001,-001,-001],
	[-001,-001,-001,-001,-001,-001,-001,-001,-001,-001,-001,-001,-001,-001,-001,-001,-001,-001,-001,-001,-001],
	[-001,-001,-001,-001,-001,-001,-001,-001,-001,-001,-001,-001,-001,-001,-001,-001,-001,-001,-001,-001,-001]
	],
	"events": [
	{
		"id": 5,
		"nom": "EV005",
		"x": 17,
		"y": 0,
		"pages": [
		{
			"conditions": [
			{
				"nom": "ArriveeAuContact"
			}
			],
			"commandes": [
			{
				"nom": "ChangerDeMap",
				"variable": false,
				"numeroNouvelleMap": 80,
				"xDebutHeros": 17,
				"yDebutHeros": 13
			}
			],
			"vitesse": "moderee",
			"frequence": "basse",
			"animeEnMouvement": true,
			"animeALArret": false,
			"directionFixe": false,
			"traversable": false,
			"auDessusDeTout": false
		}
		]
	},
	{
		"id": 11,
		"nom": "Clone[21][28]",
		"x": 6,
		"y": 11
	},
	{
		"id": 6,
		"nom": "EV006",
		"x": 20,
		"y": 11,
		"pages": [
		{
			"conditions": [
			{
				"nom": "ArriveeAuContact"
			}
			],
			"commandes": [
			{
				"nom": "ChangerDeMap",
				"variable": false,
				"numeroNouvelleMap": 92,
				"xDebutHeros": 1,
				"yDebutHeros": 11
			}
			],
			"vitesse": "moderee",
			"frequence": "basse",
			"animeEnMouvement": true,
			"animeALArret": false,
			"directionFixe": false,
			"traversable": false,
			"auDessusDeTout": false
		}
		]
	},
	{
		"id": 1,
		"nom": "Clone[582][91]",
		"x": 16,
		"y": 10
	},
	{
		"id": 12,
		"nom": "Clone[21][27]",
		"x": 6,
		"y": 5
	},
	{
		"id": 7,
		"nom": "EV007",
		"x": 0,
		"y": 11,
		"pages": [
		{
			"conditions": [
			{
				"nom": "ArriveeAuContact"
			}
			],
			"commandes": [
			{
				"nom": "ChangerDeMap",
				"variable": false,
				"numeroNouvelleMap": 93,
				"xDebutHeros": 19,
				"yDebutHeros": 11
			}
			],
			"vitesse": "moderee",
			"frequence": "basse",
			"animeEnMouvement": true,
			"animeALArret": false,
			"directionFixe": false,
			"traversable": false,
			"auDessusDeTout": false
		}
		]
	},
	{
		"id": 2,
		"nom": "Clone[341][171]",
		"x": 16,
		"y": 7
	},
	{
		"id": 13,
		"nom": "Clone[21][27]",
		"x": 4,
		"y": 11
	},
	{
		"id": 8,
		"nom": "EV008",
		"x": 4,
		"y": 0,
		"pages": [
		{
			"conditions": [
			{
				"nom": "ArriveeAuContact"
			}
			],
			"commandes": [
			{
				"nom": "ChangerDeMap",
				"variable": false,
				"numeroNouvelleMap": 80,
				"xDebutHeros": 4,
				"yDebutHeros": 13
			}
			],
			"vitesse": "moderee",
			"frequence": "basse",
			"animeEnMouvement": true,
			"animeALArret": false,
			"directionFixe": false,
			"traversable": false,
			"auDessusDeTout": false
		}
		]
	},
	{
		"id": 3,
		"nom": "Clone[341][171]",
		"x": 12,
		"y": 7
	},
	{
		"id": 9,
		"nom": "EV009",
		"x": 17,
		"y": 14,
		"pages": [
		{
			"conditions": [
			{
				"nom": "ArriveeAuContact"
			}
			],
			"commandes": [
			{
				"nom": "ChangerDeMap",
				"variable": false,
				"numeroNouvelleMap": 62,
				"xDebutHeros": 17,
				"yDebutHeros": 1
			}
			],
			"vitesse": "moderee",
			"frequence": "basse",
			"animeEnMouvement": true,
			"animeALArret": false,
			"directionFixe": false,
			"traversable": false,
			"auDessusDeTout": false
		}
		]
	},
	{
		"id": 4,
		"nom": "Clone[341][172]",
		"x": 12,
		"y": 4
	},
	{
		"id": 10,
		"nom": "Clone[21][28]",
		"x": 2,
		"y": 5
	}
	]
}
