{
	"nom": "Salle 22 (prismes)",
	"tileset": "Pyramide",
	"largeur": 21,
	"hauteur": 15,
	"couche0": [
	[0036,0037,0005,0004,0005,0004,0005,0004,0005,0016,0017,0018,0005,0004,0005,0004,0005,0004,0005,0038,0039],
	[0044,0045,0013,0012,0013,0012,0013,0012,0013,0024,0025,0026,0013,0012,0013,0012,0013,0012,0013,0046,0047],
	[0006,0007,0000,0000,0000,0000,0000,0000,0238,0000,0238,0238,0000,0019,0002,0035,0342,0342,0342,0050,0051],
	[0014,0015,-004,-004,-004,-004,-004,-004,-004,-004,-004,-004,-004,0071,0002,0070,0342,0342,0342,0058,0059],
	[0006,0007,0019,0002,0035,0008,0008,0008,0019,0002,0002,0002,0035,0008,0008,0342,0342,0342,0342,0066,0067],
	[0014,0015,0027,0002,0043,0008,0008,0008,0027,0002,0002,0002,0043,0008,0008,0008,0342,0342,0342,0020,0021],
	[0006,0007,0027,0002,0043,0008,0008,0008,0027,0002,0002,0002,0043,0008,0008,0008,0008,0342,0342,0028,0029],
	[0014,0015,0027,0002,0043,0008,0008,0008,0027,0035,0008,0008,0008,0019,0002,0002,0002,0002,0035,0020,0021],
	[0006,0007,0027,0002,0043,0008,0008,0008,0027,0043,0008,0008,0008,0027,0002,0002,0002,0002,0043,0028,0029],
	[0014,0015,0071,0002,0070,0008,0008,0008,0027,0043,0008,0008,0008,0027,0002,0002,0002,0002,0043,0020,0021],
	[0048,0049,0008,0008,0008,0019,0002,0002,0068,0043,0008,0008,0008,0027,0002,0035,0008,0008,0008,0028,0029],
	[0056,0057,0008,0008,0008,0027,0002,0002,0002,0043,0008,0008,0008,0027,0002,0043,0008,0008,0008,0020,0021],
	[0064,0065,0008,0008,0008,0071,0002,0002,0002,0070,0008,0008,0008,0071,0002,0070,0008,0008,0008,0028,0029],
	[0052,0053,0022,0023,0022,0023,0022,0023,0022,0023,0022,0023,0022,0023,0022,0023,0032,0033,0034,0054,0055],
	[0060,0061,0030,0031,0030,0031,0030,0031,0030,0031,0030,0031,0030,0031,0030,0031,0040,0041,0042,0062,0063]
	],
	"couche1": [
	[-001,-001,-001,-001,-001,-001,-001,-001,-001,-001,-001,-001,-001,-001,-001,-001,-001,-001,-001,-001,-001],
	[-001,-001,-001,-001,-001,-001,-001,-001,-001,-001,-001,-001,-001,-001,-001,-001,-001,0347,0348,0349,-001],
	[-001,-001,-001,-001,-001,-001,-001,-001,-001,-001,-001,-001,-001,-001,-001,-001,-001,0355,0356,0357,-001],
	[-001,-001,-001,-001,-001,-001,-001,-001,-001,-001,-001,-001,-001,-001,-001,-001,0334,0363,0364,-001,-001],
	[-001,-001,-001,-001,-001,-001,-001,-001,-001,-001,-001,-001,-001,-001,-001,-001,-001,-001,0334,-001,-001],
	[-001,-001,-001,-001,-001,-001,-001,-001,-001,-001,-001,-001,-001,-001,-001,-001,-001,0335,-001,-001,-001],
	[-001,-001,-001,-001,-001,-001,-001,-001,-001,-001,-001,-001,-001,-001,-001,-001,-001,-001,-001,-001,-001],
	[-001,-001,-001,-001,-001,-001,-001,-001,-001,-001,-001,-001,-001,-001,-001,-001,-001,-001,-001,-001,-001],
	[-001,-001,-001,-001,-001,-001,-001,-001,-001,-001,-001,-001,-001,-001,-001,-001,-001,-001,-001,-001,-001],
	[-001,-001,-001,-001,-001,-001,-001,-001,-001,-001,-001,-001,-001,-001,-001,-001,-001,-001,-001,-001,-001],
	[-001,-001,-001,-001,-001,-001,-001,-001,-001,-001,-001,-001,-001,-001,-001,-001,-001,-001,-001,-001,-001],
	[-001,-001,-001,-001,-001,-001,-001,-001,-001,-001,-001,-001,-001,-001,-001,-001,-001,-001,-001,-001,-001],
	[-001,-001,-001,-001,-001,-001,-001,-001,-001,-001,-001,-001,-001,-001,-001,-001,-001,-001,-001,-001,-001],
	[-001,-001,-001,-001,-001,-001,-001,-001,-001,-001,-001,-001,-001,-001,-001,-001,-001,-001,-001,-001,-001],
	[-001,-001,-001,-001,-001,-001,-001,-001,-001,-001,-001,-001,-001,-001,-001,-001,-001,-001,-001,-001,-001]
	],
	"couche2": [
	[-001,-001,-001,-001,-001,-001,-001,-001,-001,-001,-001,-001,-001,-001,-001,-001,-001,-001,-001,-001,-001],
	[-001,-001,-001,-001,-001,-001,-001,-001,-001,-001,-001,-001,-001,-001,-001,-001,-001,-001,-001,-001,-001],
	[-001,-001,-001,-001,-001,-001,-001,-001,-001,-001,-001,-001,-001,-001,-001,-001,-001,-001,-001,-001,-001],
	[-001,-001,-001,-001,-001,-001,-001,-001,-001,-001,-001,-001,-001,-001,-001,-001,-001,-001,-001,-001,-001],
	[-001,-001,-001,-001,-001,-001,-001,-001,-001,-001,-001,-001,-001,-001,-001,-001,-001,-001,-001,-001,-001],
	[-001,-001,-001,-001,-001,-001,-001,-001,-001,-001,-001,-001,-001,-001,-001,-001,-001,-001,-001,-001,-001],
	[-001,-001,-001,-001,-001,-001,-001,-001,-001,-001,-001,-001,-001,-001,-001,-001,-001,-001,-001,-001,-001],
	[-001,-001,-001,-001,-001,-001,-001,-001,-001,-001,-001,-001,-001,-001,-001,-001,-001,-001,-001,-001,-001],
	[-001,-001,-001,-001,-001,-001,-001,-001,-001,-001,-001,-001,-001,-001,-001,-001,-001,-001,-001,-001,-001],
	[-001,-001,-001,-001,-001,-001,-001,-001,-001,-001,-001,-001,-001,-001,-001,-001,-001,-001,-001,-001,-001],
	[-001,-001,-001,-001,-001,-001,-001,-001,-001,-001,-001,-001,-001,-001,-001,-001,-001,-001,-001,-001,-001],
	[-001,-001,-001,-001,-001,-001,-001,-001,-001,-001,-001,-001,-001,-001,-001,-001,-001,-001,-001,-001,-001],
	[-001,-001,-001,-001,-001,-001,-001,-001,-001,-001,-001,-001,-001,-001,-001,-001,-001,-001,-001,-001,-001],
	[-001,-001,-001,-001,-001,-001,-001,-001,-001,-001,-001,-001,-001,-001,-001,-001,-001,-001,-001,-001,-001],
	[-001,-001,-001,-001,-001,-001,-001,-001,-001,-001,-001,-001,-001,-001,-001,-001,-001,-001,-001,-001,-001]
	],
	"events": [
	{
		"id": 5,
		"nom": "sable",
		"x": 19,
		"y": 3,
		"pages": [
		{
			"conditions": [
			{
				"nom": "Parler"
			}
			],
			"commandes": [
			],
			"image": 365,
			"vitesse": "moderee",
			"frequence": "basse",
			"animeEnMouvement": false,
			"animeALArret": false,
			"directionFixe": true,
			"traversable": true,
			"auDessusDeTout": false
		}
		]
	},
	{
		"id": 11,
		"nom": "sable qui tombe (-12)",
		"x": 17,
		"y": 5,
		"pages": [
		{
			"conditions": [
			{
				"nom": "Parler"
			}
			],
			"commandes": [
			],
			"image": "sable qui tombe character",
			"vitesse": "tres rapide",
			"frequence": "la plus haute",
			"animeEnMouvement": false,
			"animeALArret": true,
			"directionFixe": true,
			"traversable": true,
			"auDessusDeTout": false
		}
		]
	},
	{
		"id": 6,
		"nom": "Clone[582][91]",
		"x": 11,
		"y": 11
	},
	{
		"id": 1,
		"nom": "Clone[582][91]",
		"x": 14,
		"y": 5
	},
	{
		"id": 12,
		"nom": "Clone[341][078]",
		"x": 18,
		"y": 4
	},
	{
		"id": 7,
		"nom": "Clone[582][91]",
		"x": 6,
		"y": 8
	},
	{
		"id": 13,
		"nom": "sable qui tombe (-12)",
		"x": 18,
		"y": 2,
		"pages": [
		{
			"conditions": [
			{
				"nom": "Parler"
			}
			],
			"commandes": [
			],
			"image": "sable qui tombe character",
			"vitesse": "tres rapide",
			"frequence": "la plus haute",
			"animeEnMouvement": false,
			"animeALArret": true,
			"directionFixe": true,
			"traversable": true,
			"auDessusDeTout": false
		}
		]
	},
	{
		"id": 2,
		"nom": "EV002",
		"x": 17,
		"y": 14,
		"pages": [
		{
			"conditions": [
			{
				"nom": "ArriveeAuContact"
			}
			],
			"commandes": [
			{
				"nom": "ChangerDeMap",
				"variable": false,
				"numeroNouvelleMap": 65,
				"xDebutHeros": 17,
				"yDebutHeros": 1
			}
			],
			"vitesse": "moderee",
			"frequence": "basse",
			"animeEnMouvement": true,
			"animeALArret": false,
			"directionFixe": false,
			"traversable": false,
			"auDessusDeTout": false
		}
		]
	},
	{
		"id": 8,
		"nom": "EV008",
		"x": 0,
		"y": 11,
		"pages": [
		{
			"conditions": [
			{
				"nom": "ArriveeAuContact"
			}
			],
			"commandes": [
			{
				"nom": "ChangerDeMap",
				"variable": false,
				"numeroNouvelleMap": 89,
				"xDebutHeros": 19,
				"yDebutHeros": 11
			}
			],
			"vitesse": "moderee",
			"frequence": "basse",
			"animeEnMouvement": true,
			"animeALArret": false,
			"directionFixe": false,
			"traversable": false,
			"auDessusDeTout": false
		}
		]
	},
	{
		"id": 3,
		"nom": "Clone[582][91]",
		"x": 2,
		"y": 2
	},
	{
		"id": 14,
		"nom": "Clone[341][078]",
		"x": 16,
		"y": 3
	},
	{
		"id": 9,
		"nom": "EV009",
		"x": 20,
		"y": 3,
		"pages": [
		{
			"conditions": [
			{
				"nom": "ArriveeAuContact"
			}
			],
			"commandes": [
			{
				"nom": "ChangerDeMap",
				"variable": false,
				"numeroNouvelleMap": 71,
				"xDebutHeros": 1,
				"yDebutHeros": 3
			}
			],
			"vitesse": "moderee",
			"frequence": "basse",
			"animeEnMouvement": true,
			"animeALArret": false,
			"directionFixe": false,
			"traversable": false,
			"auDessusDeTout": false
		}
		]
	},
	{
		"id": 4,
		"nom": "Clone[582][91]",
		"x": 18,
		"y": 10
	},
	{
		"id": 10,
		"nom": "EV010",
		"x": 10,
		"y": 0,
		"pages": [
		{
			"conditions": [
			{
				"nom": "ArriveeAuContact"
			}
			],
			"commandes": [
			{
				"nom": "ChangerDeMap",
				"variable": false,
				"numeroNouvelleMap": 78,
				"xDebutHeros": 10,
				"yDebutHeros": 13
			}
			],
			"vitesse": "moderee",
			"frequence": "basse",
			"animeEnMouvement": true,
			"animeALArret": false,
			"directionFixe": false,
			"traversable": false,
			"auDessusDeTout": false
		}
		]
	}
	]
}
