{
	"nom": "Ruines des grenouilles",
	"tileset": "Marais",
	"largeur": 40,
	"hauteur": 35,
	"musique": {
		"nomFichierSonore": "Marais.mp3",
		"volume": 1.00,
		"tempo": 1.00
	},
	"fondSonore": {
		"nomFichierSonore": "006-Rain02.ogg",
		"volume": 1.00,
		"tempo": 1.00
	},
	"couche0": [
	[0809,0809,0809,0809,0809,0809,0809,0809,0809,0809,0809,0809,0809,0809,0809,0809,0809,0809,0809,0809,0809,0809,0809,0809,0809,0809,0809,0809,0809,0809,0809,0809,0809,0809,0809,0809,0809,0809,0809,0809],
	[0809,0809,0809,0809,0809,0809,0809,0809,0809,0809,0809,0809,0809,0809,0809,0809,0809,0809,0809,0809,0809,0809,0809,0809,0809,0809,0809,0809,0809,0809,0809,0809,0809,0809,0809,0809,0809,0809,0809,0809],
	[0809,0809,0809,0809,0809,0809,0809,0809,0891,0897,0897,0897,0897,0897,0897,0897,0897,0886,0897,0897,0897,0897,0897,0892,0891,0897,0897,0909,0897,0897,0892,0809,0809,0809,0809,0809,0809,0809,0809,0809],
	[0809,0809,0809,0809,0809,0809,0809,0809,0890,0891,0897,0897,0897,0897,0897,0897,0897,0897,0897,0897,0897,0897,0892,0888,0903,0891,0897,0917,0897,0892,0888,0809,0809,0809,0809,0809,0809,0809,0809,0809],
	[0809,0809,0809,0809,0809,0809,0891,0897,0898,0890,-008,-008,-008,-008,-008,-008,-008,-008,-008,-008,-008,-008,0888,0888,0890,0890,-008,-008,-008,0888,0896,0897,0892,0809,0809,0809,0809,0809,0809,0809],
	[0809,0809,0809,0809,0809,0809,0890,0891,0897,0898,-008,-008,-008,-008,-008,-008,-008,-008,-008,0880,0881,0881,0900,0896,0898,0890,-008,-008,-008,0896,0897,0892,0895,0809,0809,0809,0809,0809,0809,0809],
	[0809,0809,0809,0809,0809,0809,0890,0890,-008,-008,-008,-008,-008,-008,-008,-008,-008,-008,-008,0895,0889,0889,0889,0889,0889,0890,-008,-008,-008,-008,-008,0888,0888,0809,0809,0809,0809,0809,0809,0809],
	[0809,0809,0809,0809,0809,0809,0890,0903,-008,-008,-008,-008,-008,-008,-008,-008,-008,-008,-008,0888,0889,0889,0889,0889,0891,0898,-008,-008,-008,-008,0885,0895,0888,0809,0809,0809,0809,0809,0809,0809],
	[0809,0809,0809,0809,0809,0809,0890,0890,-008,-008,-008,-008,-008,-008,-008,-008,-008,-008,-008,0888,0889,0889,0889,0889,0890,-008,-008,-008,0885,0885,0885,0888,0888,0809,0809,0809,0809,0809,0809,0809],
	[0809,0809,0809,0809,0809,0809,0903,0890,-008,-008,-008,-008,-008,-008,0885,0885,0885,-008,-008,0896,0897,0897,0897,0897,0898,-008,-008,0885,0885,0885,0885,0888,0888,0809,0809,0809,0809,0809,0809,0809],
	[0897,0897,0909,0909,0897,0897,0898,0890,-008,-008,-008,-008,-008,0885,0885,0885,0885,0885,-008,-008,-008,-008,-008,0885,0885,0885,-008,0885,0885,0885,0885,0888,0888,0809,0809,0809,0809,0809,0809,0809],
	[0897,0897,0917,0917,0897,0897,0897,0898,0885,0885,0885,-008,0885,0885,0880,0881,0882,0885,0885,-008,-008,-008,-008,-008,-008,-008,-008,0885,0885,0885,0885,0888,0888,0809,0809,0809,0809,0809,0809,0809],
	[0885,0885,0885,0885,0885,0885,0885,0885,0885,0885,0885,-008,0885,0885,0888,0889,0890,0885,0885,-008,-008,-008,-008,-008,-008,-008,-008,-008,-008,0885,0885,0888,0888,0809,0809,0809,0809,0809,0809,0809],
	[0881,0881,0881,0881,0881,0881,0881,0882,0885,0885,0885,-008,0885,0885,0896,0897,0898,0885,0885,-008,-008,-008,-008,-008,-008,-008,-008,0885,0885,-008,0885,0888,0888,0809,0809,0809,0809,0809,0809,0809],
	[0881,0881,0881,0881,0881,0881,0882,0890,-008,-008,-008,-008,-008,-008,0885,0885,0885,0885,-008,-008,0885,0880,0881,0881,0882,0885,-008,0885,0885,-008,-008,0888,0888,0809,0809,0809,0809,0809,0809,0809],
	[0809,0809,0809,0809,0809,0809,0903,0890,-008,-008,-008,-008,-008,-008,0885,0885,0885,0885,-008,-008,0885,0888,0889,0889,0899,0881,0882,-008,-008,-008,-008,0888,0896,0897,0892,0809,0809,0809,0809,0809],
	[0809,0809,0809,0809,0809,0809,0890,0890,-008,-008,-008,-008,-008,-008,-008,-008,-008,-008,-008,0880,0881,0900,0889,0889,0889,0889,0890,-008,-008,-008,-008,0888,0889,0889,0896,0897,0909,0909,0897,0897],
	[0809,0809,0809,0809,0809,0809,0890,0903,-008,-008,-008,-008,-008,-008,-008,-008,-008,-008,-008,0888,0889,0889,0889,0889,0889,0889,0890,-008,-008,-008,-008,0896,0897,0897,0897,0897,0917,0917,0897,0897],
	[0809,0809,0809,0809,0809,0809,0890,0890,-008,-008,-008,-008,-008,-008,-008,-008,-008,-008,-008,0888,0889,0889,0889,0889,0891,0897,0898,0885,-008,0885,0885,0885,0885,0885,0885,0885,0885,0885,0885,0885],
	[0809,0809,0809,0809,0809,0809,0890,0890,-008,-008,-008,-008,-008,-008,-008,-008,-008,-008,-008,0888,0889,0889,0889,0889,0903,0885,0885,0885,-008,-008,-008,0880,0881,0881,0881,0881,0881,0881,0881,0881],
	[0809,0809,0809,0809,0809,0809,0890,0890,-008,-008,-008,-008,-008,-008,-008,-008,-008,-008,0885,0896,0897,0897,0897,0897,0898,0885,0885,-008,-008,-008,-008,0888,0880,0881,0881,0881,0881,0881,0881,0881],
	[0809,0809,0809,0809,0809,0809,0890,0890,-008,-008,-008,-008,-008,-008,-008,-008,-008,0885,0885,0885,0885,0885,0885,0885,0885,-008,-008,-008,-008,-008,-008,0888,0888,0809,0809,0809,0809,0809,0809,0809],
	[0809,0809,0809,0809,0809,0809,0903,0890,-008,-008,-008,-008,-008,-008,-008,-008,0885,0885,0885,0885,0885,0885,0885,0885,-008,-008,-008,-008,0885,0885,0885,0895,0888,0809,0809,0809,0809,0809,0809,0809],
	[0809,0809,0809,0809,0809,0809,0890,0890,-008,-008,-008,-008,-008,-008,-008,0885,0885,0885,0885,0885,0885,0885,0885,0885,0885,-008,-008,-008,0885,0885,0885,0888,0888,0809,0809,0809,0809,0809,0809,0809],
	[0809,0809,0809,0809,0809,0809,0890,0899,0881,0882,-008,-008,-008,-008,-008,0885,0885,0885,0885,0885,0885,0885,0885,0885,-008,-008,-008,-008,-008,0880,0881,0900,0895,0809,0809,0809,0809,0809,0809,0809],
	[0809,0809,0809,0809,0809,0809,0899,0881,0882,0890,-008,-008,-008,-008,-008,-008,0885,0885,0885,0885,0885,0885,0885,0885,-008,-008,-008,-008,-008,0888,0880,0881,0900,0809,0809,0809,0809,0809,0809,0809],
	[0809,0809,0809,0809,0809,0809,0809,0809,0890,0899,0881,0881,0881,0881,0881,0881,0881,0881,0881,0881,0881,0881,0881,0881,0881,0881,0881,0881,0881,0900,0888,0809,0809,0809,0809,0809,0809,0809,0809,0809],
	[0809,0809,0809,0809,0809,0809,0809,0809,0899,0881,0881,0881,0881,0881,0881,0881,0881,0881,0881,0881,0881,0881,0881,0881,0881,0881,0881,0881,0881,0881,0900,0809,0809,0809,0809,0809,0809,0809,0809,0809],
	[0809,0809,0809,0809,0809,0809,0809,0809,0809,0809,0809,0809,0809,0809,0809,0809,0809,0809,0809,0809,0809,0809,0809,0809,0809,0809,0809,0809,0809,0809,0809,0809,0809,0809,0809,0809,0809,0809,0809,0809],
	[0809,0809,0809,0809,0809,0809,0809,0809,0809,0809,0809,0809,0809,0809,0809,0809,0809,0809,0809,0809,0809,0809,0809,0809,0809,0809,0809,0809,0809,0809,0809,0809,0809,0809,0809,0809,0809,0809,0809,0809],
	[0809,0809,0809,0809,0809,0809,0809,0809,0809,0809,0809,0809,0809,0809,0809,0809,0809,0809,0809,0809,0809,0809,0809,0809,0809,0809,0809,0809,0809,0809,0809,0809,0809,0809,0809,0809,0809,0809,0809,0809],
	[0809,0809,0809,0809,0809,0809,0809,0809,0809,0809,0809,0809,0809,0809,0809,0809,0809,0809,0809,0809,0809,0809,0809,0809,0809,0809,0809,0809,0809,0809,0809,0809,0809,0809,0809,0809,0809,0809,0809,0809],
	[0809,0809,0809,0809,0809,0809,0809,0809,0809,0809,0809,0809,0809,0809,0809,0809,0809,0809,0809,0809,0809,0809,0809,0809,0809,0809,0809,0809,0809,0809,0809,0809,0809,0809,0809,0809,0809,0809,0809,0809],
	[0809,0809,0809,0809,0809,0809,0809,0809,0809,0809,0809,0809,0809,0809,0809,0809,0809,0809,0809,0809,0809,0809,0809,0809,0809,0809,0809,0809,0809,0809,0809,0809,0809,0809,0809,0809,0809,0809,0809,0809],
	[0809,0809,0809,0809,0809,0809,0809,0809,0809,0809,0809,0809,0809,0809,0809,0809,0809,0809,0809,0809,0809,0809,0809,0809,0809,0809,0809,0809,0809,0809,0809,0809,0809,0809,0809,0809,0809,0809,0809,0809]
	],
	"couche1": [
	[-001,-001,-001,-001,-001,-001,-001,-001,-001,-001,-001,-001,-001,-001,-001,-001,-001,-001,-001,-001,-001,-001,-001,-001,-001,-001,-001,-001,-001,-001,-001,-001,-001,-001,-001,-001,-001,-001,-001,-001],
	[-001,-001,-001,-001,-001,-001,-001,-001,-001,-001,-001,-001,-001,-001,-001,-001,-001,-001,-001,-001,-001,-001,-001,-001,-001,-001,-001,-001,-001,-001,-001,-001,-001,-001,-001,-001,-001,-001,-001,-001],
	[-001,-001,-001,-001,-001,-001,-001,-001,-001,-001,-001,-001,-001,-001,-001,-001,-001,0887,-001,-001,-001,-001,-001,-001,-001,-001,-001,-001,-001,-001,-001,-001,-001,-001,-001,-001,-001,-001,-001,-001],
	[-001,-001,-001,-001,-001,-001,-001,-001,0658,0659,-001,-001,0188,-001,-001,-001,-001,-001,-001,-001,-001,-001,-001,-001,-001,-001,-001,-001,-001,-001,-001,-001,-001,-001,-001,-001,-001,-001,-001,-001],
	[-001,-001,-001,-001,-001,-001,-001,-001,0666,0667,-001,-001,0196,-001,-001,-001,-001,-001,-001,-001,-001,-001,-001,-001,-001,-001,-001,-001,-001,-001,-001,-001,-001,-001,-001,-001,-001,-001,-001,-001],
	[-001,-001,-001,-001,-001,-001,-001,-001,-001,-001,-001,-001,-001,0317,0318,0300,-001,-001,-001,-001,0248,0249,0250,-001,-001,-001,-001,-001,-001,-001,-001,-001,-001,-001,-001,-001,-001,-001,-001,-001],
	[-001,-001,-001,-001,-001,-001,-001,-001,-001,-001,-001,-001,-001,0325,0326,0327,0308,-001,-001,-001,0202,0203,0204,-001,-001,-001,-001,-001,-001,-001,-001,-001,-001,-001,-001,-001,-001,-001,-001,-001],
	[-001,-001,-001,-001,-001,-001,-001,-001,-001,-001,-001,-001,-001,0333,0334,0335,-001,-001,-001,-001,0210,0211,0212,-001,-001,-001,-001,-001,-001,-001,-001,-001,-001,-001,-001,-001,-001,-001,-001,-001],
	[-001,-001,-001,-001,-001,-001,-001,-001,-001,-001,-001,-001,-001,-001,-001,-001,0317,0318,0319,-001,-001,-001,-001,-001,-001,-001,-001,-001,0248,0249,0250,-001,-001,-001,-001,-001,-001,-001,-001,-001],
	[-001,-001,-001,-001,-001,-001,-001,-001,0248,0249,0250,-001,0188,0180,-001,-001,0325,0326,0327,-001,-001,-001,-001,-001,-001,-001,-001,-001,0256,0257,0258,-001,-001,-001,-001,-001,-001,-001,-001,-001],
	[-001,-001,-001,-001,-001,-001,-001,-001,0256,0257,0258,-001,0196,-001,-001,-001,0333,0334,0335,-001,-001,0325,0326,0327,-001,-001,-001,-001,0264,0265,0266,-001,-001,-001,-001,-001,-001,-001,-001,-001],
	[-001,-001,-001,-001,-001,-001,-001,-001,0264,0265,0266,-001,-001,-001,-001,-001,-001,-001,-001,-001,-001,0333,0334,0335,-001,0180,-001,0317,0318,0319,-001,-001,-001,-001,-001,-001,-001,-001,-001,-001],
	[-001,-001,-001,-001,-001,-001,-001,-001,-001,-001,-001,-001,-001,-001,-001,-001,-001,-001,-001,-001,0188,-001,-001,-001,-001,-001,-001,0325,0326,0327,-001,-001,-001,-001,-001,-001,-001,-001,-001,-001],
	[-001,-001,-001,-001,-001,-001,-001,-001,0324,-001,-001,-001,0188,-001,-001,-001,-001,0304,0305,0306,0196,0180,-001,-001,-001,0317,0318,0319,0334,0180,-001,-001,-001,-001,-001,-001,-001,-001,-001,-001],
	[-001,-001,-001,-001,-001,-001,-001,-001,0332,-001,-001,-001,0196,0180,-001,-001,-001,0312,0313,0314,0315,-001,-001,-001,-001,0325,0326,0327,-001,-001,-001,-001,-001,-001,-001,-001,-001,-001,-001,-001],
	[-001,-001,-001,-001,-001,-001,-001,-001,-001,-001,-001,-001,-001,0180,0188,-001,-001,0320,0321,0322,0323,-001,-001,-001,-001,-001,-001,-001,-001,-001,-001,-001,-001,-001,-001,-001,-001,-001,-001,-001],
	[-001,-001,-001,-001,-001,-001,-001,-001,-001,-001,-001,-001,-001,-001,0196,0180,0180,0328,0329,-001,-001,-001,-001,-001,-001,-001,-001,0324,-001,-001,0188,-001,-001,-001,-001,-001,-001,-001,-001,-001],
	[-001,-001,-001,-001,-001,-001,-001,-001,-001,-001,-001,-001,-001,-001,-001,-001,-001,-001,-001,-001,-001,-001,-001,-001,-001,-001,-001,0332,-001,0180,0196,-001,-001,-001,-001,-001,-001,-001,-001,-001],
	[-001,-001,-001,-001,-001,-001,-001,-001,-001,-001,-001,-001,-001,-001,-001,-001,-001,-001,0324,-001,-001,-001,-001,-001,-001,-001,-001,-001,-001,-001,-001,-001,-001,-001,-001,-001,-001,-001,-001,-001],
	[-001,-001,-001,-001,-001,-001,-001,-001,-001,0304,0305,0306,0300,-001,-001,-001,0317,0318,0332,-001,-001,-001,-001,-001,-001,0768,0768,-001,-001,-001,0180,-001,-001,-001,-001,-001,-001,-001,-001,-001],
	[-001,-001,-001,-001,-001,-001,-001,-001,-001,0312,0313,0314,0315,0308,-001,-001,0325,0326,0327,-001,-001,-001,-001,-001,-001,0768,0188,0180,-001,-001,-001,-001,-001,-001,-001,-001,-001,-001,-001,-001],
	[-001,-001,-001,-001,-001,-001,-001,-001,-001,0320,0321,0322,0323,-001,-001,-001,0180,0334,0335,-001,-001,-001,0248,0249,0250,0180,0196,0768,-001,-001,-001,-001,-001,-001,-001,-001,-001,-001,-001,-001],
	[-001,-001,-001,-001,-001,-001,-001,-001,-001,0308,0329,0330,0331,-001,-001,0248,0249,0250,-001,-001,-001,-001,0256,0257,0258,-001,-001,-001,-001,-001,-001,-001,-001,-001,-001,-001,-001,-001,-001,-001],
	[-001,-001,-001,-001,-001,-001,-001,-001,-001,-001,-001,-001,-001,-001,-001,0256,0257,0258,-001,-001,-001,-001,0264,0265,0266,-001,-001,-001,-001,-001,-001,-001,-001,-001,-001,-001,-001,-001,-001,-001],
	[-001,-001,-001,-001,-001,-001,-001,-001,-001,-001,-001,-001,-001,-001,-001,0264,0265,0266,-001,-001,-001,-001,-001,-001,-001,-001,-001,-001,-001,-001,-001,-001,-001,-001,-001,-001,-001,-001,-001,-001],
	[-001,-001,-001,-001,-001,-001,-001,-001,-001,-001,-001,-001,-001,-001,-001,-001,-001,-001,-001,-001,-001,-001,-001,-001,-001,-001,-001,-001,-001,-001,-001,-001,-001,-001,-001,-001,-001,-001,-001,-001],
	[-001,-001,-001,-001,-001,-001,-001,-001,-001,-001,-001,-001,-001,-001,-001,-001,-001,-001,-001,-001,-001,-001,-001,-001,-001,-001,-001,-001,-001,-001,-001,-001,-001,-001,-001,-001,-001,-001,-001,-001],
	[-001,-001,-001,-001,-001,-001,-001,-001,-001,-001,-001,-001,-001,-001,-001,-001,-001,-001,-001,-001,-001,-001,-001,-001,-001,-001,-001,-001,-001,-001,-001,-001,-001,-001,-001,-001,-001,-001,-001,-001],
	[-001,-001,-001,-001,-001,-001,-001,-001,-001,-001,-001,-001,-001,-001,-001,-001,-001,-001,-001,-001,-001,-001,-001,-001,-001,-001,-001,-001,-001,-001,-001,-001,-001,-001,-001,-001,-001,-001,-001,-001],
	[-001,-001,-001,-001,-001,-001,-001,-001,-001,-001,-001,-001,-001,-001,-001,-001,-001,-001,-001,-001,-001,-001,-001,-001,-001,-001,-001,-001,-001,-001,-001,-001,-001,-001,-001,-001,-001,-001,-001,-001],
	[-001,-001,-001,-001,-001,-001,-001,-001,-001,-001,-001,-001,-001,-001,-001,-001,-001,-001,-001,-001,-001,-001,-001,-001,-001,-001,-001,-001,-001,-001,-001,-001,-001,-001,-001,-001,-001,-001,-001,-001],
	[-001,-001,-001,-001,-001,-001,-001,-001,-001,-001,-001,-001,-001,-001,-001,-001,-001,-001,-001,-001,-001,-001,-001,-001,-001,-001,-001,-001,-001,-001,-001,-001,-001,-001,-001,-001,-001,-001,-001,-001],
	[-001,-001,-001,-001,-001,-001,-001,-001,-001,-001,-001,-001,-001,-001,-001,-001,-001,-001,-001,-001,-001,-001,-001,-001,-001,-001,-001,-001,-001,-001,-001,-001,-001,-001,-001,-001,-001,-001,-001,-001],
	[-001,-001,-001,-001,-001,-001,-001,-001,-001,-001,-001,-001,-001,-001,-001,-001,-001,-001,-001,-001,-001,-001,-001,-001,-001,-001,-001,-001,-001,-001,-001,-001,-001,-001,-001,-001,-001,-001,-001,-001],
	[-001,-001,-001,-001,-001,-001,-001,-001,-001,-001,-001,-001,-001,-001,-001,-001,-001,-001,-001,-001,-001,-001,-001,-001,-001,-001,-001,-001,-001,-001,-001,-001,-001,-001,-001,-001,-001,-001,-001,-001]
	],
	"couche2": [
	[-001,-001,-001,-001,-001,-001,-001,-001,-001,-001,-001,-001,-001,-001,-001,-001,-001,-001,-001,-001,-001,-001,-001,-001,-001,-001,-001,-001,-001,-001,-001,-001,-001,-001,-001,-001,-001,-001,-001,-001],
	[-001,-001,-001,-001,-001,-001,-001,-001,-001,-001,-001,-001,-001,-001,-001,-001,-001,-001,-001,-001,-001,-001,-001,-001,-001,-001,-001,-001,-001,-001,-001,-001,-001,-001,-001,-001,-001,-001,-001,-001],
	[-001,-001,-001,-001,-001,-001,-001,-001,-001,-001,-001,-001,-001,-001,-001,-001,-001,-001,-001,-001,-001,-001,-001,-001,-001,-001,-001,-001,-001,-001,-001,-001,-001,-001,-001,-001,-001,-001,-001,-001],
	[-001,-001,-001,-001,-001,-001,-001,-001,-001,-001,-001,-001,-001,-001,-001,-001,-001,-001,-001,-001,-001,-001,-001,-001,-001,-001,-001,-001,-001,-001,-001,-001,-001,-001,-001,-001,-001,-001,-001,-001],
	[-001,-001,-001,-001,-001,-001,-001,-001,-001,-001,-001,-001,-001,-001,-001,-001,-001,-001,-001,-001,-001,-001,-001,-001,-001,-001,-001,-001,-001,-001,-001,-001,-001,-001,-001,-001,-001,-001,-001,-001],
	[-001,-001,-001,-001,-001,-001,-001,-001,-001,-001,-001,-001,-001,-001,-001,-001,-001,-001,-001,-001,-001,-001,-001,-001,-001,-001,-001,-001,-001,-001,-001,-001,-001,-001,-001,-001,-001,-001,-001,-001],
	[-001,-001,-001,-001,-001,-001,-001,-001,-001,-001,-001,-001,-001,-001,-001,-001,-001,-001,-001,-001,-001,-001,-001,-001,-001,-001,-001,-001,-001,-001,-001,-001,-001,-001,-001,-001,-001,-001,-001,-001],
	[-001,-001,-001,-001,-001,-001,-001,-001,-001,-001,-001,-001,-001,-001,-001,-001,-001,-001,-001,-001,-001,-001,-001,-001,-001,-001,0306,0307,-001,-001,-001,-001,-001,-001,-001,-001,-001,-001,-001,-001],
	[-001,-001,-001,-001,-001,-001,-001,-001,-001,-001,-001,-001,-001,-001,-001,-001,-001,-001,-001,-001,-001,-001,-001,-001,-001,0313,0314,0315,-001,-001,-001,-001,-001,-001,-001,-001,-001,-001,-001,-001],
	[-001,-001,-001,-001,-001,-001,-001,-001,-001,-001,-001,-001,-001,-001,-001,-001,-001,-001,-001,-001,-001,0188,-005,-001,-001,0321,0322,0323,-001,-001,-001,-001,-001,-001,-001,-001,-001,-001,-001,-001],
	[-001,-001,-001,-001,-001,-001,-001,-001,-001,-001,-001,-001,-001,-001,-001,-001,-001,0768,0769,0770,-001,0196,-001,-001,0328,0329,0330,0331,-001,-001,-001,-001,-001,-001,-001,-001,-001,-001,-001,-001],
	[-001,-001,-001,-001,-001,-001,-001,-001,-001,-001,0317,0318,0319,-001,-001,-001,-001,0776,0777,0778,-001,-001,-001,-001,-001,-001,-001,-001,-001,-001,-001,-001,-001,-001,-001,-001,-001,-001,-001,-001],
	[-001,-001,-001,-001,-001,-001,-001,-001,-001,-001,0325,0326,0327,-001,-001,-001,-001,0784,0785,0786,-001,-001,-001,-001,-001,-001,-001,-001,-001,-001,0638,0639,0590,0591,-001,-001,-001,-001,-001,-001],
	[-001,-001,-001,-001,-001,-001,-001,-001,-001,-001,0333,0334,0335,-001,-001,-005,-001,-001,-001,-001,-001,-001,-001,-001,-001,-001,-001,-001,-001,-001,0646,0647,0598,0599,-001,-001,-001,-001,-001,-001],
	[-001,-001,-001,-001,-001,-001,-001,-001,-001,-001,-001,-001,-001,-001,-001,-001,-001,-001,-001,-001,-001,-001,-001,-001,-001,-001,-001,-001,-001,-001,0654,0655,0606,0607,-001,-001,-001,-001,-001,-001],
	[-001,-001,-001,-001,-001,-001,-001,-001,-001,-001,-001,-001,-001,-001,-001,-001,-001,-001,-001,-001,-001,-001,-001,-001,-001,-004,-001,-001,-001,-001,0662,0663,0614,0615,-001,-001,-001,-001,-001,-001],
	[-001,-001,-001,-001,-001,-001,-001,-001,-001,-001,-001,-001,-001,-001,-001,-001,-001,-001,-001,-001,-004,-001,-001,-001,-001,-001,-001,-001,-001,-001,-001,0671,0622,0623,-001,-001,-001,-001,-001,-001],
	[-001,-001,-001,-001,-001,-001,-001,-001,-001,-001,-001,-001,-001,-001,-001,-001,-001,-001,-001,-001,-001,-001,-001,-001,-001,-001,-001,-001,0318,-001,-001,0679,0630,0631,-001,-001,-001,-001,-001,-001],
	[-001,-001,-001,-001,-001,-001,-001,-001,-001,-001,-001,-001,-001,-001,-001,-001,-001,-001,-001,-001,-001,-001,-001,-001,-001,-005,-001,0325,0326,0327,-001,-001,-001,-001,-001,-001,-001,-001,-001,-001],
	[-001,-001,-001,-001,-001,-001,-001,-001,-001,-001,-001,-001,-001,-001,-001,-001,-001,-001,-001,-001,-001,-001,-001,-001,-001,-001,-001,0333,0334,0335,-001,-001,-001,-001,-001,-001,-001,-001,-001,-001],
	[-001,-001,-001,-001,-001,-001,-001,-001,-001,-001,-001,-001,-001,-001,-001,-001,-001,-001,-001,-001,-005,-001,-001,-001,-001,-001,-001,-001,-001,-001,-001,-001,-001,-001,-001,-001,-001,-001,-001,-001],
	[-001,-001,-001,-001,-001,-001,-001,-001,-001,-001,-001,-001,-001,-001,-001,0188,-001,-001,-001,-001,-001,-001,-001,-001,-001,-001,-001,-001,-001,-001,-001,-001,-001,-001,-001,-001,-001,-001,-001,-001],
	[-001,-001,-001,-001,-001,-001,-001,-001,-001,-001,0317,0318,0319,-001,-001,0196,-001,-001,-001,-001,-001,-001,-001,-001,-001,-001,-001,-001,-001,-001,-001,-001,-001,-001,-001,-001,-001,-001,-001,-001],
	[-001,-001,-001,-001,-001,-001,-001,-001,-001,-001,0325,0326,0327,-001,-001,-001,-001,-001,-001,-001,-001,-001,0228,0317,0318,0319,-001,-001,0227,-001,-001,-001,-001,-001,-001,-001,-001,-001,-001,-001],
	[-001,-001,-001,-001,-001,-001,-001,-001,-001,-001,0333,0334,0335,-001,-001,-001,-001,-001,-001,-001,-001,-001,-001,0325,0326,0327,-001,-001,-001,-001,-001,-001,-001,-001,-001,-001,-001,-001,-001,-001],
	[-001,-001,-001,-001,-001,-001,-001,-001,-001,-001,-001,-001,-001,-001,-001,-001,-001,-001,-001,-001,-001,-001,-001,0333,0334,0335,-001,-001,-001,-001,-001,-001,-001,-001,-001,-001,-001,-001,-001,-001],
	[-001,-001,-001,-001,-001,-001,-001,-001,-001,-001,-001,-001,-001,-001,-001,-001,-001,-001,-001,-001,-001,-001,-001,-001,-001,-001,-001,-001,-001,-001,-001,-001,-001,-001,-001,-001,-001,-001,-001,-001],
	[-001,-001,-001,-001,-001,-001,-001,-001,-001,-001,-001,-001,-001,-001,-001,-001,-001,-001,-001,-001,-001,-001,-001,-001,-001,-001,-001,-001,-001,-001,-001,-001,-001,-001,-001,-001,-001,-001,-001,-001],
	[-001,-001,-001,-001,-001,-001,-001,-001,-001,-001,-001,-001,-001,-001,-001,-001,-001,-001,-001,-001,-001,-001,-001,-001,-001,-001,-001,-001,-001,-001,-001,-001,-001,-001,-001,-001,-001,-001,-001,-001],
	[-001,-001,-001,-001,-001,-001,-001,-001,-001,-001,-001,-001,-001,-001,-001,-001,-001,-001,-001,-001,-001,-001,-001,-001,-001,-001,-001,-001,-001,-001,-001,-001,-001,-001,-001,-001,-001,-001,-001,-001],
	[-001,-001,-001,-001,-001,-001,-001,-001,-001,-001,-001,-001,-001,-001,-001,-001,-001,-001,-001,-001,-001,-001,-001,-001,-001,-001,-001,-001,-001,-001,-001,-001,-001,-001,-001,-001,-001,-001,-001,-001],
	[-001,-001,-001,-001,-001,-001,-001,-001,-001,-001,-001,-001,-001,-001,-001,-001,-001,-001,-001,-001,-001,-001,-001,-001,-001,-001,-001,-001,-001,-001,-001,-001,-001,-001,-001,-001,-001,-001,-001,-001],
	[-001,-001,-001,-001,-001,-001,-001,-001,-001,-001,-001,-001,-001,-001,-001,-001,-001,-001,-001,-001,-001,-001,-001,-001,-001,-001,-001,-001,-001,-001,-001,-001,-001,-001,-001,-001,-001,-001,-001,-001],
	[-001,-001,-001,-001,-001,-001,-001,-001,-001,-001,-001,-001,-001,-001,-001,-001,-001,-001,-001,-001,-001,-001,-001,-001,-001,-001,-001,-001,-001,-001,-001,-001,-001,-001,-001,-001,-001,-001,-001,-001],
	[-001,-001,-001,-001,-001,-001,-001,-001,-001,-001,-001,-001,-001,-001,-001,-001,-001,-001,-001,-001,-001,-001,-001,-001,-001,-001,-001,-001,-001,-001,-001,-001,-001,-001,-001,-001,-001,-001,-001,-001]
	],
	"events": [
	{
		"id": 5,
		"nom": "Clone[21][48]",
		"x": 26,
		"y": 14
	},
	{
		"id": 22,
		"nom": "Clone[341][0080]",
		"x": 28,
		"y": 23
	},
	{
		"id": 11,
		"nom": "Clone[341][061]",
		"x": 18,
		"y": 16
	},
	{
		"id": 17,
		"nom": "Clone[341][028]",
		"x": 29,
		"y": 22
	},
	{
		"id": 6,
		"nom": "EV006",
		"x": 39,
		"y": 18,
		"pages": [
		{
			"conditions": [
			{
				"nom": "ArriveeAuContact"
			}
			],
			"commandes": [
			{
				"nom": "ChangerDeMap",
				"variable": false,
				"numeroNouvelleMap": 206,
				"xDebutHeros": 1,
				"yDebutHeros": 11
			}
			],
			"vitesse": "moderee",
			"frequence": "basse",
			"animeEnMouvement": true,
			"animeALArret": false,
			"directionFixe": false,
			"traversable": false,
			"auDessusDeTout": false
		}
		]
	},
	{
		"id": 23,
		"nom": "Clone[341][0087]",
		"x": 22,
		"y": 23
	},
	{
		"id": 1,
		"nom": "cascade",
		"x": 17,
		"y": 4,
		"pages": [
		{
			"conditions": [
			{
				"nom": "Parler"
			}
			],
			"commandes": [
			],
			"image": "cascade character",
			"opacite": 250,
			"vitesse": "rapide",
			"frequence": "tres haute",
			"animeEnMouvement": false,
			"animeALArret": true,
			"directionFixe": true,
			"traversable": true,
			"auDessusDeTout": false
		}
		]
	},
	{
		"id": 12,
		"nom": "EV012",
		"x": 0,
		"y": 12,
		"pages": [
		{
			"conditions": [
			{
				"nom": "ArriveeAuContact"
			}
			],
			"commandes": [
			{
				"nom": "ChangerDeMap",
				"variable": false,
				"numeroNouvelleMap": 214,
				"xDebutHeros": 33,
				"yDebutHeros": 16
			}
			],
			"vitesse": "moderee",
			"frequence": "basse",
			"animeEnMouvement": true,
			"animeALArret": false,
			"directionFixe": false,
			"traversable": false,
			"auDessusDeTout": false
		}
		]
	},
	{
		"id": 7,
		"nom": "brouillard de forêt",
		"x": 20,
		"y": 27,
		"pages": [
		{
			"conditions": [
			],
			"commandes": [
			{
				"nom": "ModifierMeteo",
				"type": "pluie",
				"intensite": 5
			},
			{
				"nom": "EffacerImage",
				"numero": 3
			},
			{
				"nom": "ModifierBrouillard",
				"opacite": 75,
				"modeDeFusion": "normal",
				"defilementX": -20,
				"defilementY": 105,
				"zoom": 200,
				"nuance": 0,
				"nomImage": "essai pluie brouillard"
			},
			{
				"nom": "ModifierTonDeLEcran",
				"rouge": 115,
				"vert": 140,
				"bleu": 127,
				"gris": 0,
				"dureeTransition": 0
			},
			{
				"nom": "SupprimerEvent"
			}
			],
			"vitesse": "moderee",
			"frequence": "basse",
			"animeEnMouvement": true,
			"animeALArret": false,
			"directionFixe": false,
			"traversable": false,
			"auDessusDeTout": false
		}
		]
	},
	{
		"id": 2,
		"nom": "Clone[341][135]",
		"x": 11,
		"y": 20
	},
	{
		"id": 8,
		"nom": "Clone[341][061]",
		"x": 28,
		"y": 19
	},
	{
		"id": 3,
		"nom": "Clone[21][48]",
		"x": 15,
		"y": 12
	},
	{
		"id": 20,
		"nom": "Clone[341][028]",
		"x": 24,
		"y": 6
	},
	{
		"id": 4,
		"nom": "Clone[21][48]",
		"x": 21,
		"y": 23
	},
	{
		"id": 15,
		"nom": "EV015",
		"x": 21,
		"y": 6,
		"pages": [
		{
			"conditions": [
			{
				"nom": "ArriveeAuContact"
			}
			],
			"commandes": [
			{
				"nom": "ConditionDirection",
				"idEventConcerne": 0,
				"direction": 3,
				"numero": 0
			},
			{
				"nom": "ChangerDeMap",
				"variable": false,
				"numeroNouvelleMap": 316,
				"xDebutHeros": 11,
				"yDebutHeros": 14
			},
			{
				"nom": "ConditionSinon",
				"numero": 0
			},
			{
				"nom": "ConditionFin",
				"numero": 0
			}
			],
			"vitesse": "moderee",
			"frequence": "basse",
			"animeEnMouvement": true,
			"animeALArret": false,
			"directionFixe": false,
			"traversable": false,
			"auDessusDeTout": false
		}
		]
	},
	{
		"id": 10,
		"nom": "Clone[341][036]",
		"x": 10,
		"y": 11
	},
	{
		"id": 21,
		"nom": "Clone[341][008]",
		"x": 30,
		"y": 22
	}
	]
}
