{
	"nom": "Hutte de l'Ermite",
	"tileset": "Maison",
	"largeur": 21,
	"hauteur": 15,
	"musique": {
		"nomFichierSonore": "Maison.ogg",
		"volume": 1.00,
		"tempo": 1.00
	},
	"fondSonore": {
		"nomFichierSonore": "Forêt rayman 1.mp3",
		"volume": 0.00,
		"tempo": 1.00
	},
	"couche0": [
	[0017,0017,0017,0017,0017,0017,0017,0017,0017,0017,0017,0017,0017,0017,0017,0017,0017,0017,0017,0017,0017],
	[0017,0017,0017,0017,0017,0017,0017,0017,0017,0017,0017,0017,0017,0017,0017,0017,0017,0017,0017,0017,0017],
	[0017,0017,0017,0017,0017,0017,0145,0146,0147,0148,0148,0148,0149,0150,0151,0017,0017,0017,0017,0017,0017],
	[0017,0017,0017,0017,0017,0152,0153,0154,0155,0156,0156,0156,0157,0216,0159,0224,0017,0017,0017,0017,0017],
	[0017,0017,0017,0017,0017,0160,0161,0162,0163,0164,0164,0164,0165,0166,0167,0232,0017,0017,0017,0017,0017],
	[0017,0017,0017,0017,0017,0168,0169,0170,0171,0172,0172,0172,0173,0174,0175,0240,0017,0017,0017,0017,0017],
	[0017,0017,0017,0017,0017,0176,0177,0178,0179,0180,0180,0180,0181,0182,0183,0248,0017,0017,0017,0017,0017],
	[0017,0017,0017,0017,0017,0176,0177,0178,0179,0180,0180,0180,0181,0182,0183,0248,0017,0017,0017,0017,0017],
	[0017,0017,0017,0017,0017,0176,0177,0178,0179,0180,0180,0180,0181,0182,0183,0248,0017,0017,0017,0017,0017],
	[0017,0017,0017,0017,0017,0184,0185,0186,0187,0188,0188,0188,0189,0190,0191,0256,0017,0017,0017,0017,0017],
	[0017,0017,0017,0017,0017,0192,0193,0194,0195,0196,0188,0188,0197,0198,0199,0264,0017,0017,0017,0017,0017],
	[0017,0017,0017,0017,0017,0200,0201,0208,0203,0204,0204,0204,0205,0206,0207,0272,0017,0017,0017,0017,0017],
	[0017,0017,0017,0017,0017,0017,0209,0210,0211,0212,0236,0212,0213,0214,0215,0017,0017,0017,0017,0017,0017],
	[0017,0017,0017,0017,0017,0017,0017,0017,0017,0017,0017,0017,0017,0017,0017,0017,0017,0017,0017,0017,0017],
	[0017,0017,0017,0017,0017,0017,0017,0017,0017,0017,0017,0017,0017,0017,0017,0017,0017,0017,0017,0017,0017]
	],
	"couche1": [
	[-001,-001,-001,-001,-001,-001,-001,-001,-001,-001,-001,-001,-001,-001,-001,-001,-001,-001,-001,-001,-001],
	[-001,-001,-001,-001,-001,-001,-001,-001,-001,-001,-001,-001,-001,-001,-001,-001,-001,-001,-001,-001,-001],
	[-001,-001,-001,-001,-001,-001,-001,-001,-001,0070,0028,0029,-001,-001,-001,-001,-001,-001,-001,-001,-001],
	[-001,-001,-001,-001,-001,-001,-001,-001,-001,0078,0036,0037,-001,-001,-001,-001,-001,-001,-001,-001,-001],
	[-001,-001,-001,-001,-001,-001,-001,-001,-001,-001,0044,0045,-001,-001,-001,-001,-001,-001,-001,-001,-001],
	[-001,-001,-001,-001,-001,-001,-001,-001,-001,-001,-001,-001,-001,-001,-001,-001,-001,-001,-001,-001,-001],
	[-001,-001,-001,-001,-001,-001,-001,0005,0007,-001,-001,-001,-001,-001,-001,-001,-001,-001,-001,-001,-001],
	[-001,-001,-001,-001,-001,-001,-001,0013,0015,0002,-001,-001,0030,0031,-001,-001,-001,-001,-001,-001,-001],
	[-001,-001,-001,-001,-001,-001,-001,-001,-001,-001,-001,-001,0038,0039,-001,-001,-001,-001,-001,-001,-001],
	[-001,-001,-001,-001,-001,-001,-001,-001,-001,-001,-001,-001,0046,0047,-001,-001,-001,-001,-001,-001,-001],
	[-001,-001,-001,-001,-001,-001,-001,-001,-001,-001,-001,-001,-001,-001,-001,-001,-001,-001,-001,-001,-001],
	[-001,-001,-001,-001,-001,-001,-001,-001,-001,0219,0220,0221,-001,-001,-001,-001,-001,-001,-001,-001,-001],
	[-001,-001,-001,-001,-001,-001,-001,-001,-001,0227,0228,0229,-001,-001,-001,-001,-001,-001,-001,-001,-001],
	[-001,-001,-001,-001,-001,-001,-001,-001,-001,-001,-001,-001,-001,-001,-001,-001,-001,-001,-001,-001,-001],
	[-001,-001,-001,-001,-001,-001,-001,-001,-001,-001,-001,-001,-001,-001,-001,-001,-001,-001,-001,-001,-001]
	],
	"couche2": [
	[-001,-001,-001,-001,-001,-001,-001,-001,-001,-001,-001,-001,-001,-001,-001,-001,-001,-001,-001,-001,-001],
	[-001,-001,-001,-001,-001,-001,-001,-001,-001,-001,-001,-001,-001,-001,-001,-001,-001,-001,-001,-001,-001],
	[-001,-001,-001,-001,-001,-001,-001,-001,-001,-001,-001,-001,-001,-001,-001,-001,-001,-001,-001,-001,-001],
	[-001,-001,-001,-001,-001,-001,-001,-001,-001,-001,-001,-001,-001,-001,-001,-001,-001,-001,-001,-001,-001],
	[-001,-001,-001,-001,-001,-001,-001,-001,-001,-001,-001,-001,-001,-001,-001,-001,-001,-001,-001,-001,-001],
	[-001,-001,-001,-001,-001,-001,-001,-001,-001,-001,-001,-001,-001,-001,-001,-001,-001,-001,-001,-001,-001],
	[-001,-001,-001,-001,-001,-001,-001,-001,0300,-001,-001,-001,-001,-001,-001,-001,-001,-001,-001,-001,-001],
	[-001,-001,-001,-001,-001,-001,-001,-001,-001,-001,-001,-001,-001,-001,-001,-001,-001,-001,-001,-001,-001],
	[-001,-001,-001,-001,-001,-001,-001,-001,-001,-001,-001,-001,-001,-001,-001,-001,-001,-001,-001,-001,-001],
	[-001,-001,-001,-001,-001,-001,-001,-001,-001,-001,-001,-001,-001,-001,-001,-001,-001,-001,-001,-001,-001],
	[-001,-001,-001,-001,-001,-001,-001,-001,-001,-001,-001,-001,-001,-001,-001,-001,-001,-001,-001,-001,-001],
	[-001,-001,-001,-001,-001,-001,-001,-001,-001,-001,-001,-001,-001,-001,-001,-001,-001,-001,-001,-001,-001],
	[-001,-001,-001,-001,-001,-001,-001,-001,-001,-001,-001,-001,-001,-001,-001,-001,-001,-001,-001,-001,-001],
	[-001,-001,-001,-001,-001,-001,-001,-001,-001,-001,-001,-001,-001,-001,-001,-001,-001,-001,-001,-001,-001],
	[-001,-001,-001,-001,-001,-001,-001,-001,-001,-001,-001,-001,-001,-001,-001,-001,-001,-001,-001,-001,-001]
	],
	"events": [
	{
		"id": 5,
		"nom": "Clone[341][004]",
		"x": 13,
		"y": 6
	},
	{
		"id": 6,
		"nom": "Parchemin",
		"x": 9,
		"y": 3,
		"pages": [
		{
			"conditions": [
			{
				"nom": "Parler"
			}
			],
			"commandes": [
			{
				"nom": "ModifierInterrupteur",
				"numeroInterrupteur": 12,
				"valeur": true
			},
			{
				"nom": "Message",
				"texte": "\"Au vieil étang\\nUne grenouille saute :\\nBruit d'eau\""
			},
			{
				"nom": "Message",
				"texte": "\\c[02]Matsuo Bashô\\c[02]"
			},
			{
				"nom": "Attendre",
				"nombreDeFrames": 8
			},
			{
				"nom": "ModifierInterrupteur",
				"numeroInterrupteur": 12,
				"valeur": false
			}
			],
			"vitesse": "moderee",
			"frequence": "basse",
			"animeEnMouvement": true,
			"animeALArret": false,
			"directionFixe": false,
			"traversable": false,
			"auDessusDeTout": false
		}
		]
	},
	{
		"id": 1,
		"nom": "Clone[341][006]",
		"x": 7,
		"y": 8
	},
	{
		"id": 7,
		"nom": "EV007",
		"x": 10,
		"y": 11,
		"pages": [
		{
			"conditions": [
			{
				"nom": "ArriveeAuContact"
			}
			],
			"commandes": [
			{
				"nom": "ChangerDeMap",
				"variable": false,
				"numeroNouvelleMap": 136,
				"xDebutHeros": 13,
				"yDebutHeros": 13
			}
			],
			"vitesse": "moderee",
			"frequence": "basse",
			"animeEnMouvement": true,
			"animeALArret": false,
			"directionFixe": false,
			"traversable": false,
			"auDessusDeTout": false
		}
		]
	},
	{
		"id": 2,
		"nom": "EV002",
		"x": 15,
		"y": 2,
		"pages": [
		{
			"conditions": [
			],
			"commandes": [
			{
				"nom": "EffacerImage",
				"numero": 3
			},
			{
				"nom": "SupprimerEvent"
			}
			],
			"vitesse": "moderee",
			"frequence": "basse",
			"animeEnMouvement": true,
			"animeALArret": false,
			"directionFixe": false,
			"traversable": false,
			"auDessusDeTout": false
		}
		]
	},
	{
		"id": 8,
		"nom": "Clone[341][004]",
		"x": 12,
		"y": 10
	},
	{
		"id": 9,
		"nom": "Clone[341][004]",
		"x": 8,
		"y": 10
	},
	{
		"id": 4,
		"nom": "Clone[341][004]",
		"x": 13,
		"y": 5
	}
	]
}
