{
	"nom": "Lueurs",
	"tileset": "Intestins",
	"largeur": 30,
	"hauteur": 30,
	"musique": {
		"nomFichierSonore": "Mineurs du Fin-fond.ogg",
		"volume": 1.00,
		"tempo": 1.00
	},
	"fondSonore": {
		"nomFichierSonore": "016-Drips01.ogg",
		"volume": 1.00,
		"tempo": 0.50
	},
	"couche0": [
	[0000,0000,0009,0011,0017,0000,0000,0000,0000,0000,0009,0011,0011,0011,0017,0000,0000,0000,0000,0021,0011,0011,0011,0022,0000,0000,0000,0021,0022,0000],
	[0000,0009,0017,0000,0000,0000,0000,0000,0009,0011,0017,0000,0000,0000,0000,0000,0000,0000,0000,0000,0000,0000,0000,0021,0022,0000,0000,0000,0046,0000],
	[0009,0017,0000,0000,0000,0009,0011,0011,0017,0000,0000,0000,0000,0000,0009,0011,0011,0011,0011,0011,0022,0000,0000,0000,0021,0022,0000,0000,0046,0000],
	[0032,0000,0000,0000,0009,0017,0000,0000,0000,0000,0009,0011,0011,0011,0017,0000,0000,0000,0000,0000,0021,0012,0022,0000,0000,0046,0000,0000,0046,0000],
	[0017,0000,0000,0009,0017,0000,0000,0000,0009,0011,0017,0000,0000,0000,0000,0009,0012,0012,0012,0022,0000,0000,0021,0022,0000,0046,0000,0000,0021,0022],
	[0000,0000,0000,0032,0000,0000,0009,0011,0017,0000,0000,0009,0011,0011,0011,0017,0000,0000,0000,0021,0012,0022,0000,0046,0000,0046,0000,0000,0000,0046],
	[0000,0000,0009,0017,0000,0009,0017,0000,0000,0009,0011,0017,0000,0009,0010,0010,0010,0010,0010,0022,0000,0046,0000,0046,0000,0021,0022,0000,0000,0046],
	[0000,0000,0032,0000,0000,0032,0000,0009,0011,0017,0000,0000,0009,0017,0009,0010,0111,0010,0022,0030,0000,0046,0000,0046,0000,0000,0046,0000,0000,0021],
	[0000,0000,0032,0000,0000,0032,0000,0032,0000,0000,0009,0010,0017,0009,0017,-008,-008,-008,0030,0021,0022,0046,0000,0021,0022,0000,0046,0000,0000,0000],
	[0000,0000,0032,0000,0009,0017,0000,0032,0009,0010,0017,0009,0010,0017,-008,-008,-008,-007,0021,0022,0046,0021,0022,0000,0046,0000,0021,0022,0000,0000],
	[0000,0000,0032,0000,0032,0000,0009,0017,0032,0009,0010,0017,-007,-008,-008,-008,-008,-007,0008,0030,0046,0000,0046,0000,0046,0000,0000,0046,0000,0000],
	[0000,0000,0032,0000,0032,0000,0032,0000,0032,0032,0018,0019,-007,-008,-007,-007,-007,-007,-007,0038,0046,0000,0046,0000,0046,0000,0000,0046,0000,0000],
	[0000,0000,0032,0000,0032,0000,0032,0000,0032,0032,-007,-007,-007,-008,-007,0008,-007,-008,-008,0046,0046,0000,0046,0000,0046,0000,0000,0046,0000,0000],
	[0000,0000,0032,0000,0032,0000,0032,0000,0032,0032,-008,-008,-007,-007,-007,-007,-007,-008,-008,0046,0046,0000,0046,0000,0046,0000,0000,0046,0000,0000],
	[0000,0000,0032,0000,0032,0000,0032,0000,0032,0032,-008,-008,-007,0018,0019,-007,-008,-008,-008,0046,0046,0000,0046,0000,0046,0000,0000,0046,0000,0000],
	[0000,0000,0032,0000,0032,0000,0032,0000,0032,0032,-008,-008,-007,-007,-007,-007,-007,-007,0053,0054,0046,0053,0054,0000,0046,0000,0053,0054,0000,0000],
	[0000,0000,0032,0000,0032,0000,0032,0000,0032,0032,-008,-008,-008,-008,-008,-007,0018,0019,0046,0053,0054,0046,0000,0053,0054,0000,0046,0000,0000,0000],
	[0000,0000,0032,0000,0032,0000,0048,0049,0032,0048,0049,-008,-008,-008,-008,-007,0053,0059,0054,0046,0000,0046,0000,0046,0000,0000,0046,0000,0000,0053],
	[0000,0000,0032,0000,0048,0049,0000,0032,0048,0049,0032,-007,-007,-008,-008,-008,0038,0053,0059,0054,0000,0046,0000,0046,0000,0000,0046,0000,0000,0046],
	[0000,0000,0032,0000,0000,0032,0000,0032,0000,0032,0032,0008,-007,-008,-008,-008,0046,0038,0000,0053,0059,0054,0000,0046,0000,0000,0046,0000,0000,0046],
	[0000,0000,0032,0000,0000,0032,0000,0032,0000,0032,0048,0049,-007,-008,-008,0053,0054,0046,0000,0046,0000,0000,0053,0054,0000,0053,0054,0000,0000,0046],
	[0000,0000,0032,0000,0000,0032,0000,0048,0049,0048,0049,0032,-008,-008,-008,0046,0053,0054,0000,0046,0000,0053,0054,0000,0000,0046,0000,0000,0000,0046],
	[0000,0000,0048,0049,0000,0048,0049,0000,0032,0000,0032,0048,0059,0118,0059,0054,0046,0000,0053,0054,0000,0046,0000,0000,0053,0054,0000,0000,0053,0054],
	[0000,0000,0000,0032,0000,0000,0032,0000,0032,0000,0048,0059,0059,0059,0059,0059,0054,0000,0046,0000,0053,0054,0000,0000,0046,0000,0000,0000,0046,0000],
	[0049,0000,0000,0032,0000,0000,0032,0000,0048,0059,0049,0000,0000,0000,0053,0059,0059,0059,0054,0000,0046,0000,0000,0000,0046,0000,0000,0053,0054,0000],
	[0032,0000,0000,0032,0000,0000,0048,0049,0000,0000,0048,0059,0059,0059,0054,0000,0000,0000,0000,0053,0054,0000,0000,0053,0054,0000,0000,0046,0000,0000],
	[0032,0000,0000,0048,0049,0000,0000,0048,0059,0049,0000,0000,0000,0000,0000,0053,0059,0059,0059,0054,0000,0000,0053,0054,0000,0000,0000,0046,0000,0000],
	[0032,0000,0000,0000,0048,0049,0000,0000,0000,0048,0059,0059,0059,0059,0059,0054,0000,0000,0000,0000,0000,0053,0054,0000,0000,0000,0053,0054,0000,0000],
	[0048,0049,0000,0000,0000,0048,0049,0000,0000,0000,0000,0000,0000,0000,0000,0000,0000,0000,0000,0053,0059,0054,0000,0000,0000,0053,0054,0000,0000,0000],
	[0000,0048,0049,0000,0000,0000,0048,0059,0049,0000,0000,0000,0000,0000,0000,0053,0059,0059,0059,0054,0000,0000,0000,0000,0053,0054,0000,0000,0000,0053]
	],
	"couche1": [
	[-001,-001,-001,-001,-001,-001,-001,-001,-001,-001,-001,-001,-001,-001,-001,-001,-001,0133,0134,0135,-001,-001,-001,-001,-001,-001,0133,0134,0135,-001],
	[-001,-001,-001,0133,0134,0135,-001,-001,-001,-001,-001,-001,-001,-001,-001,-001,-001,0141,0142,0143,-001,-001,-001,-001,-001,-001,0141,0142,0143,-001],
	[-001,-001,-001,0141,0142,0143,-001,-001,-001,-001,-001,-001,-001,-001,-001,-001,-001,-001,-001,-001,-001,-001,-001,-001,-001,-001,-001,-001,-001,-001],
	[-001,-001,-001,-001,-001,-001,-001,-001,0127,-001,0133,0134,0135,-001,-001,-001,-001,-001,0127,-001,-001,-001,-001,-001,-001,-001,-001,-001,-001,-001],
	[-001,-001,-001,-001,-001,-001,-001,-001,-001,-001,0141,0142,0143,-001,-001,-001,0133,0134,0135,-001,-001,-001,-001,-001,-001,-001,-001,-001,-001,-001],
	[-001,-001,-001,-001,-001,-001,-001,-001,-001,-001,-001,-001,-001,-001,-001,-001,0141,0142,0143,-001,-001,-001,-001,-001,-001,-001,-001,-001,-001,-001],
	[-001,-001,-001,-001,-001,-001,-001,-001,-001,-001,-001,-001,-001,-001,-001,-001,0036,-001,-001,-001,-001,0133,0134,0135,-001,-001,-001,-001,-001,-001],
	[-001,-001,-001,-001,-001,-001,-001,-001,-001,-001,0127,-001,-001,-001,-001,-001,0004,-001,-001,-001,-001,0141,0142,0143,-001,-001,-001,-001,-001,-001],
	[-001,-001,-001,-001,-001,-001,-001,-001,-001,-001,-001,-001,-001,-001,-001,-001,-001,-001,-001,-001,-001,-001,-001,-001,-001,-001,-001,0127,-001,-001],
	[0134,0135,-001,-001,0133,0134,0135,-001,-001,-001,-001,-001,-001,-001,-001,-001,-001,-001,-001,-001,-001,-001,-001,-001,-001,-001,-001,-001,-001,-001],
	[0142,0143,-001,-001,0141,0142,0143,-001,-001,-001,-001,-001,-001,-001,-001,-001,-001,-001,-001,-001,-001,0127,-001,-001,-001,-001,-001,-001,-001,-001],
	[-001,-001,-001,-001,-001,-001,-001,-001,-001,-001,-001,-001,-001,-001,-001,-001,-001,-001,-001,-001,-001,-001,-001,-001,-001,-001,-001,-001,-001,-001],
	[-001,-001,-001,-001,-001,-001,-001,-001,-001,-001,-001,-001,-001,-001,-001,-001,-001,-001,-001,-001,-001,-001,-001,-001,-001,0133,0134,0135,-001,-001],
	[-001,-001,-001,-001,-001,-001,-001,-001,-001,-001,-001,-001,-001,-001,-001,-001,-001,-001,-001,-001,-001,-001,-001,-001,-001,0141,0142,0143,-001,-001],
	[-001,0127,-001,-001,-001,-001,-001,-001,-001,-001,-001,-001,-001,-001,-001,-001,-001,-001,-001,-001,-001,-001,-001,-001,-001,-001,-001,-001,-001,-001],
	[-001,-001,-001,-001,-001,-001,-001,-001,-001,-001,-001,-001,-001,-001,-001,-001,-001,-001,-001,-001,-001,-001,-001,-001,-001,-001,0133,0134,0135,-001],
	[-001,-001,-001,-001,-001,-001,-001,0127,-001,-001,-001,-001,-001,-001,-001,-001,-001,-001,-001,-001,-001,-001,-001,-001,-001,-001,0141,0142,0143,-001],
	[-001,-001,-001,-001,-001,-001,-001,-001,-001,-001,-001,-001,-001,-001,-001,-001,-001,-001,-001,0133,0134,0135,-001,-001,-001,-001,-001,-001,-001,-001],
	[-001,-001,-001,-001,-001,-001,-001,-001,-001,-001,-001,-001,-001,-001,-001,-001,-001,-001,-001,0141,0142,0143,-001,-001,-001,-001,-001,-001,-001,-001],
	[-001,-001,0133,0134,0135,-001,-001,-001,-001,-001,-001,-001,-001,-001,-001,-001,-001,-001,-001,-001,-001,-001,0127,-001,-001,-001,-001,-001,-001,-001],
	[-001,-001,0141,0142,0143,-001,-001,-001,-001,-001,-001,-001,-001,-001,-001,-001,-001,-001,-001,-001,-001,-001,-001,-001,-001,-001,-001,-001,-001,-001],
	[-001,-001,-001,-001,-001,-001,-001,-001,0133,0134,0135,-001,-001,-001,-001,-001,-001,-001,-001,-001,-001,-001,-001,-001,-001,-001,-001,-001,-001,-001],
	[-001,-001,-001,-001,-001,-001,-001,-001,0141,0142,0143,-001,-001,0050,-001,-001,-001,0127,-001,-001,-001,-001,-001,-001,-001,-001,-001,-001,-001,-001],
	[-001,-001,-001,-001,-001,-001,-001,-001,-001,-001,-001,-001,-001,-001,-001,-001,-001,-001,-001,-001,0133,0134,0135,-001,-001,0127,-001,-001,-001,-001],
	[-001,-001,-001,-001,-001,-001,-001,-001,-001,-001,-001,-001,-001,-001,-001,0133,0134,0135,-001,-001,0141,0142,0143,-001,-001,-001,-001,-001,-001,-001],
	[-001,-001,-001,-001,0127,-001,-001,-001,-001,-001,-001,-001,-001,-001,-001,0141,0142,0143,-001,-001,-001,-001,-001,-001,-001,-001,-001,-001,-001,-001],
	[-001,-001,-001,-001,-001,-001,-001,-001,-001,-001,0127,-001,-001,-001,-001,-001,-001,-001,-001,-001,-001,-001,-001,-001,-001,-001,-001,-001,-001,-001],
	[-001,-001,-001,-001,-001,-001,-001,-001,-001,-001,-001,-001,-001,-001,-001,-001,-001,-001,-001,-001,-001,-001,-001,-001,-001,-001,-001,-001,-001,-001],
	[-001,-001,-001,-001,-001,-001,-001,-001,-001,-001,-001,-001,-001,-001,-001,-001,-001,-001,0127,-001,-001,-001,-001,-001,-001,-001,-001,-001,-001,-001],
	[-001,-001,-001,-001,-001,-001,-001,-001,-001,-001,-001,-001,-001,-001,-001,-001,-001,-001,-001,-001,-001,-001,-001,-001,-001,-001,-001,-001,-001,-001]
	],
	"couche2": [
	[-001,-001,-001,-001,-001,-001,-001,-001,-001,-001,-001,-001,-001,-001,-001,-001,-001,-001,-001,-001,-001,-001,-001,-001,-001,-001,-001,-001,-001,-001],
	[-001,-001,-001,-001,-001,-001,-001,-001,-001,-001,-001,-001,-001,-001,-001,-001,-001,-001,-001,-001,-001,-001,-001,-001,-001,-001,-001,-001,-001,-001],
	[-001,-001,-001,-001,-001,-001,-001,-001,-001,-001,-001,-001,-001,-001,-001,-001,-001,-001,-001,-001,-001,-001,-001,-001,-001,-001,-001,-001,-001,-001],
	[-001,-001,-001,-001,-001,-001,-001,-001,-001,-001,-001,-001,-001,-001,-001,-001,-001,-001,-001,-001,-001,-001,-001,-001,-001,-001,-001,-001,-001,-001],
	[-001,-001,-001,-001,-001,-001,-001,-001,-001,-001,-001,-001,-001,-001,-001,-001,-001,-001,-001,-001,-001,-001,-001,-001,-001,-001,-001,-001,-001,-001],
	[-001,-001,-001,-001,-001,-001,-001,-001,-001,-001,-001,-001,-001,-001,-001,-001,-001,-001,-001,-001,-001,-001,-001,-001,-001,-001,-001,-001,-001,-001],
	[-001,-001,-001,-001,-001,-001,-001,-001,-001,-001,-001,-001,-001,-001,-001,-001,-001,-001,-001,-001,-001,-001,-001,-001,-001,-001,-001,-001,-001,-001],
	[-001,-001,-001,-001,-001,-001,-001,-001,-001,-001,-001,-001,-001,-001,-001,-001,-001,-001,-001,-001,-001,-001,-001,-001,-001,-001,-001,-001,-001,-001],
	[-001,-001,-001,-001,-001,-001,-001,-001,-001,-001,-001,-001,-001,-001,-001,-001,-001,-001,-001,-001,-001,-001,-001,-001,-001,-001,-001,-001,-001,-001],
	[-001,-001,-001,-001,-001,-001,-001,-001,-001,-001,-001,-001,-001,-001,-001,-001,-001,-001,-001,-001,-001,-001,-001,-001,-001,-001,-001,-001,-001,-001],
	[-001,-001,-001,-001,-001,-001,-001,-001,-001,-001,-001,-001,-001,-001,-001,-001,-001,-001,-001,-001,-001,-001,-001,-001,-001,-001,-001,-001,-001,-001],
	[-001,-001,-001,-001,-001,-001,-001,-001,-001,-001,-001,-001,-001,-001,-001,-001,-001,-001,-001,-001,-001,-001,-001,-001,-001,-001,-001,-001,-001,-001],
	[-001,-001,-001,-001,-001,-001,-001,-001,-001,-001,-001,-001,-001,-001,-001,-001,-001,-001,-001,-001,-001,-001,-001,-001,-001,-001,-001,-001,-001,-001],
	[-001,-001,-001,-001,-001,-001,-001,-001,-001,-001,-001,-001,-001,-001,-001,-001,-001,-001,-001,-001,-001,-001,-001,-001,-001,-001,-001,-001,-001,-001],
	[-001,-001,-001,-001,-001,-001,-001,-001,-001,-001,-001,-001,-001,-001,-001,-001,-001,-001,-001,-001,-001,-001,-001,-001,-001,-001,-001,-001,-001,-001],
	[-001,-001,-001,-001,-001,-001,-001,-001,-001,-001,-001,-001,-001,-001,-001,-001,-001,-001,-001,-001,-001,-001,-001,-001,-001,-001,-001,-001,-001,-001],
	[-001,-001,-001,-001,-001,-001,-001,-001,-001,-001,-001,-001,-001,-001,-001,-001,-001,-001,-001,-001,-001,-001,-001,-001,-001,-001,-001,-001,-001,-001],
	[-001,-001,-001,-001,-001,-001,-001,-001,-001,-001,-001,-001,-001,-001,-001,-001,-001,-001,-001,-001,-001,-001,-001,-001,-001,-001,-001,-001,-001,-001],
	[-001,-001,-001,-001,-001,-001,-001,-001,-001,-001,-001,-001,-001,-001,-001,-001,-001,-001,-001,-001,-001,-001,-001,-001,-001,-001,-001,-001,-001,-001],
	[-001,-001,-001,-001,-001,-001,-001,-001,-001,-001,-001,-001,-001,-001,-001,-001,-001,-001,-001,-001,-001,-001,-001,-001,-001,-001,-001,-001,-001,-001],
	[-001,-001,-001,-001,-001,-001,-001,-001,-001,-001,-001,-001,-001,-001,-001,-001,-001,-001,-001,-001,-001,-001,-001,-001,-001,-001,-001,-001,-001,-001],
	[-001,-001,-001,-001,-001,-001,-001,-001,-001,-001,-001,-001,-001,-001,-001,-001,-001,-001,-001,-001,-001,-001,-001,-001,-001,-001,-001,-001,-001,-001],
	[-001,-001,-001,-001,-001,-001,-001,-001,-001,-001,-001,-001,-001,-001,-001,-001,-001,-001,-001,-001,-001,-001,-001,-001,-001,-001,-001,-001,-001,-001],
	[-001,-001,-001,-001,-001,-001,-001,-001,-001,-001,-001,-001,-001,-001,-001,-001,-001,-001,-001,-001,-001,-001,-001,-001,-001,-001,-001,-001,-001,-001],
	[-001,-001,-001,-001,-001,-001,-001,-001,-001,-001,-001,-001,-001,-001,-001,-001,-001,-001,-001,-001,-001,-001,-001,-001,-001,-001,-001,-001,-001,-001],
	[-001,-001,-001,-001,-001,-001,-001,-001,-001,-001,-001,-001,-001,-001,-001,-001,-001,-001,-001,-001,-001,-001,-001,-001,-001,-001,-001,-001,-001,-001],
	[-001,-001,-001,-001,-001,-001,-001,-001,-001,-001,-001,-001,-001,-001,-001,-001,-001,-001,-001,-001,-001,-001,-001,-001,-001,-001,-001,-001,-001,-001],
	[-001,-001,-001,-001,-001,-001,-001,-001,-001,-001,-001,-001,-001,-001,-001,-001,-001,-001,-001,-001,-001,-001,-001,-001,-001,-001,-001,-001,-001,-001],
	[-001,-001,-001,-001,-001,-001,-001,-001,-001,-001,-001,-001,-001,-001,-001,-001,-001,-001,-001,-001,-001,-001,-001,-001,-001,-001,-001,-001,-001,-001],
	[-001,-001,-001,-001,-001,-001,-001,-001,-001,-001,-001,-001,-001,-001,-001,-001,-001,-001,-001,-001,-001,-001,-001,-001,-001,-001,-001,-001,-001,-001]
	],
	"events": [
	{
		"id": 5,
		"nom": "Clone[341][159]",
		"x": 15,
		"y": 15
	},
	{
		"id": 1,
		"nom": "lueurs",
		"x": 14,
		"y": 23,
		"pages": [
		{
			"conditions": [
			],
			"commandes": [
			{
				"nom": "EffacerImage",
				"numero": 2
			},
			{
				"nom": "EffacerImage",
				"numero": 3
			},
			{
				"nom": "ModifierTonDeLEcran",
				"rouge": 117,
				"vert": 122,
				"bleu": 122,
				"gris": 0,
				"dureeTransition": 0
			},
			{
				"nom": "ModifierBrouillard",
				"opacite": 200,
				"modeDeFusion": "normal",
				"defilementX": 0,
				"defilementY": 0,
				"zoom": 100,
				"nuance": 0,
				"nomImage": "lueurs brouillard1"
			},
			{
				"nom": "Attendre",
				"nombreDeFrames": 16
			},
			{
				"nom": "ModifierTonDeLEcran",
				"rouge": 120,
				"vert": 124,
				"bleu": 124,
				"gris": 0,
				"dureeTransition": 16
			},
			{
				"nom": "ModifierBrouillard",
				"opacite": 200,
				"modeDeFusion": "normal",
				"defilementX": 0,
				"defilementY": 0,
				"zoom": 100,
				"nuance": 0,
				"nomImage": "lueurs brouillard2"
			},
			{
				"nom": "Attendre",
				"nombreDeFrames": 16
			},
			{
				"nom": "ModifierTonDeLEcran",
				"rouge": 117,
				"vert": 122,
				"bleu": 122,
				"gris": 0,
				"dureeTransition": 16
			},
			{
				"nom": "ModifierBrouillard",
				"opacite": 200,
				"modeDeFusion": "normal",
				"defilementX": 0,
				"defilementY": 0,
				"zoom": 100,
				"nuance": 0,
				"nomImage": "lueurs brouillard1"
			},
			{
				"nom": "Attendre",
				"nombreDeFrames": 16
			},
			{
				"nom": "ModifierTonDeLEcran",
				"rouge": 112,
				"vert": 120,
				"bleu": 120,
				"gris": 0,
				"dureeTransition": 16
			},
			{
				"nom": "ModifierBrouillard",
				"opacite": 200,
				"modeDeFusion": "normal",
				"defilementX": 0,
				"defilementY": 0,
				"zoom": 100,
				"nuance": 0,
				"nomImage": "lueurs brouillard3"
			},
			{
				"nom": "Attendre",
				"nombreDeFrames": 16
			},
			{
				"nom": "ModifierTonDeLEcran",
				"rouge": 117,
				"vert": 122,
				"bleu": 122,
				"gris": 0,
				"dureeTransition": 16
			},
			{
				"nom": "ModifierBrouillard",
				"opacite": 200,
				"modeDeFusion": "normal",
				"defilementX": 0,
				"defilementY": 0,
				"zoom": 100,
				"nuance": 0,
				"nomImage": "lueurs brouillard1"
			},
			{
				"nom": "Attendre",
				"nombreDeFrames": 16
			}
			],
			"vitesse": "moderee",
			"frequence": "basse",
			"animeEnMouvement": true,
			"animeALArret": false,
			"directionFixe": false,
			"traversable": false,
			"auDessusDeTout": false
		}
		]
	},
	{
		"id": 2,
		"nom": "EV002",
		"x": 13,
		"y": 22,
		"pages": [
		{
			"conditions": [
			{
				"nom": "ArriveeAuContact"
			}
			],
			"commandes": [
			{
				"nom": "ChangerDeMap",
				"variable": false,
				"numeroNouvelleMap": 203,
				"xDebutHeros": 14,
				"yDebutHeros": 12
			}
			],
			"vitesse": "moderee",
			"frequence": "basse",
			"animeEnMouvement": true,
			"animeALArret": false,
			"directionFixe": false,
			"traversable": false,
			"auDessusDeTout": false
		}
		]
	},
	{
		"id": 3,
		"nom": "Clone[341][008]",
		"x": 14,
		"y": 9
	},
	{
		"id": 4,
		"nom": "EV004",
		"x": 16,
		"y": 7,
		"pages": [
		{
			"conditions": [
			{
				"nom": "ArriveeAuContact"
			}
			],
			"commandes": [
			{
				"nom": "ChangerDeMap",
				"variable": false,
				"numeroNouvelleMap": 218,
				"xDebutHeros": 13,
				"yDebutHeros": 33
			}
			],
			"vitesse": "moderee",
			"frequence": "basse",
			"animeEnMouvement": true,
			"animeALArret": false,
			"directionFixe": false,
			"traversable": false,
			"auDessusDeTout": false
		}
		]
	}
	]
}
