{
	"nom": "Sifflet",
	"tileset": "Reve",
	"largeur": 21,
	"hauteur": 15,
	"couche0": [
	[-008,-008,-008,-008,-008,-008,-008,-008,-008,-008,-008,-008,-008,-008,-008,-008,-008,-008,-008,-008,-008],
	[-008,-008,-008,-008,-008,-008,-008,-008,-008,-008,-008,-008,-008,-008,-008,-008,-008,-008,-008,-008,-008],
	[-008,-008,-008,-008,-008,-008,-008,-008,-008,-008,-008,-008,-008,-008,-008,-008,-008,-008,-008,-008,-008],
	[-008,-008,-008,-008,-008,-008,-008,-008,-008,-008,-008,-008,-008,-008,-008,-008,-008,-008,-008,-008,-008],
	[-008,-008,-008,-008,-008,-008,-008,-008,-008,-008,-008,-008,-008,-008,-008,-008,-008,-008,-008,-008,-008],
	[-008,-008,-008,-008,-008,-008,-008,-008,-008,-008,-008,-008,-008,-008,-008,-008,-008,-008,-008,-008,-008],
	[-008,-008,-008,-008,-008,-008,-008,-008,-008,-008,-008,-008,-008,-008,-008,-008,-008,-008,-008,-008,-008],
	[-008,-008,-008,-008,-008,-008,-008,-008,-008,-008,-008,-008,-008,-008,-008,-008,-008,-008,-008,-008,-008],
	[-008,-008,-008,-008,-008,-008,-008,-008,-008,-008,-008,-008,-008,-008,-008,-008,-008,-008,-008,-008,-008],
	[-008,-008,-008,-008,-008,-008,-008,-008,-008,-008,-008,-008,-008,-008,-008,-008,-008,-008,-008,-008,-008],
	[-008,-008,-008,-008,-008,-008,-008,-008,-008,-008,-008,-008,-008,-008,-008,-008,-008,-008,-008,-008,-008],
	[-008,-008,-008,-008,-008,-008,-008,-008,-008,-008,-008,-008,-008,-008,-008,-008,-008,-008,-008,-008,-008],
	[-008,-008,-008,-008,-008,-008,-008,-008,-008,-008,-008,-008,-008,-008,-008,-008,-008,-008,-008,-008,-008],
	[-008,-008,-008,-008,-008,-008,-008,-008,-008,-008,-008,-008,-008,-008,-008,-008,-008,-008,-008,-008,-008],
	[-008,-008,-008,-008,-008,-008,-008,-008,-008,-008,-008,-008,-008,-008,-008,-008,-008,-008,-008,-008,-008]
	],
	"couche1": [
	[-001,-001,-001,-001,-001,-001,-001,-001,-001,-001,-001,-001,-001,-001,-001,-001,-001,-001,-001,-001,-001],
	[-001,-001,-001,-001,-001,-001,-001,-001,-001,-001,-001,-001,-001,-001,-001,-001,-001,-001,-001,-001,-001],
	[-001,-001,-001,-001,-001,-001,-001,-001,-001,-001,-001,-001,-001,-001,-001,-001,-001,-001,-001,-001,-001],
	[-001,-001,-001,-001,-001,-001,-001,-001,-001,-001,-001,-001,-001,-001,-001,-001,-001,-001,-001,-001,-001],
	[-001,-001,-001,-001,-001,-001,-001,-001,-001,-001,-001,-001,-001,-001,-001,-001,-001,-001,-001,-001,-001],
	[-001,-001,-001,-001,-001,-001,-001,-001,-001,-001,-001,-001,-001,-001,-001,-001,-001,-001,-001,-001,-001],
	[-001,-001,-001,-001,-001,-001,-001,-001,-001,-001,-001,-001,-001,-001,-001,-001,-001,-001,-001,-001,-001],
	[-001,-001,-001,-001,-001,-001,-001,-001,-001,-001,-001,-001,-001,-001,-001,-001,-001,-001,-001,-001,-001],
	[-001,-001,-001,-001,-001,-001,-001,-001,-001,-001,-001,-001,-001,-001,-001,-001,-001,-001,-001,-001,-001],
	[-001,-001,-001,-001,-001,-001,-001,-001,-001,-001,-001,-001,-001,-001,-001,-001,-001,-001,-001,-001,-001],
	[-001,-001,-001,-001,-001,-001,-001,-001,-001,-001,-001,-001,-001,-001,-001,-001,-001,-001,-001,-001,-001],
	[-001,-001,-001,-001,-001,-001,-001,-001,-001,-001,-001,-001,-001,-001,-001,-001,-001,-001,-001,-001,-001],
	[-001,-001,-001,-001,-001,-001,-001,-001,-001,-001,-001,-001,-001,-001,-001,-001,-001,-001,-001,-001,-001],
	[-001,-001,-001,-001,-001,-001,-001,-001,-001,-001,-001,-001,-001,-001,-001,-001,-001,-001,-001,-001,-001],
	[-001,-001,-001,-001,-001,-001,-001,-001,-001,-001,-001,-001,-001,-001,-001,-001,-001,-001,-001,-001,-001]
	],
	"couche2": [
	[-001,-001,-001,-001,-001,-001,-001,-001,-001,-001,-001,-001,-001,-001,-001,-001,-001,-001,-001,-001,-001],
	[-001,-001,-001,-001,-001,-001,-001,-001,-001,-001,-001,-001,-001,-001,-001,-001,-001,-001,-001,-001,-001],
	[-001,-001,-001,-001,-001,-001,-001,-001,-001,-001,-001,-001,-001,-001,-001,-001,-001,-001,-001,-001,-001],
	[-001,-001,-001,-001,-001,-001,-001,-001,-001,-001,-001,-001,-001,-001,-001,-001,-001,-001,-001,-001,-001],
	[-001,-001,-001,-001,-001,-001,-001,-001,-001,-001,-001,-001,-001,-001,-001,-001,-001,-001,-001,-001,-001],
	[-001,-001,-001,-001,-001,-001,-001,-001,-001,-001,-001,-001,-001,-001,-001,-001,-001,-001,-001,-001,-001],
	[-001,-001,-001,-001,-001,-001,-001,-001,-001,-001,-001,-001,-001,-001,-001,-001,-001,-001,-001,-001,-001],
	[-001,-001,-001,-001,-001,-001,-001,-001,-001,-001,-001,-001,-001,-001,-001,-001,-001,-001,-001,-001,-001],
	[-001,-001,-001,-001,-001,-001,-001,-001,-001,-001,-001,-001,-001,-001,-001,-001,-001,-001,-001,-001,-001],
	[-001,-001,-001,-001,-001,-001,-001,-001,-001,-001,-001,-001,-001,-001,-001,-001,-001,-001,-001,-001,-001],
	[-001,-001,-001,-001,-001,-001,-001,-001,-001,-001,-001,-001,-001,-001,-001,-001,-001,-001,-001,-001,-001],
	[-001,-001,-001,-001,-001,-001,-001,-001,-001,-001,-001,-001,-001,-001,-001,-001,-001,-001,-001,-001,-001],
	[-001,-001,-001,-001,-001,-001,-001,-001,-001,-001,-001,-001,-001,-001,-001,-001,-001,-001,-001,-001,-001],
	[-001,-001,-001,-001,-001,-001,-001,-001,-001,-001,-001,-001,-001,-001,-001,-001,-001,-001,-001,-001,-001],
	[-001,-001,-001,-001,-001,-001,-001,-001,-001,-001,-001,-001,-001,-001,-001,-001,-001,-001,-001,-001,-001]
	],
	"events": [
	]
}
