{
	"nom": "Maison (Marie-Gambette)",
	"tileset": "Marais",
	"largeur": 21,
	"hauteur": 15,
	"musique": {
		"nomFichierSonore": "",
		"volume": 0.00,
		"tempo": 1.00
	},
	"fondSonore": {
		"nomFichierSonore": "RotS_eau.ogg",
		"volume": 0.60,
		"tempo": 1.00
	},
	"couche0": [
	[0809,0809,0809,0809,0809,0809,0809,0809,0809,0809,0809,0809,0809,0809,0809,0809,0809,0809,0809,0809,0809],
	[0809,0809,0809,0809,0891,0897,0897,0897,0897,0897,0897,0897,0897,0897,0897,0897,0892,0809,0809,0809,0809],
	[0809,0809,0809,0809,0890,0891,1133,1133,1133,1133,1133,1133,1133,1133,1133,0892,0888,0809,0809,0809,0809],
	[0809,0809,0809,0809,0890,1134,-008,-008,-008,-008,-008,-008,-008,-008,-008,1125,0888,0809,0809,0809,0809],
	[0809,0809,0809,0809,0890,1134,-008,-008,-008,-008,-008,-008,-008,-008,-008,1125,0888,0809,0809,0809,0809],
	[0809,0809,0809,0809,0890,1134,-008,-008,0885,0885,0885,0885,0885,-008,-008,1125,0888,0809,0809,0809,0809],
	[0809,0809,0809,0809,0890,1134,-008,-008,0885,0885,0885,0885,0885,-008,-008,1125,0888,0809,0809,0809,0809],
	[0809,0809,0809,0809,0890,1134,-008,-008,0885,0885,0885,0885,0885,-008,-008,1125,0888,0809,0809,0809,0809],
	[0809,0809,0809,0809,0890,1134,-008,-008,0885,0885,0885,0885,0885,-008,-008,1125,0888,0809,0809,0809,0809],
	[0809,0809,0809,0809,0890,1134,-008,-008,-008,0889,0889,0889,-008,-008,-008,1125,0888,0809,0809,0809,0809],
	[0809,0809,0809,0809,0890,1134,-008,-008,-008,0889,0908,0889,-008,-008,-008,1125,0888,0809,0809,0809,0809],
	[0809,0809,0809,0809,0890,0899,1126,1126,1126,1126,0916,1126,1126,1126,1126,0900,0888,0809,0809,0809,0809],
	[0809,0809,0809,0809,0899,0881,0881,0881,0881,0881,0881,0881,0881,0881,0881,0881,0900,0809,0809,0809,0809],
	[0809,0809,0809,0809,0809,0809,0809,0809,0809,0809,0809,0809,0809,0809,0809,0809,0809,0809,0809,0809,0809],
	[0809,0809,0809,0809,0809,0809,0809,0809,0809,0809,0809,0809,0809,0809,0809,0809,0809,0809,0809,0809,0809]
	],
	"couche1": [
	[-001,-001,-001,-001,-001,-001,-001,-001,-001,-001,-001,-001,-001,-001,-001,-001,-001,-001,-001,-001,-001],
	[-001,-001,-001,-001,-001,-001,-001,-001,-001,-001,-001,-001,-001,-001,-001,-001,-001,-001,-001,-001,-001],
	[-001,-001,-001,-001,0903,-001,-001,-001,-001,-001,-001,-001,-001,-001,-001,-001,0895,-001,-001,-001,-001],
	[-001,-001,-001,-001,-001,0903,-001,-001,0855,-001,-001,-001,-001,-001,-001,-001,-001,-001,-001,-001,-001],
	[-001,-001,-001,-001,-001,-001,-001,0300,-001,-001,-001,-001,0855,-001,-001,-001,-001,-001,-001,-001,-001],
	[-001,-001,-001,-001,-001,-001,-001,-001,-001,-001,-001,-001,-001,-001,-001,0895,-001,-001,-001,-001,-001],
	[-001,-001,-001,-001,-001,-001,-001,-001,-001,1238,1239,1223,-001,0308,-001,-001,-001,-001,-001,-001,-001],
	[-001,-001,-001,-001,-001,-001,0855,-001,-001,1246,1247,-001,-001,-001,0300,-001,-001,-001,-001,-001,-001],
	[-001,-001,-001,-001,-001,-001,-001,-001,-001,-001,-001,-001,-001,-001,-001,-001,-001,-001,-001,-001,-001],
	[-001,-001,-001,-001,0903,-001,0308,0300,-001,-001,-001,-001,-001,0855,-001,-001,0895,-001,-001,-001,-001],
	[-001,-001,-001,-001,-001,-001,-001,-001,-001,-001,-001,-001,-001,-001,-001,0895,-001,-001,-001,-001,-001],
	[-001,-001,-001,-001,-001,-001,-001,-001,-001,-001,-001,-001,-001,-001,-001,-001,-001,-001,-001,-001,-001],
	[-001,-001,-001,-001,-001,-001,-001,-001,-001,-001,-001,-001,-001,-001,-001,-001,-001,-001,-001,-001,-001],
	[-001,-001,-001,-001,-001,-001,-001,-001,-001,-001,-001,-001,-001,-001,-001,-001,-001,-001,-001,-001,-001],
	[-001,-001,-001,-001,-001,-001,-001,-001,-001,-001,-001,-001,-001,-001,-001,-001,-001,-001,-001,-001,-001]
	],
	"couche2": [
	[-001,-001,-001,-001,-001,-001,-001,-001,-001,-001,-001,-001,-001,-001,-001,-001,-001,-001,-001,-001,-001],
	[-001,-001,-001,-001,-001,-001,-001,-001,-001,-001,-001,-001,-001,-001,-001,-001,-001,-001,-001,-001,-001],
	[-001,-001,-001,-001,-001,-001,-001,-001,-001,-001,-001,-001,-001,-001,-001,-001,-001,-001,-001,-001,-001],
	[-001,-001,-001,-001,-001,-001,-001,-001,-001,-001,-001,-001,-001,-001,-001,-001,-001,-001,-001,-001,-001],
	[-001,-001,-001,-001,-001,-001,-001,-001,-001,-001,-001,-001,-001,-001,-001,-001,-001,-001,-001,-001,-001],
	[-001,-001,-001,-001,-001,-001,-001,-001,-001,-001,-001,-001,-001,-001,-001,-001,-001,-001,-001,-001,-001],
	[-001,-001,-001,-001,-001,-001,-001,-001,-001,1230,1228,-001,-001,-001,-001,-001,-001,-001,-001,-001,-001],
	[-001,-001,-001,-001,-001,-001,-001,-001,-001,-001,1229,-001,-001,-001,-001,-001,-001,-001,-001,-001,-001],
	[-001,-001,-001,-001,-001,-001,-001,-001,-001,-001,-001,-001,-001,-001,-001,-001,-001,-001,-001,-001,-001],
	[-001,-001,-001,-001,-001,-001,-001,-001,-001,-001,-001,-001,-001,-001,-001,-001,-001,-001,-001,-001,-001],
	[-001,-001,-001,-001,-001,-001,-001,-001,-001,-001,-001,-001,-001,-001,-001,-001,-001,-001,-001,-001,-001],
	[-001,-001,-001,-001,-001,-001,-001,-001,-001,-001,-001,-001,-001,-001,-001,-001,-001,-001,-001,-001,-001],
	[-001,-001,-001,-001,-001,-001,-001,-001,-001,-001,-001,-001,-001,-001,-001,-001,-001,-001,-001,-001,-001],
	[-001,-001,-001,-001,-001,-001,-001,-001,-001,-001,-001,-001,-001,-001,-001,-001,-001,-001,-001,-001,-001],
	[-001,-001,-001,-001,-001,-001,-001,-001,-001,-001,-001,-001,-001,-001,-001,-001,-001,-001,-001,-001,-001]
	],
	"events": [
	{
		"id": 5,
		"nom": "Clone[582][37]",
		"x": 13,
		"y": 3
	},
	{
		"id": 6,
		"nom": "Clone[582][37]",
		"x": 7,
		"y": 3
	},
	{
		"id": 1,
		"nom": "pas de pluie",
		"x": 18,
		"y": 3,
		"pages": [
		{
			"conditions": [
			],
			"commandes": [
			{
				"nom": "ModifierMeteo",
				"type": "rien",
				"intensite": 5
			},
			{
				"nom": "EffacerImage",
				"numero": 3
			},
			{
				"nom": "ModifierTonDeLEcran",
				"rouge": 127,
				"vert": 127,
				"bleu": 127,
				"gris": 0,
				"dureeTransition": 0
			},
			{
				"nom": "SupprimerEvent"
			}
			],
			"vitesse": "moderee",
			"frequence": "basse",
			"animeEnMouvement": true,
			"animeALArret": false,
			"directionFixe": false,
			"traversable": false,
			"auDessusDeTout": false
		}
		]
	},
	{
		"id": 7,
		"nom": "Parchemin",
		"x": 10,
		"y": 7,
		"pages": [
		{
			"conditions": [
			{
				"nom": "Parler"
			}
			],
			"commandes": [
			{
				"nom": "ModifierInterrupteur",
				"numeroInterrupteur": 12,
				"valeur": true
			},
			{
				"nom": "Commentaire",
				"texte": "(en) \"\\c[2]Marie-Gambette\\c[0],\\n\\c[2]Crocus\\c[0] didn't come to entertain \\n\\c[2]His Majesty\\c[0] today either.\\nDo you know what's wrong with him?"
			},
			{
				"nom": "Message",
				"texte": "\"\\c[2]Marie-Gambette\\c[0],\\n\\c[2]Crocus\\c[0] n'est pas venu divertir \\n\\c[2]Sa Majesté\\c[0] aujourd'hui non plus.\\nEst-ce que tu sais ce qu'il a ?"
			},
			{
				"nom": "Commentaire",
				"texte": "(en) He's been cooped up at home for a week. \\nI'm starting to get worried.\""
			},
			{
				"nom": "Message",
				"texte": "Cela fait une semaine qu'il est cloîtré chez lui.\\nJe commence à m'inquiéter.\""
			},
			{
				"nom": "Commentaire",
				"texte": "(en) \\c[2]Jean-Rainette\\c[0]"
			},
			{
				"nom": "Message",
				"texte": "\\c[2]Jean-Rainette\\c[0]"
			},
			{
				"nom": "Attendre",
				"nombreDeFrames": 8
			},
			{
				"nom": "ModifierInterrupteur",
				"numeroInterrupteur": 12,
				"valeur": false
			}
			],
			"vitesse": "moderee",
			"frequence": "basse",
			"animeEnMouvement": true,
			"animeALArret": false,
			"directionFixe": false,
			"traversable": false,
			"auDessusDeTout": false
		}
		]
	},
	{
		"id": 2,
		"nom": "caustiques",
		"x": 19,
		"y": 3,
		"pages": [
		{
			"conditions": [
			],
			"commandes": [
			{
				"nom": "AppelerPageCommune",
				"numeroPageCommune": 133
			}
			],
			"vitesse": "moderee",
			"frequence": "basse",
			"animeEnMouvement": true,
			"animeALArret": false,
			"directionFixe": false,
			"traversable": false,
			"auDessusDeTout": false
		}
		]
	},
	{
		"id": 3,
		"nom": "EV003",
		"x": 10,
		"y": 11,
		"pages": [
		{
			"conditions": [
			{
				"nom": "ArriveeAuContact"
			}
			],
			"commandes": [
			{
				"nom": "ChangerDeMap",
				"variable": false,
				"numeroNouvelleMap": 214,
				"xDebutHeros": 21,
				"yDebutHeros": 7
			}
			],
			"vitesse": "moderee",
			"frequence": "basse",
			"animeEnMouvement": true,
			"animeALArret": false,
			"directionFixe": false,
			"traversable": false,
			"auDessusDeTout": false
		}
		]
	},
	{
		"id": 4,
		"nom": "Clone[582][37]",
		"x": 10,
		"y": 3
	}
	]
}
