{
	"nom": "Maison (Crocus)",
	"tileset": "Marais",
	"largeur": 21,
	"hauteur": 15,
	"musique": {
		"nomFichierSonore": "",
		"volume": 0.00,
		"tempo": 1.00
	},
	"fondSonore": {
		"nomFichierSonore": "RotS_eau.ogg",
		"volume": 0.60,
		"tempo": 1.00
	},
	"couche0": [
	[0809,0809,0809,0809,0809,0809,0809,0809,0809,0809,0809,0809,0809,0809,0809,0809,0809,0809,0809,0809,0809],
	[0809,0809,0809,0809,0891,0897,0897,0897,0897,0897,0897,0897,0897,0897,0897,0897,0892,0809,0809,0809,0809],
	[0809,0809,0809,0809,0890,0891,1133,1133,1133,1133,1133,1133,1133,1133,1133,0892,0888,0809,0809,0809,0809],
	[0809,0809,0809,0809,0890,1134,0885,0885,0885,0885,0885,0885,0885,0885,0885,1125,0888,0809,0809,0809,0809],
	[0809,0809,0809,0809,0890,1134,0885,0885,0885,0885,-008,-008,-008,-008,0885,1125,0888,0809,0809,0809,0809],
	[0809,0809,0809,0809,0890,1134,0885,0885,0885,0885,-008,-008,-008,-008,0885,1125,0888,0809,0809,0809,0809],
	[0809,0809,0809,0809,0890,1134,-008,-008,-008,-008,-008,-008,-008,-008,0885,1125,0888,0809,0809,0809,0809],
	[0809,0809,0809,0809,0890,1134,-008,-008,-008,-008,-008,-008,-008,-008,0885,1125,0888,0809,0809,0809,0809],
	[0809,0809,0809,0809,0890,1134,-008,-008,-008,-008,-008,-008,-008,-008,0885,1125,0888,0809,0809,0809,0809],
	[0809,0809,0809,0809,0890,1134,-008,-008,-008,0889,0889,0889,-008,-008,0885,1125,0888,0809,0809,0809,0809],
	[0809,0809,0809,0809,0890,1134,-008,-008,-008,0889,0908,0889,0885,0885,0885,1125,0888,0809,0809,0809,0809],
	[0809,0809,0809,0809,0890,0899,1126,1126,1126,1126,0916,1126,1126,1126,1126,0900,0888,0809,0809,0809,0809],
	[0809,0809,0809,0809,0899,0881,0881,0881,0881,0881,0881,0881,0881,0881,0881,0881,0900,0809,0809,0809,0809],
	[0809,0809,0809,0809,0809,0809,0809,0809,0809,0809,0809,0809,0809,0809,0809,0809,0809,0809,0809,0809,0809],
	[0809,0809,0809,0809,0809,0809,0809,0809,0809,0809,0809,0809,0809,0809,0809,0809,0809,0809,0809,0809,0809]
	],
	"couche1": [
	[-001,-001,-001,-001,-001,-001,-001,-001,-001,-001,-001,-001,-001,-001,-001,-001,-001,-001,-001,-001,-001],
	[-001,-001,-001,-001,-001,-001,-001,-001,-001,-001,-001,-001,-001,-001,-001,-001,-001,-001,-001,-001,-001],
	[-001,-001,-001,-001,-001,-001,-001,-001,-001,-001,-001,-001,-001,-001,-001,-001,-001,-001,-001,-001,-001],
	[-001,-001,-001,-001,0903,-001,1238,1239,-001,-001,-001,-001,-001,-001,-001,0895,-001,-001,-001,-001,-001],
	[-001,-001,-001,-001,0903,0903,1246,1247,-001,1223,-001,-001,-001,-001,-001,-001,0895,-001,-001,-001,-001],
	[-001,-001,-001,-001,-001,0903,1222,-001,-001,-001,-001,0300,-001,-001,-001,-001,0895,-001,-001,-001,-001],
	[-001,-001,-001,-001,-001,-001,0855,-001,-001,-001,-001,-001,-001,-001,-001,-001,-001,-001,-001,-001,-001],
	[-001,-001,-001,-001,-001,-001,-001,-001,0300,-001,-001,-001,0308,-001,-001,-001,-001,-001,-001,-001,-001],
	[-001,-001,-001,-001,-001,0903,-001,0308,-001,-001,0855,-001,-001,-001,-001,0895,-001,-001,-001,-001,-001],
	[-001,-001,-001,-001,-001,-001,-001,-001,-001,0855,-001,-001,-001,0855,-001,-001,-001,-001,-001,-001,-001],
	[-001,-001,-001,-001,0903,-001,-001,-001,-001,-001,-001,-001,-001,-001,-001,-001,0895,-001,-001,-001,-001],
	[-001,-001,-001,-001,-001,-001,-001,-001,-001,-001,-001,-001,-001,-001,-001,-001,-001,-001,-001,-001,-001],
	[-001,-001,-001,-001,-001,-001,-001,-001,-001,-001,-001,-001,-001,-001,-001,-001,-001,-001,-001,-001,-001],
	[-001,-001,-001,-001,-001,-001,-001,-001,-001,-001,-001,-001,-001,-001,-001,-001,-001,-001,-001,-001,-001],
	[-001,-001,-001,-001,-001,-001,-001,-001,-001,-001,-001,-001,-001,-001,-001,-001,-001,-001,-001,-001,-001]
	],
	"couche2": [
	[-001,-001,-001,-001,-001,-001,-001,-001,-001,-001,-001,-001,-001,-001,-001,-001,-001,-001,-001,-001,-001],
	[-001,-001,-001,-001,-001,-001,-001,-001,-001,-001,-001,-001,-001,-001,-001,-001,-001,-001,-001,-001,-001],
	[-001,-001,-001,-001,-001,-001,-001,-001,-001,-001,-001,-001,-001,-001,-001,-001,-001,-001,-001,-001,-001],
	[-001,-001,-001,-001,-001,-001,1230,1231,-001,-001,-001,-001,-001,-001,-001,-001,-001,-001,-001,-001,-001],
	[-001,-001,-001,-001,-001,-001,-001,1229,-001,-001,-001,-001,-001,-001,-001,-001,-001,-001,-001,-001,-001],
	[-001,-001,-001,-001,-001,-001,-001,-001,-001,-001,-001,-001,-001,-001,-001,-001,-001,-001,-001,-001,-001],
	[-001,-001,-001,-001,-001,-001,-001,-001,-001,-001,-001,-001,-001,-001,-001,-001,-001,-001,-001,-001,-001],
	[-001,-001,-001,-001,-001,-001,-001,-001,-001,-001,-001,-001,-001,-001,-001,-001,-001,-001,-001,-001,-001],
	[-001,-001,-001,-001,-001,-001,-001,-001,-001,-001,-001,-001,-001,-001,-001,-001,-001,-001,-001,-001,-001],
	[-001,-001,-001,-001,-001,-001,-001,-001,-001,-001,-001,-001,-001,-001,-001,-001,-001,-001,-001,-001,-001],
	[-001,-001,-001,-001,-001,-001,-001,-001,-001,-001,-001,-001,-001,-001,-001,-001,-001,-001,-001,-001,-001],
	[-001,-001,-001,-001,-001,-001,-001,-001,-001,-001,-001,-001,-001,-001,-001,-001,-001,-001,-001,-001,-001],
	[-001,-001,-001,-001,-001,-001,-001,-001,-001,-001,-001,-001,-001,-001,-001,-001,-001,-001,-001,-001,-001],
	[-001,-001,-001,-001,-001,-001,-001,-001,-001,-001,-001,-001,-001,-001,-001,-001,-001,-001,-001,-001,-001],
	[-001,-001,-001,-001,-001,-001,-001,-001,-001,-001,-001,-001,-001,-001,-001,-001,-001,-001,-001,-001,-001]
	],
	"events": [
	{
		"id": 5,
		"nom": "Clone[341][004]",
		"x": 14,
		"y": 6
	},
	{
		"id": 6,
		"nom": "Clone[341][004]",
		"x": 14,
		"y": 7
	},
	{
		"id": 1,
		"nom": "pas de pluie",
		"x": 18,
		"y": 3,
		"pages": [
		{
			"conditions": [
			],
			"commandes": [
			{
				"nom": "ModifierMeteo",
				"type": "rien",
				"intensite": 5
			},
			{
				"nom": "EffacerImage",
				"numero": 3
			},
			{
				"nom": "ModifierTonDeLEcran",
				"rouge": 127,
				"vert": 127,
				"bleu": 127,
				"gris": 0,
				"dureeTransition": 0
			},
			{
				"nom": "SupprimerEvent"
			}
			],
			"vitesse": "moderee",
			"frequence": "basse",
			"animeEnMouvement": true,
			"animeALArret": false,
			"directionFixe": false,
			"traversable": false,
			"auDessusDeTout": false
		}
		]
	},
	{
		"id": 7,
		"nom": "Clone[582][37]",
		"x": 12,
		"y": 4
	},
	{
		"id": 2,
		"nom": "caustiques",
		"x": 19,
		"y": 3,
		"pages": [
		{
			"conditions": [
			],
			"commandes": [
			{
				"nom": "AppelerPageCommune",
				"numeroPageCommune": 133
			}
			],
			"vitesse": "moderee",
			"frequence": "basse",
			"animeEnMouvement": true,
			"animeALArret": false,
			"directionFixe": false,
			"traversable": false,
			"auDessusDeTout": false
		}
		]
	},
	{
		"id": 8,
		"nom": "Clone[582][37]",
		"x": 13,
		"y": 3
	},
	{
		"id": 3,
		"nom": "EV003",
		"x": 10,
		"y": 11,
		"pages": [
		{
			"conditions": [
			{
				"nom": "ArriveeAuContact"
			}
			],
			"commandes": [
			{
				"nom": "ChangerDeMap",
				"variable": false,
				"numeroNouvelleMap": 135,
				"xDebutHeros": 27,
				"yDebutHeros": 4
			}
			],
			"vitesse": "moderee",
			"frequence": "basse",
			"animeEnMouvement": true,
			"animeALArret": false,
			"directionFixe": false,
			"traversable": false,
			"auDessusDeTout": false
		}
		]
	},
	{
		"id": 9,
		"nom": "Clone[582][37]",
		"x": 10,
		"y": 3
	},
	{
		"id": 4,
		"nom": "Clone[341][004]",
		"x": 14,
		"y": 5
	},
	{
		"id": 10,
		"nom": "Parchemin",
		"x": 7,
		"y": 4,
		"pages": [
		{
			"conditions": [
			{
				"nom": "Parler"
			}
			],
			"commandes": [
			{
				"nom": "ModifierInterrupteur",
				"numeroInterrupteur": 12,
				"valeur": true
			},
			{
				"nom": "Commentaire",
				"texte": "(en) \"\\c[2]Crocus\\c[0],\\nKnow that if you try to save a people\\nwho don't want to be saved,\\nyou won't be a hero, but a criminal."
			},
			{
				"nom": "Message",
				"texte": "\"\\c[2]Crocus\\c[0],\\nSache que si tu essaies de sauver un peuple \\nqui n'a pas envie d'être sauvé, \\ntu ne seras pas un héros, mais un criminel."
			},
			{
				"nom": "Commentaire",
				"texte": "(en) \\c[2]Frogs\\c[0] find their happiness\\nin serving their king.\\nIt is better that we be happy for a short time \\nthan sad for eternity."
			},
			{
				"nom": "Message",
				"texte": "\\c[2]Les Grenouilles\\c[0] trouvent leur bonheur \\ndans le fait de servir leur roi.\\nIl vaut mieux que nous soyons heureux \\nun court moment que tristes pour l'éternité."
			},
			{
				"nom": "Commentaire",
				"texte": "(en) Try to chase away your dark thoughts\\nby reading adventure novels for example.\\nCome back soon! Your juggling tricks\\nare greatly missed by \\c[2]His Majesty\\c[0].\""
			},
			{
				"nom": "Message",
				"texte": "Essaie de chasser tes idées noires\\nen lisant des romans d'aventure par exemple.\\nReviens-nous vite ! Tes tours de jonglage \\nmanquent beaucoup à \\c[2]Sa Majesté\\c[0].\""
			},
			{
				"nom": "Commentaire",
				"texte": "(en) \\c[2]Jean-Rainette\\c[0]"
			},
			{
				"nom": "Message",
				"texte": "\\c[2]Jean-Rainette\\c[0]"
			},
			{
				"nom": "Attendre",
				"nombreDeFrames": 8
			},
			{
				"nom": "ModifierInterrupteur",
				"numeroInterrupteur": 12,
				"valeur": false
			}
			],
			"vitesse": "moderee",
			"frequence": "basse",
			"animeEnMouvement": true,
			"animeALArret": false,
			"directionFixe": false,
			"traversable": false,
			"auDessusDeTout": false
		}
		]
	}
	]
}
