{
	"nom": "Echelle 0",
	"tileset": "Ventre",
	"largeur": 21,
	"hauteur": 20,
	"musique": {
		"nomFichierSonore": "Ascension Mouvementée.mid",
		"volume": 1.00,
		"tempo": 1.00
	},
	"fondSonore": {
		"nomFichierSonore": "InterieurDeLaBaleine.ogg",
		"volume": 0.50,
		"tempo": 1.00
	},
	"couche0": [
	[0007,0007,0007,0007,0007,0007,0007,0007,0007,0381,0382,0383,0007,0007,0007,0007,0007,0007,0007,0007,0007],
	[0007,0007,0007,0007,0007,0007,0007,0007,0007,0381,0382,0383,0007,0007,0007,0007,0007,0007,0007,0007,0007],
	[0007,0007,0007,0007,0007,0007,0007,0007,0007,0381,0382,0383,0007,0007,0007,0007,0007,0007,0007,0007,0007],
	[0007,0007,0007,0007,0007,0007,0007,0007,0007,0381,0382,0383,0007,0007,0007,0007,0007,0007,0007,0007,0007],
	[0007,0007,0007,0007,0007,0007,0007,0007,0007,0381,0382,0383,0007,0007,0007,0007,0007,0007,0007,0007,0007],
	[0007,0007,0007,0007,0007,0007,0007,0007,0007,0381,0382,0383,0007,0007,0007,0007,0007,0007,0007,0007,0007],
	[0007,0007,0007,0007,0007,0007,0007,0007,0007,0381,0382,0383,0007,0007,0007,0007,0007,0007,0007,0007,0007],
	[0007,0007,0007,0007,0007,0007,0007,0007,0007,0381,0382,0383,0007,0007,0007,0007,0007,0007,0007,0007,0007],
	[0007,0007,0007,0007,0007,0007,0007,0007,0007,0381,0382,0383,0007,0007,0007,0007,0007,0007,0007,0007,0007],
	[0007,0007,0007,0007,0007,0007,0007,0007,0007,0381,0382,0383,0007,0007,0007,0007,0007,0007,0007,0007,0007],
	[0007,0007,0007,0007,0007,0007,0007,0007,0007,0381,0382,0383,0007,0007,0007,0007,0007,0007,0007,0007,0007],
	[0007,0007,0007,0007,0007,0007,0007,0007,0007,0381,0382,0383,0007,0007,0007,0007,0007,0007,0007,0007,0007],
	[0007,0007,0007,0007,0007,0007,0007,0007,0007,0381,0382,0383,0007,0007,0007,0007,0007,0007,0007,0007,0007],
	[0007,0007,0007,0007,0007,0007,0007,0007,0007,0381,0382,0383,0007,0007,0007,0007,0007,0007,0007,0007,0007],
	[0007,0007,0007,0007,0007,0007,0007,0007,0007,0381,0382,0383,0007,0007,0007,0007,0007,0007,0007,0007,0007],
	[0007,0007,0007,0007,0007,0007,0007,0007,0007,0381,0382,0383,0007,0007,0007,0007,0007,0007,0007,0007,0007],
	[0007,0007,0007,0007,0007,0007,0007,0007,0007,0381,0382,0383,0007,0007,0007,0007,0007,0007,0007,0007,0007],
	[0007,0007,0007,0007,0007,0007,0007,0007,0007,0381,0382,0383,0007,0007,0007,0007,0007,0007,0007,0007,0007],
	[0007,0007,0007,0007,0007,0007,0007,0007,0007,0381,0382,0383,0007,0007,0007,0007,0007,0007,0007,0007,0007],
	[0007,0007,0007,0007,0007,0007,0007,0007,0007,0381,0382,0383,0007,0007,0007,0007,0007,0007,0007,0007,0007]
	],
	"couche1": [
	[-001,-001,-001,-001,-001,-001,-001,-001,-001,-001,0388,-001,-001,-001,-001,-001,-001,-001,-001,-001,-001],
	[-001,-001,-001,-001,-001,-001,-001,-001,-001,-001,0388,-001,-001,-001,-001,-001,-001,-001,-001,-001,-001],
	[-001,-001,-001,-001,-001,-001,-001,-001,-001,-001,0388,-001,-001,-001,-001,-001,-001,-001,-001,-001,-001],
	[-001,-001,-001,-001,-001,-001,-001,-001,-001,-001,0388,-001,-001,-001,-001,-001,-001,-001,-001,-001,-001],
	[-001,-001,-001,-001,-001,-001,-001,-001,-001,-001,0388,-001,-001,-001,-001,-001,-001,-001,-001,-001,-001],
	[-001,-001,-001,-001,-001,-001,-001,-001,-001,-001,0388,-001,-001,-001,-001,-001,-001,-001,-001,-001,-001],
	[-001,-001,-001,-001,-001,-001,-001,-001,-001,-001,0388,-001,-001,-001,-001,-001,-001,-001,-001,-001,-001],
	[-001,-001,-001,-001,-001,-001,-001,-001,-001,-001,0388,-001,-001,-001,-001,-001,-001,-001,-001,-001,-001],
	[-001,-001,-001,-001,-001,-001,-001,-001,-001,-001,0388,-001,-001,-001,-001,-001,-001,-001,-001,-001,-001],
	[-001,-001,-001,-001,-001,-001,-001,-001,-001,-001,0388,-001,-001,-001,-001,-001,-001,-001,-001,-001,-001],
	[-001,-001,-001,-001,-001,-001,-001,-001,-001,-001,0388,-001,-001,-001,-001,-001,-001,-001,-001,-001,-001],
	[-001,-001,-001,-001,-001,-001,-001,-001,-001,-001,0388,-001,-001,-001,-001,-001,-001,-001,-001,-001,-001],
	[-001,-001,-001,-001,-001,-001,-001,-001,-001,-001,0388,-001,-001,-001,-001,-001,-001,-001,-001,-001,-001],
	[-001,-001,-001,-001,-001,-001,-001,-001,-001,-001,0388,-001,-001,-001,-001,-001,-001,-001,-001,-001,-001],
	[-001,-001,-001,-001,-001,-001,-001,-001,-001,-001,0388,-001,-001,-001,-001,-001,-001,-001,-001,-001,-001],
	[-001,-001,-001,-001,-001,-001,-001,-001,-001,-001,0388,-001,-001,-001,-001,-001,-001,-001,-001,-001,-001],
	[-001,-001,-001,-001,-001,-001,-001,-001,-001,-001,0388,-001,-001,-001,-001,-001,-001,-001,-001,-001,-001],
	[-001,-001,-001,-001,-001,-001,-001,-001,-001,-001,0388,-001,-001,-001,-001,-001,-001,-001,-001,-001,-001],
	[-001,-001,-001,-001,-001,-001,-001,-001,-001,-001,0388,-001,-001,-001,-001,-001,-001,-001,-001,-001,-001],
	[-001,-001,-001,-001,-001,-001,-001,-001,-001,-001,0388,-001,-001,-001,-001,-001,-001,-001,-001,-001,-001]
	],
	"couche2": [
	[-001,-001,-001,-001,-001,-001,-001,-001,-001,-001,-001,-001,-001,-001,-001,-001,-001,-001,-001,-001,-001],
	[-001,-001,-001,-001,-001,-001,-001,-001,-001,-001,-001,-001,-001,-001,-001,-001,-001,-001,-001,-001,-001],
	[-001,-001,-001,-001,-001,-001,-001,-001,-001,-001,-001,-001,-001,-001,-001,-001,-001,-001,-001,-001,-001],
	[-001,-001,-001,-001,-001,-001,-001,-001,-001,-001,-001,-001,-001,-001,-001,-001,-001,-001,-001,-001,-001],
	[-001,-001,-001,-001,-001,-001,-001,-001,-001,-001,-001,-001,-001,-001,-001,-001,-001,-001,-001,-001,-001],
	[-001,-001,-001,-001,-001,-001,-001,-001,-001,-001,-001,-001,-001,-001,-001,-001,-001,-001,-001,-001,-001],
	[-001,-001,-001,-001,-001,-001,-001,-001,-001,-001,-001,-001,-001,-001,-001,-001,-001,-001,-001,-001,-001],
	[-001,-001,-001,-001,-001,-001,-001,-001,-001,-001,-001,-001,-001,-001,-001,-001,-001,-001,-001,-001,-001],
	[-001,-001,-001,-001,-001,-001,-001,-001,-001,-001,-001,-001,-001,-001,-001,-001,-001,-001,-001,-001,-001],
	[-001,-001,-001,-001,-001,-001,-001,-001,-001,-001,-001,-001,-001,-001,-001,-001,-001,-001,-001,-001,-001],
	[-001,-001,-001,-001,-001,-001,-001,-001,-001,-001,-001,-001,-001,-001,-001,-001,-001,-001,-001,-001,-001],
	[-001,-001,-001,-001,-001,-001,-001,-001,-001,-001,-001,-001,-001,-001,-001,-001,-001,-001,-001,-001,-001],
	[-001,-001,-001,-001,-001,-001,-001,-001,-001,-001,-001,-001,-001,-001,-001,-001,-001,-001,-001,-001,-001],
	[-001,-001,-001,-001,-001,-001,-001,-001,-001,-001,-001,-001,-001,-001,-001,-001,-001,-001,-001,-001,-001],
	[-001,-001,-001,-001,-001,-001,-001,-001,-001,-001,-001,-001,-001,-001,-001,-001,-001,-001,-001,-001,-001],
	[-001,-001,-001,-001,-001,-001,-001,-001,-001,-001,-001,-001,-001,-001,-001,-001,-001,-001,-001,-001,-001],
	[-001,-001,-001,-001,-001,-001,-001,-001,-001,-001,-001,-001,-001,-001,-001,-001,-001,-001,-001,-001,-001],
	[-001,-001,-001,-001,-001,-001,-001,-001,-001,-001,-001,-001,-001,-001,-001,-001,-001,-001,-001,-001,-001],
	[-001,-001,-001,-001,-001,-001,-001,-001,-001,-001,-001,-001,-001,-001,-001,-001,-001,-001,-001,-001,-001],
	[-001,-001,-001,-001,-001,-001,-001,-001,-001,-001,-001,-001,-001,-001,-001,-001,-001,-001,-001,-001,-001]
	],
	"events": [
	{
		"id": 1,
		"nom": "EV001",
		"x": 10,
		"y": 0,
		"pages": [
		{
			"conditions": [
			{
				"nom": "ArriveeAuContact"
			}
			],
			"commandes": [
			{
				"nom": "ChangerDeMap",
				"variable": false,
				"numeroNouvelleMap": 241,
				"xDebutHeros": 10,
				"yDebutHeros": 58
			}
			],
			"vitesse": 8,
			"frequence": 8,
			"animeEnMouvement": true,
			"animeALArret": false,
			"directionFixe": false,
			"traversable": false,
			"auDessusDeTout": false
		}
		]
	},
	{
		"id": 2,
		"nom": "EV002",
		"x": 16,
		"y": 4,
		"pages": [
		{
			"conditions": [
			],
			"commandes": [
			{
				"nom": "ModifierBrouillard",
				"opacite": 0,
				"modeDeFusion": "normal",
				"defilementX": 0,
				"defilementY": 0,
				"zoom": 100,
				"nuance": 0,
				"nomImage": ""
			},
			{
				"nom": "ModifierBrouillard",
				"rouge": 127,
				"vert": 127,
				"bleu": 127,
				"gris": 0,
				"dureeTransition": 0
			},
			{
				"nom": "ModifierMeteo",
				"type": "rien",
				"intensite": 9
			},
			{
				"nom": "Deplacement",
				"idEventADeplacer": 0,
				"ignorerLesMouvementsImpossibles": false,
				"repeterLeDeplacement": false,
				"attendreLaFinDuDeplacement": false,
				"mouvements": [
				{
					"nom": "RegarderDansUneDirection",
					"direction": 3
				},
				{
					"nom": "RegarderDansUneDirection",
					"direction": 3
				},
				{
					"nom": "RegarderDansUneDirection",
					"direction": 3
				},
				{
					"nom": "RendreDirectionFixe",
					"directionFixe": true
				},
				{
					"nom": "RendreDirectionFixe",
					"directionFixe": true
				},
				{
					"nom": "RendreDirectionFixe",
					"directionFixe": true
				},
				{
					"nom": "RendreAnimeEnMouvement",
					"animeEnMouvement": true
				}
				]
			},
			{
				"nom": "Attendre",
				"nombreDeFrames": 8
			},
			{
				"nom": "ModifierBrouillard",
				"opacite": 0,
				"modeDeFusion": "normal",
				"defilementX": 0,
				"defilementY": 0,
				"zoom": 100,
				"nuance": 0,
				"nomImage": ""
			},
			{
				"nom": "ModifierBrouillard",
				"rouge": 127,
				"vert": 127,
				"bleu": 127,
				"gris": 0,
				"dureeTransition": 0
			},
			{
				"nom": "ModifierMeteo",
				"type": "rien",
				"intensite": 9
			},
			{
				"nom": "Deplacement",
				"idEventADeplacer": 0,
				"ignorerLesMouvementsImpossibles": false,
				"repeterLeDeplacement": false,
				"attendreLaFinDuDeplacement": false,
				"mouvements": [
				{
					"nom": "RegarderDansUneDirection",
					"direction": 3
				},
				{
					"nom": "RegarderDansUneDirection",
					"direction": 3
				},
				{
					"nom": "RegarderDansUneDirection",
					"direction": 3
				},
				{
					"nom": "RendreDirectionFixe",
					"directionFixe": true
				},
				{
					"nom": "RendreDirectionFixe",
					"directionFixe": true
				},
				{
					"nom": "RendreDirectionFixe",
					"directionFixe": true
				},
				{
					"nom": "RendreAnimeEnMouvement",
					"animeEnMouvement": true
				}
				]
			},
			{
				"nom": "Attendre",
				"nombreDeFrames": 8
			},
			{
				"nom": "SupprimerEvent"
			}
			],
			"vitesse": 8,
			"frequence": 8,
			"animeEnMouvement": true,
			"animeALArret": false,
			"directionFixe": false,
			"traversable": false,
			"auDessusDeTout": false
		}
		]
	},
	{
		"id": 3,
		"nom": "EV003",
		"x": 10,
		"y": 19,
		"pages": [
		{
			"conditions": [
			{
				"nom": "ArriveeAuContact"
			}
			],
			"commandes": [
			{
				"nom": "ChangerDeMap",
				"variable": false,
				"numeroNouvelleMap": 247,
				"xDebutHeros": 12,
				"yDebutHeros": 1
			}
			],
			"vitesse": 8,
			"frequence": 8,
			"animeEnMouvement": true,
			"animeALArret": false,
			"directionFixe": false,
			"traversable": false,
			"auDessusDeTout": false
		}
		]
	}
	]
}
