{
	"nom": "Bas de l'Echelle",
	"tileset": "Ventre",
	"largeur": 25,
	"hauteur": 25,
	"musique": {
		"nomFichierSonore": "Ascension Mouvementée.mp3",
		"volume": 0.80,
		"tempo": 1.00
	},
	"fondSonore": {
		"nomFichierSonore": "InterieurDeLaBaleine.ogg",
		"volume": 0.50,
		"tempo": 1.00
	},
	"couche0": [
	[0809,0809,0809,0809,0800,0011,0011,0011,0011,0011,0011,0011,0011,0011,0011,0011,0011,0011,0011,0011,0802,0809,0809,0809,0809],
	[0809,0809,0809,0809,0808,0009,0011,0011,0011,0011,0011,0011,0011,0011,0011,0011,0011,0011,0011,0022,0810,0809,0809,0809,0809],
	[0809,0809,0809,0809,0808,0032,0009,0011,0011,0011,0011,0011,0011,0011,0011,0011,0011,0011,0022,0038,0810,0809,0809,0809,0809],
	[0809,0809,0809,0809,0808,0032,0032,0009,0011,0011,0011,0011,0011,0011,0011,0011,0011,0022,0038,0038,0810,0809,0809,0809,0809],
	[0809,0809,0809,0809,0808,0032,0032,0032,0009,0011,0011,0011,0011,0011,0011,0011,0022,0038,0038,0038,0810,0809,0809,0809,0809],
	[0809,0809,0809,0809,0808,0032,0032,0032,0032,0052,0008,0000,0000,0000,0000,0000,0038,0038,0038,0038,0810,0809,0809,0809,0809],
	[0809,0809,0809,0809,0808,0032,0032,0032,0032,0000,0000,0000,0000,0000,0000,0000,0038,0038,0038,0038,0810,0809,0809,0809,0809],
	[0809,0809,0809,0809,0808,0032,0032,0032,0032,0000,0000,-002,-002,-002,0000,0000,0038,0038,0038,0038,0810,0809,0809,0809,0809],
	[0809,0809,0809,0809,0808,0032,0032,0032,0032,0000,0000,-002,-002,-002,0000,0000,0038,0038,0038,0038,0810,0809,0809,0809,0809],
	[0809,0809,0809,0809,0808,0032,0032,0032,0032,0000,0000,-002,-002,-002,0000,0000,0038,0038,0038,0038,0810,0809,0809,0809,0809],
	[0809,0809,0809,0809,0808,0032,0032,0032,0032,0000,0000,0000,0000,0000,0000,0000,0038,0038,0038,0038,0810,0809,0809,0809,0809],
	[0809,0809,0809,0809,0808,0032,0032,0032,0032,0008,0000,0000,0000,0000,0000,0052,0038,0038,0038,0038,0810,0809,0809,0809,0809],
	[0809,0809,0809,0809,0808,0032,0032,0032,0048,0060,0060,0049,0000,0053,0060,0060,0054,0038,0038,0038,0810,0809,0809,0809,0809],
	[0809,0809,0809,0809,0808,0032,0032,0048,0060,0060,0049,0032,0000,0038,0053,0060,0060,0054,0038,0038,0810,0809,0809,0809,0809],
	[0809,0809,0809,0809,0808,0032,0048,0060,0060,0049,0032,0032,0000,0038,0038,0053,0060,0060,0054,0038,0810,0809,0809,0809,0809],
	[0809,0809,0809,0809,0808,0048,0060,0060,0049,0032,0032,0032,0000,0038,0038,0038,0053,0060,0060,0054,0810,0809,0809,0809,0809],
	[0809,0809,0809,0809,0816,0817,0817,0049,0032,0032,0032,0032,0000,0038,0038,0038,0038,0053,0817,0817,0818,0809,0809,0809,0809],
	[0809,0809,0809,0809,0809,0809,0809,0808,0032,0032,0032,0032,0000,0038,0038,0038,0038,0810,0809,0809,0809,0809,0809,0809,0809],
	[0809,0809,0809,0809,0809,0809,0809,0808,0032,0032,0032,0032,0000,0038,0038,0038,0038,0810,0809,0809,0809,0809,0809,0809,0809],
	[0809,0809,0809,0809,0809,0809,0809,0808,0032,0032,0032,0032,0000,0038,0038,0038,0038,0810,0809,0809,0809,0809,0809,0809,0809],
	[0809,0809,0809,0809,0809,0809,0809,0808,0032,0032,0032,0032,0000,0038,0038,0038,0038,0810,0809,0809,0809,0809,0809,0809,0809],
	[0809,0809,0809,0809,0809,0809,0809,0808,0032,0032,0032,0032,0000,0038,0038,0038,0038,0810,0809,0809,0809,0809,0809,0809,0809],
	[0809,0809,0809,0809,0809,0809,0809,0808,0032,0032,0032,0032,0000,0038,0038,0038,0038,0810,0809,0809,0809,0809,0809,0809,0809],
	[0809,0809,0809,0809,0809,0809,0809,0808,0032,0032,0032,0032,0000,0038,0038,0038,0038,0810,0809,0809,0809,0809,0809,0809,0809],
	[0809,0809,0809,0809,0809,0809,0809,0808,0032,0032,0032,0032,0000,0038,0038,0038,0038,0810,0809,0809,0809,0809,0809,0809,0809]
	],
	"couche1": [
	[-001,-001,-001,-001,-001,-001,-001,-001,-001,-001,-001,-001,0388,-001,-001,-001,-001,-001,-001,-001,-001,-001,-001,-001,-001],
	[-001,-001,-001,-001,-001,-001,-001,-001,-001,-001,-001,-001,0388,-001,-001,-001,-001,-001,-001,-001,-001,-001,-001,-001,-001],
	[-001,-001,-001,-001,-001,-001,-001,-001,-001,-001,-001,-001,0388,-001,-001,-001,-001,-001,-001,-001,-001,-001,-001,-001,-001],
	[-001,-001,-001,-001,-001,-001,-001,-001,-001,-001,-001,-001,0388,-001,0039,-001,-001,-001,-001,-001,-001,-001,-001,-001,-001],
	[-001,-001,-001,-001,-001,-001,-001,-001,-001,0044,-001,-001,0388,-001,0047,-001,-001,-001,-001,-001,-001,-001,-001,-001,-001],
	[-001,-001,-001,-001,-001,-001,-001,-001,-001,-001,-001,-001,0396,-001,-001,-001,-001,-001,-001,-001,-001,-001,-001,-001,-001],
	[-001,-001,-001,-001,-001,-001,-001,-001,-001,-001,-001,-001,-001,-001,-001,-001,-001,-001,-001,-001,-001,-001,-001,-001,-001],
	[-001,-001,-001,-001,-001,-001,-001,-001,-001,-001,-001,-001,-001,-001,-001,-001,-001,-001,-001,-001,-001,-001,-001,-001,-001],
	[-001,-001,-001,-001,-001,-001,-001,-001,-001,-001,-001,-001,-001,-001,-001,-001,-001,-001,-001,-001,-001,-001,-001,-001,-001],
	[-001,-001,-001,-001,-001,-001,-001,-001,-001,-001,-001,-001,-001,-001,-001,-001,-001,-001,-001,-001,-001,-001,-001,-001,-001],
	[-001,-001,-001,-001,-001,-001,-001,-001,-001,-001,-001,-001,-001,-001,-001,0044,-001,-001,-001,-001,-001,-001,-001,-001,-001],
	[-001,-001,-001,-001,-001,-001,-001,-001,-001,-001,-001,-001,-001,-001,-001,-001,-001,-001,-001,-001,-001,-001,-001,-001,-001],
	[-001,-001,-001,-001,-001,-001,-001,-001,-001,-001,-001,-001,-001,-001,-001,-001,-001,-001,-001,-001,-001,-001,-001,-001,-001],
	[-001,-001,-001,-001,-001,-001,-001,-001,-001,-001,-001,-001,-001,-001,-001,-001,-001,-001,-001,-001,-001,-001,-001,-001,-001],
	[-001,-001,-001,-001,-001,-001,-001,-001,-001,-001,-001,-001,-001,-001,-001,-001,-001,-001,-001,-001,-001,-001,-001,-001,-001],
	[-001,-001,-001,-001,-001,-001,-001,-001,-001,-001,-001,-001,-001,-001,-001,-001,-001,-001,-001,-001,-001,-001,-001,-001,-001],
	[-001,-001,-001,-001,-001,-001,-001,-001,-001,-001,-001,-001,-001,-001,-001,-001,-001,-001,-001,-001,-001,-001,-001,-001,-001],
	[-001,-001,-001,-001,-001,-001,-001,-001,-001,-001,-001,-001,-001,-001,-001,-001,-001,-001,-001,-001,-001,-001,-001,-001,-001],
	[-001,-001,-001,-001,-001,-001,-001,-001,-001,-001,-001,-001,-001,-001,-001,-001,-001,-001,-001,-001,-001,-001,-001,-001,-001],
	[-001,-001,-001,-001,-001,-001,-001,-001,-001,-001,-001,-001,-001,-001,-001,-001,-001,-001,-001,-001,-001,-001,-001,-001,-001],
	[-001,-001,-001,-001,-001,-001,-001,-001,-001,-001,-001,-001,-001,-001,-001,-001,-001,-001,-001,-001,-001,-001,-001,-001,-001],
	[-001,-001,-001,-001,-001,-001,-001,-001,-001,-001,-001,-001,-001,-001,-001,-001,-001,-001,-001,-001,-001,-001,-001,-001,-001],
	[-001,-001,-001,-001,-001,-001,-001,-001,-001,-001,-001,-001,-001,-001,-001,-001,-001,-001,-001,-001,-001,-001,-001,-001,-001],
	[-001,-001,-001,-001,-001,-001,-001,-001,-001,-001,-001,-001,-001,-001,-001,-001,-001,-001,-001,-001,-001,-001,-001,-001,-001],
	[-001,-001,-001,-001,-001,-001,-001,-001,-001,-001,-001,-001,-001,-001,-001,-001,-001,-001,-001,-001,-001,-001,-001,-001,-001]
	],
	"couche2": [
	[-001,-001,-001,-001,-001,-001,-001,-001,-001,-001,-001,-001,-001,-001,-001,-001,-001,-001,-001,-001,-001,-001,-001,-001,-001],
	[-001,-001,-001,-001,-001,-001,-001,-001,-001,-001,-001,-001,-001,-001,-001,-001,-001,-001,-001,-001,-001,-001,-001,-001,-001],
	[-001,-001,-001,-001,-001,-001,-001,-001,-001,-001,-001,-001,-001,-001,-001,-001,-001,-001,-001,-001,-001,-001,-001,-001,-001],
	[-001,-001,-001,-001,-001,-001,-001,-001,-001,-001,-001,-001,-001,-001,-001,-001,-001,-001,-001,-001,-001,-001,-001,-001,-001],
	[-001,-001,-001,-001,-001,-001,-001,-001,-001,-001,-001,-001,-001,-001,-001,-001,-001,-001,-001,-001,-001,-001,-001,-001,-001],
	[-001,-001,-001,-001,-001,-001,-001,-001,-001,-001,-001,-001,-001,-001,-001,-001,-001,-001,-001,-001,-001,-001,-001,-001,-001],
	[-001,-001,-001,-001,-001,-001,-001,-001,-001,-001,-001,-001,-001,-001,-001,-001,-001,-001,-001,-001,-001,-001,-001,-001,-001],
	[-001,-001,-001,-001,-001,-001,-001,-001,-001,-001,-001,-001,-001,-001,-001,-001,-001,-001,-001,-001,-001,-001,-001,-001,-001],
	[-001,-001,-001,-001,-001,-001,-001,-001,-001,-001,-001,-001,-001,-001,-001,-001,-001,-001,-001,-001,-001,-001,-001,-001,-001],
	[-001,-001,-001,-001,-001,-001,-001,-001,-001,-001,-001,-001,-001,-001,-001,-001,-001,-001,-001,-001,-001,-001,-001,-001,-001],
	[-001,-001,-001,-001,-001,-001,-001,-001,-001,-001,-001,-001,-001,-001,-001,-001,-001,-001,-001,-001,-001,-001,-001,-001,-001],
	[-001,-001,-001,-001,-001,-001,-001,-001,-001,-001,-001,-001,-001,-001,-001,-001,-001,-001,-001,-001,-001,-001,-001,-001,-001],
	[-001,-001,-001,-001,-001,-001,-001,-001,-001,-001,-001,-001,-001,-001,-001,-001,-001,-001,-001,-001,-001,-001,-001,-001,-001],
	[-001,-001,-001,-001,-001,-001,-001,-001,-001,-001,-001,-001,-001,-001,-001,-001,-001,-001,-001,-001,-001,-001,-001,-001,-001],
	[-001,-001,-001,-001,-001,-001,-001,-001,-001,-001,-001,-001,-001,-001,-001,-001,-001,-001,-001,-001,-001,-001,-001,-001,-001],
	[-001,-001,-001,-001,-001,-001,-001,-001,-001,-001,-001,-001,-001,-001,-001,-001,-001,-001,-001,-001,-001,-001,-001,-001,-001],
	[-001,-001,-001,-001,-001,-001,-001,-001,-001,-001,-001,-001,-001,-001,-001,-001,-001,-001,-001,-001,-001,-001,-001,-001,-001],
	[-001,-001,-001,-001,-001,-001,-001,-001,-001,-001,-001,-001,-001,-001,-001,-001,-001,-001,-001,-001,-001,-001,-001,-001,-001],
	[-001,-001,-001,-001,-001,-001,-001,-001,-001,-001,-001,-001,-001,-001,-001,-001,-001,-001,-001,-001,-001,-001,-001,-001,-001],
	[-001,-001,-001,-001,-001,-001,-001,-001,-001,-001,-001,-001,-001,-001,-001,-001,-001,-001,-001,-001,-001,-001,-001,-001,-001],
	[-001,-001,-001,-001,-001,-001,-001,-001,-001,-001,-001,-001,-001,-001,-001,-001,-001,-001,-001,-001,-001,-001,-001,-001,-001],
	[-001,-001,-001,-001,-001,-001,-001,-001,-001,-001,-001,-001,-001,-001,-001,-001,-001,-001,-001,-001,-001,-001,-001,-001,-001],
	[-001,-001,-001,-001,-001,-001,-001,-001,-001,-001,-001,-001,-001,-001,-001,-001,-001,-001,-001,-001,-001,-001,-001,-001,-001],
	[-001,-001,-001,-001,-001,-001,-001,-001,-001,-001,-001,-001,-001,-001,-001,-001,-001,-001,-001,-001,-001,-001,-001,-001,-001],
	[-001,-001,-001,-001,-001,-001,-001,-001,-001,-001,-001,-001,-001,-001,-001,-001,-001,-001,-001,-001,-001,-001,-001,-001,-001]
	],
	"events": [
	{
		"id": 1,
		"nom": "EV001",
		"x": 12,
		"y": 0,
		"pages": [
		{
			"conditions": [
			{
				"nom": "ArriveeAuContact"
			}
			],
			"commandes": [
			{
				"nom": "ChangerDeMap",
				"variable": false,
				"numeroNouvelleMap": 244,
				"xDebutHeros": 10,
				"yDebutHeros": 18
			}
			],
			"vitesse": "moderee",
			"frequence": "basse",
			"animeEnMouvement": true,
			"animeALArret": false,
			"directionFixe": false,
			"traversable": false,
			"auDessusDeTout": false
		}
		]
	},
	{
		"id": 2,
		"nom": "Parchemin",
		"x": 14,
		"y": 4,
		"pages": [
		{
			"conditions": [
			{
				"nom": "Parler"
			}
			],
			"commandes": [
			{
				"nom": "ModifierInterrupteur",
				"numeroInterrupteur": 12,
				"valeur": true
			},
			{
				"nom": "Message",
				"texte": "\"Viens !\\nMarchons pour voir la neige,\\njusqu'à tomber d'épuisement !\""
			},
			{
				"nom": "Message",
				"texte": "\\c[02]Matsuo Bashô\\c[02]"
			},
			{
				"nom": "Attendre",
				"nombreDeFrames": 8
			},
			{
				"nom": "ModifierInterrupteur",
				"numeroInterrupteur": 12,
				"valeur": false
			}
			],
			"vitesse": "moderee",
			"frequence": "basse",
			"animeEnMouvement": true,
			"animeALArret": false,
			"directionFixe": false,
			"traversable": false,
			"auDessusDeTout": false
		}
		]
	},
	{
		"id": 3,
		"nom": "EV003",
		"x": 19,
		"y": 5,
		"pages": [
		{
			"conditions": [
			],
			"commandes": [
			{
				"nom": "ModifierVariable",
				"numeroVariable": 3,
				"operationAFaire": "rendre egal a",
				"valeurADonner": 0,
				"operationAFaire2": "coordonnee y"
			},
			{
				"nom": "ConditionVariable",
				"numeroVariable": 3,
				"inegalite": ">=",
				"valeurQuIlEstCenseAvoir": 5,
				"comparerAUneAutreVariable": false,
				"numero": 0
			},
			{
				"nom": "Deplacement",
				"idEventADeplacer": 0,
				"ignorerLesMouvementsImpossibles": false,
				"repeterLeDeplacement": false,
				"attendreLaFinDuDeplacement": false,
				"mouvements": [
				{
					"nom": "RendreTraversable",
					"traversable": false
				},
				{
					"nom": "RendreDirectionFixe",
					"directionFixe": false
				},
				{
					"nom": "RendreDirectionFixe",
					"directionFixe": false
				},
				{
					"nom": "RendreAnimeEnMouvement",
					"animeEnMouvement": true
				},
				{
					"nom": "RendreAnimeALArret",
					"animeALArret": false
				}
				]
			},
			{
				"nom": "ConditionSinon",
				"numero": 0
			},
			{
				"nom": "ConditionFin",
				"numero": 0
			},
			{
				"nom": "Attendre",
				"nombreDeFrames": 1
			}
			],
			"vitesse": "moderee",
			"frequence": "basse",
			"animeEnMouvement": true,
			"animeALArret": false,
			"directionFixe": false,
			"traversable": false,
			"auDessusDeTout": false
		}
		]
	},
	{
		"id": 4,
		"nom": "EV004",
		"x": 12,
		"y": 24,
		"pages": [
		{
			"conditions": [
			{
				"nom": "ArriveeAuContact"
			}
			],
			"commandes": [
			{
				"nom": "ChangerDeMap",
				"variable": false,
				"numeroNouvelleMap": 280,
				"xDebutHeros": 7,
				"yDebutHeros": 1
			}
			],
			"vitesse": "moderee",
			"frequence": "basse",
			"animeEnMouvement": true,
			"animeALArret": false,
			"directionFixe": false,
			"traversable": false,
			"auDessusDeTout": false
		}
		]
	}
	]
}
