{
	"nom": "Enigme du vitrail crabe (haut)",
	"tileset": "Donjon",
	"largeur": 25,
	"hauteur": 25,
	"musique": {
		"nomFichierSonore": "Casse-tete.ogg",
		"volume": 0.80,
		"tempo": 1.00
	},
	"fondSonore": {
		"nomFichierSonore": "",
		"volume": 0.00,
		"tempo": 1.00
	},
	"couche0": [
	[0002,0002,0002,0002,0002,0002,0002,0002,0002,0002,0002,0002,0002,0002,0002,0002,0002,0002,0002,0002,0002,0002,0002,0002,0002],
	[0002,0002,0002,0002,0002,0002,0002,0002,0002,0002,0002,0002,0002,0002,0002,0002,0002,0002,0002,0002,0002,0002,0002,0002,0002],
	[0002,0002,0002,0002,0002,0002,0002,0002,0002,0002,0002,0002,0002,0002,0002,0002,0002,0002,0002,0002,0002,0002,0002,0002,0002],
	[0002,0002,0002,0002,0002,0002,0002,0002,0002,0002,0002,0002,0002,0002,0002,0002,0002,0002,0002,0002,0002,0002,0002,0002,0002],
	[0002,0002,0002,0002,0002,0002,0002,0002,0002,0002,0002,0002,0002,0002,0002,0002,0002,0002,0002,0002,0002,0002,0002,0002,0002],
	[0002,0002,0002,0002,0002,0002,0036,0037,0004,0005,0004,0005,0004,0005,0004,0005,0004,0038,0039,0002,0002,0002,0002,0002,0002],
	[0002,0002,0002,0002,0002,0002,0044,0045,0012,0013,0012,0013,0012,0013,0012,0013,0012,0046,0047,0002,0002,0002,0002,0002,0002],
	[0002,0002,0002,0002,0002,0002,0020,0021,0000,0000,0000,0000,0000,0000,0000,0000,0000,0006,0007,0002,0002,0002,0002,0002,0002],
	[0002,0002,0002,0002,0002,0002,0028,0029,0000,0000,0000,-004,0013,-004,0000,0000,0000,0014,0015,0002,0002,0002,0002,0002,0002],
	[0002,0002,0002,0002,0002,0002,0020,0021,0000,0000,0000,-004,-004,-004,0000,0000,0000,0006,0007,0002,0002,0002,0002,0002,0002],
	[0002,0002,0002,0002,0002,0002,0028,0029,0000,0000,0000,0000,0000,0000,0000,0000,0000,0014,0015,0002,0002,0002,0002,0002,0002],
	[0002,0002,0002,0002,0002,0002,0020,0021,0000,0000,0000,0010,0010,0010,0000,0000,0000,0006,0007,0002,0002,0002,0002,0002,0002],
	[0002,0002,0002,0002,0002,0002,0028,0029,0000,0000,0000,0010,-004,0010,0000,0000,0000,0014,0015,0002,0002,0002,0002,0002,0002],
	[0002,0002,0002,0002,0002,0002,0020,0021,0000,0000,0000,0010,0010,0010,0000,0000,0000,0006,0007,0002,0002,0002,0002,0002,0002],
	[0002,0002,0002,0002,0002,0002,0028,0029,0000,0000,0000,0000,0000,0000,0000,0000,0000,0014,0015,0002,0002,0002,0002,0002,0002],
	[0002,0002,0002,0002,0002,0002,0020,0021,0000,0000,0000,0000,0000,0000,0000,0000,0000,0006,0007,0002,0002,0002,0002,0002,0002],
	[0002,0002,0002,0002,0002,0002,0052,0053,0023,0022,0023,0032,0117,0034,0023,0022,0023,0054,0055,0002,0002,0002,0002,0002,0002],
	[0002,0002,0002,0002,0002,0002,0060,0061,0031,0030,0031,0040,0041,0042,0031,0030,0031,0062,0063,0002,0002,0002,0002,0002,0002],
	[0002,0002,0002,0002,0002,0002,0002,0002,0002,0002,0002,0002,0002,0002,0002,0002,0002,0002,0002,0002,0002,0002,0002,0002,0002],
	[0002,0002,0002,0002,0002,0002,0002,0002,0002,0002,0002,0002,0002,0002,0002,0002,0002,0002,0002,0002,0002,0002,0002,0002,0002],
	[0002,0002,0002,0002,0002,0002,0002,0002,0002,0002,0002,0002,0002,0002,0002,0002,0002,0002,0002,0002,0002,0002,0002,0002,0002],
	[0002,0002,0002,0002,0002,0002,0002,0002,0002,0002,0002,0002,0002,0002,0002,0002,0002,0002,0002,0002,0002,0002,0002,0002,0002],
	[0002,0002,0002,0002,0002,0002,0002,0002,0002,0002,0002,0002,0002,0002,0002,0002,0002,0002,0002,0002,0002,0002,0002,0002,0002],
	[0002,0002,0002,0002,0002,0002,0002,0002,0002,0002,0002,0002,0002,0002,0002,0002,0002,0002,0002,0002,0002,0002,0002,0002,0002],
	[0002,0002,0002,0002,0002,0002,0002,0002,0002,0002,0002,0002,0002,0002,0002,0002,0002,0002,0002,0002,0002,0002,0002,0002,0002]
	],
	"couche1": [
	[-001,-001,-001,-001,-001,-001,-001,-001,-001,-001,-001,-001,-001,-001,-001,-001,-001,-001,-001,-001,-001,-001,-001,-001,-001],
	[-001,-001,-001,-001,-001,-001,-001,-001,-001,-001,-001,-001,-001,-001,-001,-001,-001,-001,-001,-001,-001,-001,-001,-001,-001],
	[-001,-001,-001,-001,-001,-001,-001,-001,-001,-001,-001,-001,-001,-001,-001,-001,-001,-001,-001,-001,-001,-001,-001,-001,-001],
	[-001,-001,-001,-001,-001,-001,-001,-001,-001,-001,-001,-001,-001,-001,-001,-001,-001,-001,-001,-001,-001,-001,-001,-001,-001],
	[-001,-001,-001,-001,-001,-001,-001,-001,-001,-001,-001,-001,-001,-001,-001,-001,-001,-001,-001,-001,-001,-001,-001,-001,-001],
	[-001,-001,-001,-001,-001,-001,-001,-001,-001,-001,-001,-001,-001,-001,-001,-001,-001,-001,-001,-001,-001,-001,-001,-001,-001],
	[-001,-001,-001,-001,-001,-001,-001,-001,-001,-001,-001,-001,-001,-001,-001,-001,-001,-001,-001,-001,-001,-001,-001,-001,-001],
	[-001,-001,-001,-001,-001,-001,-001,-001,-001,-001,-001,-001,-001,-001,-001,-001,-001,-001,-001,-001,-001,-001,-001,-001,-001],
	[-001,-001,-001,-001,-001,-001,-001,-001,-001,-001,-001,-001,-005,-001,-001,-001,-001,-001,-001,-001,-001,-001,-001,-001,-001],
	[-001,-001,-001,-001,-001,-001,-001,-001,-001,-001,-001,-001,-001,-001,-001,-001,-001,-001,-001,-001,-001,-001,-001,-001,-001],
	[-001,-001,-001,-001,-001,-001,-001,-001,-001,-001,-001,-001,-001,-001,-001,-001,-001,-001,-001,-001,-001,-001,-001,-001,-001],
	[-001,-001,-001,-001,-001,-001,-001,-001,-001,-001,-001,-001,-001,-001,-001,-001,-001,-001,-001,-001,-001,-001,-001,-001,-001],
	[-001,-001,-001,-001,-001,-001,-001,-001,-001,-001,-001,-001,-001,-001,-001,-001,-001,-001,-001,-001,-001,-001,-001,-001,-001],
	[-001,-001,-001,-001,-001,-001,-001,-001,-001,-001,-001,-001,-001,-001,-001,-001,-001,-001,-001,-001,-001,-001,-001,-001,-001],
	[-001,-001,-001,-001,-001,-001,-001,-001,-001,-001,-001,-001,-001,-001,-001,-001,-001,-001,-001,-001,-001,-001,-001,-001,-001],
	[-001,-001,-001,-001,-001,-001,-001,-001,-001,-001,-001,-001,-001,-001,-001,-001,-001,-001,-001,-001,-001,-001,-001,-001,-001],
	[-001,-001,-001,-001,-001,-001,-001,-001,-001,-001,-001,0088,0089,0090,-001,-001,-001,-001,-001,-001,-001,-001,-001,-001,-001],
	[-001,-001,-001,-001,-001,-001,-001,-001,-001,-001,-001,0096,0097,0098,-001,-001,-001,-001,-001,-001,-001,-001,-001,-001,-001],
	[-001,-001,-001,-001,-001,-001,-001,-001,-001,-001,-001,-001,-001,-001,-001,-001,-001,-001,-001,-001,-001,-001,-001,-001,-001],
	[-001,-001,-001,-001,-001,-001,-001,-001,-001,-001,-001,-001,-001,-001,-001,-001,-001,-001,-001,-001,-001,-001,-001,-001,-001],
	[-001,-001,-001,-001,-001,-001,-001,-001,-001,-001,-001,-001,-001,-001,-001,-001,-001,-001,-001,-001,-001,-001,-001,-001,-001],
	[-001,-001,-001,-001,-001,-001,-001,-001,-001,-001,-001,-001,-001,-001,-001,-001,-001,-001,-001,-001,-001,-001,-001,-001,-001],
	[-001,-001,-001,-001,-001,-001,-001,-001,-001,-001,-001,-001,-001,-001,-001,-001,-001,-001,-001,-001,-001,-001,-001,-001,-001],
	[-001,-001,-001,-001,-001,-001,-001,-001,-001,-001,-001,-001,-001,-001,-001,-001,-001,-001,-001,-001,-001,-001,-001,-001,-001],
	[-001,-001,-001,-001,-001,-001,-001,-001,-001,-001,-001,-001,-001,-001,-001,-001,-001,-001,-001,-001,-001,-001,-001,-001,-001]
	],
	"couche2": [
	[-001,-001,-001,-001,-001,-001,-001,-001,-001,-001,-001,-001,-001,-001,-001,-001,-001,-001,-001,-001,-001,-001,-001,-001,-001],
	[-001,-001,-001,-001,-001,-001,-001,-001,-001,-001,-001,-001,-001,-001,-001,-001,-001,-001,-001,-001,-001,-001,-001,-001,-001],
	[-001,-001,-001,-001,-001,-001,-001,-001,-001,-001,-001,-001,-001,-001,-001,-001,-001,-001,-001,-001,-001,-001,-001,-001,-001],
	[-001,-001,-001,-001,-001,-001,-001,-001,-001,-001,-001,-001,-001,-001,-001,-001,-001,-001,-001,-001,-001,-001,-001,-001,-001],
	[-001,-001,-001,-001,-001,-001,-001,-001,-001,-001,-001,-001,-001,-001,-001,-001,-001,-001,-001,-001,-001,-001,-001,-001,-001],
	[-001,-001,-001,-001,-001,-001,-001,-001,-001,-001,-001,-001,-001,-001,-001,-001,-001,-001,-001,-001,-001,-001,-001,-001,-001],
	[-001,-001,-001,-001,-001,-001,-001,-001,-001,-001,-001,-001,-001,-001,-001,-001,-001,-001,-001,-001,-001,-001,-001,-001,-001],
	[-001,-001,-001,-001,-001,-001,-001,-001,-001,-001,-001,-001,-001,-001,-001,-001,-001,-001,-001,-001,-001,-001,-001,-001,-001],
	[-001,-001,-001,-001,-001,-001,-001,-001,-001,-001,-001,-001,-001,-001,-001,-001,-001,-001,-001,-001,-001,-001,-001,-001,-001],
	[-001,-001,-001,-001,-001,-001,-001,-001,-001,-001,-001,-001,-001,-001,-001,-001,-001,-001,-001,-001,-001,-001,-001,-001,-001],
	[-001,-001,-001,-001,-001,-001,-001,-001,-001,-001,-001,-001,-001,-001,-001,-001,-001,-001,-001,-001,-001,-001,-001,-001,-001],
	[-001,-001,-001,-001,-001,-001,-001,-001,-001,-001,-001,-001,-001,-001,-001,-001,-001,-001,-001,-001,-001,-001,-001,-001,-001],
	[-001,-001,-001,-001,-001,-001,-001,-001,-001,-001,-001,-001,-001,-001,-001,-001,-001,-001,-001,-001,-001,-001,-001,-001,-001],
	[-001,-001,-001,-001,-001,-001,-001,-001,-001,-001,-001,-001,-001,-001,-001,-001,-001,-001,-001,-001,-001,-001,-001,-001,-001],
	[-001,-001,-001,-001,-001,-001,-001,-001,-001,-001,-001,-001,-001,-001,-001,-001,-001,-001,-001,-001,-001,-001,-001,-001,-001],
	[-001,-001,-001,-001,-001,-001,-001,-001,-001,-001,-001,-001,-001,-001,-001,-001,-001,-001,-001,-001,-001,-001,-001,-001,-001],
	[-001,-001,-001,-001,-001,-001,-001,-001,-001,-001,-001,-001,-001,-001,-001,-001,-001,-001,-001,-001,-001,-001,-001,-001,-001],
	[-001,-001,-001,-001,-001,-001,-001,-001,-001,-001,-001,-001,-001,-001,-001,-001,-001,-001,-001,-001,-001,-001,-001,-001,-001],
	[-001,-001,-001,-001,-001,-001,-001,-001,-001,-001,-001,-001,-001,-001,-001,-001,-001,-001,-001,-001,-001,-001,-001,-001,-001],
	[-001,-001,-001,-001,-001,-001,-001,-001,-001,-001,-001,-001,-001,-001,-001,-001,-001,-001,-001,-001,-001,-001,-001,-001,-001],
	[-001,-001,-001,-001,-001,-001,-001,-001,-001,-001,-001,-001,-001,-001,-001,-001,-001,-001,-001,-001,-001,-001,-001,-001,-001],
	[-001,-001,-001,-001,-001,-001,-001,-001,-001,-001,-001,-001,-001,-001,-001,-001,-001,-001,-001,-001,-001,-001,-001,-001,-001],
	[-001,-001,-001,-001,-001,-001,-001,-001,-001,-001,-001,-001,-001,-001,-001,-001,-001,-001,-001,-001,-001,-001,-001,-001,-001],
	[-001,-001,-001,-001,-001,-001,-001,-001,-001,-001,-001,-001,-001,-001,-001,-001,-001,-001,-001,-001,-001,-001,-001,-001,-001],
	[-001,-001,-001,-001,-001,-001,-001,-001,-001,-001,-001,-001,-001,-001,-001,-001,-001,-001,-001,-001,-001,-001,-001,-001,-001]
	],
	"events": [
	{
		"id": 11,
		"nom": "EV011",
		"x": 12,
		"y": 17,
		"pages": [
		{
			"conditions": [
			{
				"nom": "ArriveeAuContact"
			}
			],
			"commandes": [
			{
				"nom": "ChangerDeMap",
				"variable": false,
				"numeroNouvelleMap": 176,
				"xDebutHeros": 3,
				"yDebutHeros": 12
			}
			],
			"vitesse": "moderee",
			"frequence": "basse",
			"animeEnMouvement": true,
			"animeALArret": false,
			"directionFixe": false,
			"traversable": false,
			"auDessusDeTout": false
		}
		]
	},
	{
		"id": 12,
		"nom": "EV012",
		"x": 21,
		"y": 8,
		"pages": [
		{
			"conditions": [
			],
			"commandes": [
			{
				"nom": "EffacerImage",
				"numero": 3
			},
			{
				"nom": "SupprimerEvent"
			}
			],
			"vitesse": "moderee",
			"frequence": "basse",
			"animeEnMouvement": true,
			"animeALArret": false,
			"directionFixe": false,
			"traversable": false,
			"auDessusDeTout": false
		}
		]
	},
	{
		"id": 1,
		"nom": "Receptacle",
		"x": 12,
		"y": 12,
		"pages": [
		{
			"conditions": [
			{
				"nom": "Parler"
			}
			],
			"commandes": [
			{
				"nom": "ModifierInterrupteur",
				"numeroInterrupteur": 12,
				"valeur": true
			},
			{
				"nom": "Commentaire",
				"texte": "(en) It's a receptacle."
			},
			{
				"nom": "Message",
				"texte": "C'est un réceptacle."
			},
			{
				"nom": "ConditionEtatQuete",
				"idQuete": 110,
				"etat": "CONNUE",
				"numero": 0
			},
			{
				"nom": "ConditionSinon",
				"numero": 0
			},
			{
				"nom": "ConditionEtatQuete",
				"idQuete": 110,
				"etat": "FAITE",
				"numero": 1
			},
			{
				"nom": "ConditionSinon",
				"numero": 1
			},
			{
				"nom": "ModifierAvancementQuete",
				"numero": 111,
				"avancement": "CONNUE"
			},
			{
				"nom": "ConditionFin",
				"numero": 1
			},
			{
				"nom": "ConditionFin",
				"numero": 0
			},
			{
				"nom": "ConditionObjetPossede",
				"idObjet": 55,
				"numero": 2
			},
			{
				"nom": "RetirerObjet",
				"idObjet": 55,
				"variable": false,
				"quantite": 1
			},
			{
				"nom": "ModifierVariable",
				"numeroVariable": 86,
				"operationAFaire": "rendre egal a",
				"valeurADonner": 1,
				"operationAFaire2": "valeur brute"
			},
			{
				"nom": "Commentaire",
				"texte": "(en) You put the crab stained glass\\nin the receptacle."
			},
			{
				"nom": "Message",
				"texte": "Vous déposez le vitrail crabe \\ndans le réceptacle."
			},
			{
				"nom": "ConditionSinon",
				"numero": 2
			},
			{
				"nom": "Commentaire",
				"texte": "(en) You can put a stained glass window on it."
			},
			{
				"nom": "Message",
				"texte": "On peut y déposer un vitrail."
			},
			{
				"nom": "ConditionFin",
				"numero": 2
			},
			{
				"nom": "Attendre",
				"nombreDeFrames": 8
			},
			{
				"nom": "ModifierInterrupteur",
				"numeroInterrupteur": 12,
				"valeur": false
			}
			],
			"image": "socle vitrail character",
			"vitesse": "moderee",
			"frequence": "basse",
			"animeEnMouvement": false,
			"animeALArret": false,
			"directionFixe": true,
			"traversable": false,
			"auDessusDeTout": false
		},
		{
			"conditions": [
			{
				"nom": "Parler"
			},
			{
				"nom": "Variable",
				"numeroVariable": 86,
				"inegalite": ">=",
				"valeurQuIlEstCenseAvoir": 1
			}
			],
			"commandes": [
			{
				"nom": "ModifierInterrupteur",
				"numeroInterrupteur": 12,
				"valeur": true
			},
			{
				"nom": "Commentaire",
				"texte": "(en) You have placed the Crab stained\\nglass on the receptacle."
			},
			{
				"nom": "Message",
				"texte": "Vous avez posé le vitrail crabe\\ndans le réceptacle."
			},
			{
				"nom": "Attendre",
				"nombreDeFrames": 8
			},
			{
				"nom": "ModifierInterrupteur",
				"numeroInterrupteur": 12,
				"valeur": false
			}
			],
			"image": "socle vitrail character",
			"directionInitiale": 2,
			"vitesse": "moderee",
			"frequence": "basse",
			"animeEnMouvement": false,
			"animeALArret": false,
			"directionFixe": true,
			"traversable": false,
			"auDessusDeTout": false
		}
		]
	},
	{
		"id": 13,
		"nom": "lumiere",
		"x": 12,
		"y": 13,
		"pages": [
		{
			"conditions": [
			{
				"nom": "Parler"
			}
			],
			"commandes": [
			],
			"image": "lumiere cone character",
			"opacite": 100,
			"modeDeFusion": "addition",
			"vitesse": "moderee",
			"frequence": "basse",
			"animeEnMouvement": false,
			"animeALArret": false,
			"directionFixe": true,
			"traversable": true,
			"auDessusDeTout": false
		}
		]
	},
	{
		"id": 10,
		"nom": "EV010",
		"x": 12,
		"y": 8,
		"pages": [
		{
			"conditions": [
			{
				"nom": "ArriveeAuContact"
			}
			],
			"commandes": [
			{
				"nom": "ConditionTouche",
				"touche": "BAS",
				"numero": 0
			},
			{
				"nom": "ChangerDeMap",
				"variable": false,
				"numeroNouvelleMap": 250,
				"xDebutHeros": 12,
				"yDebutHeros": 8
			},
			{
				"nom": "ConditionFin",
				"numero": 0
			}
			],
			"vitesse": "moderee",
			"frequence": "basse",
			"animeEnMouvement": true,
			"animeALArret": false,
			"directionFixe": false,
			"traversable": false,
			"auDessusDeTout": false
		}
		]
	}
	]
}
