{
	"nom": "Arbre Intérieur",
	"tileset": "Arbre Intérieur",
	"largeur": 25,
	"hauteur": 20,
	"bgm": "",
	"bgs": "",
	"couche0": [
	[0000,0000,0000,0000,0000,0000,0000,0000,0000,0000,0000,0000,0000,0000,0000,0000,0000,0000,0000,0000,0000,0000,0000,0000,0000],
	[0000,0000,0000,0000,0000,0000,0000,0000,0000,0000,0000,0000,0000,0000,0000,0000,0000,0000,0000,0000,0000,0000,0000,0000,0000],
	[0000,0000,0000,0000,0000,0000,0000,0000,0000,0000,0000,0000,0000,0000,0000,0000,0000,0000,0000,0000,0000,0000,0000,0000,0000],
	[0000,0000,0000,0000,0000,0000,0000,0000,0000,0000,0000,0000,0000,0000,0000,0000,0000,0000,0000,0000,0000,0000,0000,0000,0000],
	[0000,0000,0000,0000,0000,0000,0000,0001,0002,0003,0004,0005,0006,0007,0088,0089,0090,0000,0000,0000,0000,0000,0000,0000,0000],
	[0000,0000,0000,0000,0000,0000,0008,0009,0010,0011,0012,0013,0014,0015,0096,0097,0098,0000,0000,0000,0000,0000,0000,0000,0000],
	[0000,0000,0000,0000,0000,0000,0016,0017,0018,0019,0020,0021,0022,0023,0104,0105,0106,0000,0000,0000,0000,0000,0000,0000,0000],
	[0000,0000,0000,0000,0000,0000,0024,0025,0026,0027,0028,0029,0030,0031,0112,0113,0114,0000,0000,0000,0000,0000,0000,0000,0000],
	[0000,0000,0000,0000,0000,0000,0032,0033,0034,0035,0036,0037,0038,0039,0120,0121,0122,0000,0000,0000,0000,0000,0000,0000,0000],
	[0000,0000,0000,0000,0000,0000,0040,0041,0042,0043,0044,0045,0046,0047,0128,0129,0130,0000,0000,0000,0000,0000,0000,0000,0000],
	[0000,0000,0000,0000,0000,0000,0048,0049,0050,0051,0052,0053,0054,0055,0136,0137,0138,0000,0000,0000,0000,0000,0000,0000,0000],
	[0000,0000,0000,0000,0000,0000,0056,0057,0058,0059,0060,0061,0062,0063,0144,0145,0146,0000,0000,0000,0000,0000,0000,0000,0000],
	[0000,0000,0000,0000,0000,0000,0064,0065,0066,0067,0068,0069,0070,0071,0152,0153,0154,0000,0000,0000,0000,0000,0000,0000,0000],
	[0000,0000,0000,0000,0000,0000,0072,0073,0074,0075,0076,0077,0078,0079,0160,0161,0162,0000,0000,0000,0000,0000,0000,0000,0000],
	[0000,0000,0000,0000,0000,0000,0080,0081,0082,0083,0084,0085,0086,0087,0168,0169,0170,0000,0000,0000,0000,0000,0000,0000,0000],
	[0000,0000,0000,0000,0000,0000,0000,0000,0000,0000,0000,0000,0000,0000,0000,0000,0000,0000,0000,0000,0000,0000,0000,0000,0000],
	[0000,0000,0000,0000,0000,0000,0000,0000,0000,0000,0000,0000,0000,0000,0000,0000,0000,0000,0000,0000,0000,0000,0000,0000,0000],
	[0000,0000,0000,0000,0000,0000,0000,0000,0000,0000,0000,0000,0000,0000,0000,0000,0000,0000,0000,0000,0000,0000,0000,0000,0000],
	[0000,0000,0000,0000,0000,0000,0000,0000,0000,0000,0000,0000,0000,0000,0000,0000,0000,0000,0000,0000,0000,0000,0000,0000,0000],
	[0000,0000,0000,0000,0000,0000,0000,0000,0000,0000,0000,0000,0000,0000,0000,0000,0000,0000,0000,0000,0000,0000,0000,0000,0000]
	],
	"couche1": [
	[-001,-001,-001,-001,-001,-001,-001,-001,-001,-001,-001,-001,-001,-001,-001,-001,-001,-001,-001,-001,-001,-001,-001,-001,-001],
	[-001,-001,-001,-001,-001,-001,-001,-001,-001,-001,-001,-001,-001,-001,-001,-001,-001,-001,-001,-001,-001,-001,-001,-001,-001],
	[-001,-001,-001,-001,-001,-001,-001,-001,-001,-001,-001,-001,-001,-001,-001,-001,-001,-001,-001,-001,-001,-001,-001,-001,-001],
	[-001,-001,-001,-001,-001,-001,-001,-001,-001,-001,-001,-001,-001,-001,-001,-001,-001,-001,-001,-001,-001,-001,-001,-001,-001],
	[-001,-001,-001,-001,-001,-001,0091,0092,0093,0094,0095,0176,0177,0178,0179,0180,0181,-001,-001,-001,-001,-001,-001,-001,-001],
	[-001,-001,-001,-001,-001,-001,0099,0100,0101,0102,0103,0184,0185,0186,0187,0188,0189,-001,-001,-001,-001,-001,-001,-001,-001],
	[-001,-001,-001,-001,-001,-001,0107,0108,0109,0110,0111,0192,0193,0194,0195,0196,0197,-001,-001,-001,-001,-001,-001,-001,-001],
	[-001,-001,-001,-001,-001,-001,0115,0116,0117,0118,0119,0200,0201,0202,0203,0204,0205,-001,-001,-001,-001,-001,-001,-001,-001],
	[-001,-001,-001,-001,-001,-001,0123,0124,0125,0126,0127,0208,0209,0210,0211,0212,0213,-001,-001,-001,-001,-001,-001,-001,-001],
	[-001,-001,-001,-001,-001,-001,0131,0132,0133,0134,0135,0216,0217,0218,0219,0220,0221,-001,-001,-001,-001,-001,-001,-001,-001],
	[-001,-001,-001,-001,-001,-001,0139,0140,0141,0142,0143,0224,0225,0226,0227,0228,0229,-001,-001,-001,-001,-001,-001,-001,-001],
	[-001,-001,-001,-001,-001,-001,0147,0148,0149,0150,0151,0232,0233,0234,0235,0236,0237,-001,-001,-001,-001,-001,-001,-001,-001],
	[-001,-001,-001,-001,-001,-001,0155,0156,0157,0158,0159,0240,0241,0242,0243,0244,0245,-001,-001,-001,-001,-001,-001,-001,-001],
	[-001,-001,-001,-001,-001,-001,0163,0164,0165,0166,0167,0248,0249,0250,0251,0252,0253,-001,-001,-001,-001,-001,-001,-001,-001],
	[-001,-001,-001,-001,-001,-001,0171,0172,0173,0174,0175,0256,0257,0258,0259,0260,0261,-001,-001,-001,-001,-001,-001,-001,-001],
	[-001,-001,-001,-001,-001,-001,-001,-001,-001,-001,-001,-001,-001,-001,-001,-001,-001,-001,-001,-001,-001,-001,-001,-001,-001],
	[-001,-001,-001,-001,-001,-001,-001,-001,-001,-001,-001,-001,-001,-001,-001,-001,-001,-001,-001,-001,-001,-001,-001,-001,-001],
	[-001,-001,-001,-001,-001,-001,-001,-001,-001,-001,-001,-001,-001,-001,-001,-001,-001,-001,-001,-001,-001,-001,-001,-001,-001],
	[-001,-001,-001,-001,-001,-001,-001,-001,-001,-001,-001,-001,-001,-001,-001,-001,-001,-001,-001,-001,-001,-001,-001,-001,-001],
	[-001,-001,-001,-001,-001,-001,-001,-001,-001,-001,-001,-001,-001,-001,-001,-001,-001,-001,-001,-001,-001,-001,-001,-001,-001]
	],
	"couche2": [
	[-001,-001,-001,-001,-001,-001,-001,-001,-001,-001,-001,-001,-001,-001,-001,-001,-001,-001,-001,-001,-001,-001,-001,-001,-001],
	[-001,-001,-001,-001,-001,-001,-001,-001,-001,-001,-001,-001,-001,-001,-001,-001,-001,-001,-001,-001,-001,-001,-001,-001,-001],
	[-001,-001,-001,-001,-001,-001,-001,-001,-001,-001,-001,-001,-001,-001,-001,-001,-001,-001,-001,-001,-001,-001,-001,-001,-001],
	[-001,-001,-001,-001,-001,-001,-001,-001,-001,-001,-001,-001,-001,-001,-001,-001,-001,-001,-001,-001,-001,-001,-001,-001,-001],
	[-001,-001,-001,-001,-001,-001,-001,-001,-001,-001,-001,-001,-001,-001,-001,-001,-001,-001,-001,-001,-001,-001,-001,-001,-001],
	[-001,-001,-001,-001,-001,-001,-001,-001,-001,-001,-001,-001,-001,-001,-001,-001,-001,-001,-001,-001,-001,-001,-001,-001,-001],
	[-001,-001,-001,-001,-001,-001,-001,-001,-001,-001,-001,-001,-001,-001,-001,-001,-001,-001,-001,-001,-001,-001,-001,-001,-001],
	[-001,-001,-001,-001,-001,-001,0672,0673,0674,0675,0676,0677,0678,0679,-001,-001,-001,-001,-001,-001,-001,-001,-001,-001,-001],
	[-001,-001,-001,-001,-001,-001,0680,0681,0682,0683,0684,0685,0686,0687,-001,-001,-001,-001,-001,-001,-001,-001,-001,-001,-001],
	[-001,-001,-001,-001,-001,-001,0688,0689,0690,0691,0692,0693,0694,0695,-001,-001,-001,-001,-001,-001,-001,-001,-001,-001,-001],
	[-001,-001,-001,-001,-001,-001,0696,0697,0698,0699,0700,0701,0702,0703,-001,-001,-001,-001,-001,-001,-001,-001,-001,-001,-001],
	[-001,-001,-001,-001,-001,-001,0704,0705,0706,0707,0708,0709,0710,0711,-001,-001,-001,-001,-001,-001,-001,-001,-001,-001,-001],
	[-001,-001,-001,-001,-001,-001,0712,0713,0714,0715,0716,0717,0718,0719,-001,-001,-001,-001,-001,-001,-001,-001,-001,-001,-001],
	[-001,-001,-001,-001,-001,-001,-001,-001,-001,-001,-001,-001,-001,-001,-001,-001,-001,-001,-001,-001,-001,-001,-001,-001,-001],
	[-001,-001,-001,-001,-001,-001,-001,-001,-001,-001,-001,-001,-001,-001,-001,-001,-001,-001,-001,-001,-001,-001,-001,-001,-001],
	[-001,-001,-001,-001,-001,-001,-001,-001,-001,-001,-001,-001,-001,-001,-001,-001,-001,-001,-001,-001,-001,-001,-001,-001,-001],
	[-001,-001,-001,-001,-001,-001,-001,-001,-001,-001,-001,-001,-001,-001,-001,-001,-001,-001,-001,-001,-001,-001,-001,-001,-001],
	[-001,-001,-001,-001,-001,-001,-001,-001,-001,-001,-001,-001,-001,-001,-001,-001,-001,-001,-001,-001,-001,-001,-001,-001,-001],
	[-001,-001,-001,-001,-001,-001,-001,-001,-001,-001,-001,-001,-001,-001,-001,-001,-001,-001,-001,-001,-001,-001,-001,-001,-001],
	[-001,-001,-001,-001,-001,-001,-001,-001,-001,-001,-001,-001,-001,-001,-001,-001,-001,-001,-001,-001,-001,-001,-001,-001,-001]
	],
	"events": [
	{
		"id": 1,
		"nom": "Clone[341][008]",
		"x": 11,
		"y": 11
	},
	{
		"id": 2,
		"nom": "Réglages initiaux",
		"x": 18,
		"y": 5,
		"pages": [
		{
			"conditions": [
			],
			"commandes": [
			{
				"nom": "EffacerImage",
				"numero": 9
			},
			{
				"nom": "ConditionInterrupteur",
				"numeroInterrupteur": 1,
				"valeurQuIlEstCenseAvoir": false,
				"numero": 0
			},
			{
				"nom": "ModifierVariable",
				"numeroVariable": 5,
				"operationAFaire": "rendre egal a",
				"valeurADonner": "24",
				"operationAFaire2": "valeur brute"
			},
			{
				"nom": "ModifierVariable",
				"numeroVariable": 4,
				"operationAFaire": "rendre egal a",
				"valeurADonner": "24",
				"operationAFaire2": "valeur brute"
			},
			{
				"nom": "AjouterArme",
				"idArme": 1
			},
			{
				"nom": "AjouterArme",
				"idArme": 2
			},
			{
				"nom": "AjouterArme",
				"idArme": 5
			},
			{
				"nom": "AjouterArme",
				"idArme": 6
			},
			{
				"nom": "ModifierInterrupteur",
				"numeroInterrupteur": 1,
				"valeur": true
			},
			{
				"nom": "AjouterObjet",
				"idObjet": 1,
				"variable": false,
				"quantite": 1
			},
			{
				"nom": "AjouterObjet",
				"idObjet": 3,
				"variable": false,
				"quantite": 1
			},
			{
				"nom": "AjouterObjet",
				"idObjet": 4,
				"variable": false,
				"quantite": 1
			},
			{
				"nom": "AjouterObjet",
				"idObjet": 5,
				"variable": false,
				"quantite": 1
			},
			{
				"nom": "AjouterArme",
				"idArme": 3
			},
			{
				"nom": "AjouterArme",
				"idArme": 4
			},
			{
				"nom": "AjouterGadget",
				"idGadget": 2
			},
			{
				"nom": "AjouterObjet",
				"idObjet": 31,
				"variable": false,
				"quantite": 20
			},
			{
				"nom": "AjouterObjet",
				"idObjet": 32,
				"variable": false,
				"quantite": 1
			},
			{
				"nom": "AjouterGadget",
				"idGadget": 1
			},
			{
				"nom": "AjouterObjet",
				"idObjet": 6,
				"variable": false,
				"quantite": 1
			},
			{
				"nom": "ConditionSinon",
				"numero": 0
			},
			{
				"nom": "ConditionFin",
				"numero": 0
			},
			{
				"nom": "Deplacement",
				"idEventADeplacer": 0,
				"ignorerLesMouvementsImpossibles": false,
				"repeterLeDeplacement": false,
				"attendreLaFinDuDeplacement": false,
				"mouvements": [
				{
					"nom": "ModifierApparence",
					"image": "Jiyounasu character",
					"direction": 0,
					"animation": 0,
					"teinte": 0
				},
				{
					"nom": "Attendre",
					"nombreDeFrames": 8
				},
				{
					"nom": "ModifierApparence",
					"image": "Jiyounasu character",
					"direction": 0,
					"animation": 0,
					"teinte": 0
				},
				{
					"nom": "RendreDirectionFixe",
					"directionFixe": false
				}
				]
			},
			{
				"nom": "EffacerImage",
				"numero": 3
			},
			{
				"nom": "SupprimerEvent"
			}
			],
			"directionInitiale": 2,
			"vitesse": 0,
			"frequence": 0,
			"animeEnMouvement": false,
			"animeALArret": false,
			"directionFixe": false,
			"traversable": false,
			"auDessusDeTout": false
		}
		]
	},
	{
		"id": 3,
		"nom": "Clone[341][035]",
		"x": 14,
		"y": 11
	},
	{
		"id": 4,
		"nom": "Clone[341][036]",
		"x": 8,
		"y": 13
	}
	]
}
