{
	"nom": "Echelle pour remonter",
	"tileset": "Intestins",
	"largeur": 30,
	"hauteur": 40,
	"musique": {
		"nomFichierSonore": "Intestins.ogg",
		"volume": 0.50,
		"tempo": 0.75
	},
	"fondSonore": {
		"nomFichierSonore": "016-Drips01.ogg",
		"volume": 0.50,
		"tempo": 1.00
	},
	"couche0": [
	[0009,0011,0011,0011,0011,0011,0011,0011,0011,0011,0011,0011,0011,0011,0011,0011,0011,0011,0011,0011,0011,0011,0011,0011,0011,0011,0022,0038,0021,0011],
	[0032,0009,0011,0011,0011,0011,0011,0011,0011,0011,0011,0011,0011,0011,0011,0011,0011,0011,0011,0011,0011,0011,0011,0011,0011,0022,0038,0021,0011,0011],
	[0017,0032,0009,0011,0011,0011,0011,0011,0011,0011,0011,0011,0011,0011,0011,0011,0011,0011,0011,0011,0011,0011,0011,0011,0022,0038,0021,0011,0011,0011],
	[0011,0017,0032,0009,0011,0011,0011,0011,0011,0011,0011,0011,0011,0011,0011,0011,0011,0011,0011,0011,0011,0011,0011,0022,0038,0021,0011,0011,0011,0011],
	[0011,0011,0017,0032,0009,0011,0011,0011,0011,0011,0011,0011,0011,0011,0011,0011,0011,0011,0011,0011,0011,0011,0022,0038,0021,0011,0011,0011,0011,0011],
	[0011,0011,0011,0017,0032,0009,0011,0011,0011,0011,0011,0011,0011,0011,0011,0011,0011,0011,0011,0011,0011,0022,0038,0021,0011,0011,0011,0011,0011,0011],
	[0011,0011,0011,0011,0017,0032,0009,0011,0011,0011,0011,0011,0011,0011,0011,0011,0011,0011,0011,0011,0022,0038,0021,0011,0011,0011,0011,0011,0011,0011],
	[0011,0011,0011,0011,0011,0017,0032,0009,0011,0011,0011,0011,0011,0011,0011,0011,0011,0011,0011,0022,0038,0021,0011,0011,0011,0011,0011,0011,0011,0011],
	[0011,0011,0011,0011,0011,0011,0017,0032,0009,0011,0011,0011,0011,0011,0011,0011,0011,0011,0022,0038,0021,0011,0011,0011,0011,0011,0011,0011,0011,0011],
	[0011,0011,0011,0011,0011,0011,0011,0017,0032,0009,0011,0011,0011,0011,0011,0011,0011,0022,0038,0021,0011,0011,0011,0011,0011,0011,0011,0011,0011,0011],
	[0011,0011,0011,0011,0011,0011,0011,0011,0017,0032,0009,0011,0011,0011,0011,0011,0022,0038,0021,0011,0011,0011,0011,0011,0011,0011,0011,0011,0011,0011],
	[0011,0011,0011,0011,0011,0011,0011,0011,0011,0017,0032,0009,0011,0003,0011,0022,0038,0021,0011,0011,0011,0011,0011,0011,0011,0011,0011,0011,0011,0011],
	[0011,0011,0011,0011,0011,0011,0011,0011,0011,0011,0017,0032,0001,0001,0001,0038,0021,0011,0011,0011,0011,0011,0011,0011,0011,0011,0011,0011,0011,0011],
	[0011,0011,0011,0011,0011,0011,0011,0011,0011,0011,0011,0017,0001,0001,0001,0021,0011,0011,0011,0011,0011,0011,0011,0011,0011,0011,0011,0011,0011,0011],
	[0011,0011,0011,0011,0011,0011,0011,0011,0011,0011,0011,0011,0011,0011,0011,0011,0011,0011,0011,0011,0011,0011,0011,0011,0011,0011,0011,0011,0011,0011],
	[0011,0011,0011,0011,0011,0011,0011,0011,0011,0011,0011,0011,0011,0011,0011,0011,0011,0011,0011,0011,0011,0011,0011,0011,0011,0011,0011,0011,0011,0011],
	[0011,0011,0011,0011,0011,0011,0011,0011,0011,0011,0011,0011,0011,0011,0011,0011,0011,0011,0011,0011,0011,0011,0011,0011,0011,0011,0011,0011,0011,0022],
	[0011,0011,0011,0011,0011,0011,0011,0011,0011,0011,0011,0011,0011,0011,0011,0011,0011,0011,0011,0011,0011,0011,0011,0011,0011,0011,0011,0011,0022,0038],
	[0011,0011,0011,0011,0011,0011,0011,0011,0011,0011,0011,0011,0011,0011,0011,0011,0011,0011,0011,0011,0011,0011,0011,0011,0011,0011,0011,0022,0038,0038],
	[0009,0011,0011,0011,0011,0011,0011,0011,0011,0011,0011,0011,0011,0011,0011,0011,0011,0011,0011,0011,0011,0011,0011,0011,0011,0011,0022,0038,0038,0038],
	[0032,0009,0011,0011,0011,0011,0011,0011,0011,0011,0011,0011,0011,0011,0011,0011,0011,0011,0011,0011,0011,0011,0011,0011,0011,0022,0038,0038,0038,0038],
	[0032,0032,0009,0011,0011,0011,0011,0011,0011,0011,0011,0011,0011,0011,0011,0011,0011,0011,0011,0011,0011,0011,0011,0011,0022,0038,0038,0038,0038,0038],
	[0032,0032,0032,0009,0011,0011,0011,0011,0011,0011,0011,0011,0011,0011,0011,0011,0011,0011,0011,0011,0011,0011,0011,0022,0038,0038,0038,0038,0038,0038],
	[0032,0032,0032,0032,0009,0011,0011,0011,0011,0011,0011,0011,0011,0011,0011,0011,0011,0011,0011,0011,0011,0011,0022,0038,0038,0038,0038,0038,0038,0038],
	[0032,0032,0032,0032,0032,0009,0011,0011,0011,0011,0011,0011,0011,0011,0011,0011,0011,0011,0011,0011,0011,0022,0038,0038,0038,0038,0038,0038,0038,0038],
	[0032,0032,0032,0032,0032,0032,0009,0011,0011,0011,0011,0011,0011,0011,0011,0011,0011,0011,0011,0011,0022,0038,0038,0038,0038,0038,0038,0038,0038,0038],
	[0032,0032,0032,0032,0032,0032,0032,0009,0011,0011,0011,0011,0011,0011,0011,0011,0011,0011,0011,0022,0038,0038,0038,0038,0038,0038,0038,0038,0038,0038],
	[0032,0032,0032,0032,0032,0032,0032,0032,0009,0011,0011,0011,0011,0011,0011,0011,0011,0011,0022,0038,0038,0038,0038,0038,0038,0038,0038,0038,0038,0038],
	[0032,0032,0032,0032,0032,0032,0032,0032,0032,0009,0011,0011,0011,0011,0011,0011,0011,0022,0038,0038,0038,0038,0038,0038,0038,0038,0038,0038,0038,0038],
	[0032,0032,0032,0032,0032,0032,0032,0032,0032,0032,0009,0011,0011,0011,0011,0011,0022,0038,0038,0038,0038,0038,0038,0038,0038,0038,0038,0038,0038,0038],
	[0032,0032,0032,0032,0032,0032,0032,0032,0032,0032,0032,0008,-007,-008,-007,0000,0038,0038,0038,0038,0038,0038,0038,0038,0038,0038,0038,0038,0038,0038],
	[0032,0032,0032,0032,0032,0032,0032,0032,0032,0032,0032,0000,-007,-007,-007,0000,0037,0038,0038,0038,0038,0038,0038,0038,0038,0038,0038,0038,0038,0038],
	[0032,0032,0032,0032,0032,0032,0032,0032,0032,0032,0032,0000,0000,0000,0000,0000,0038,0038,0038,0038,0038,0038,0038,0038,0038,0038,0038,0038,0038,0038],
	[0032,0032,0032,0032,0032,0032,0032,0032,0032,0032,0057,0059,0059,0059,0059,0059,0061,0038,0038,0038,0038,0038,0038,0038,0038,0038,0038,0038,0038,0038],
	[0032,0032,0032,0032,0032,0032,0032,0032,0032,0057,0059,0059,0059,0059,0059,0059,0059,0061,0038,0038,0038,0038,0038,0038,0038,0038,0038,0038,0038,0038],
	[0032,0032,0032,0032,0032,0032,0032,0032,0057,0059,0059,0059,0059,0059,0059,0059,0059,0059,0061,0038,0038,0038,0038,0038,0038,0038,0038,0038,0038,0038],
	[0032,0032,0032,0032,0032,0032,0032,0057,0059,0059,0059,0059,0059,0059,0059,0059,0059,0059,0059,0061,0038,0038,0038,0038,0038,0038,0038,0038,0038,0038],
	[0032,0032,0032,0032,0032,0032,0057,0059,0059,0059,0059,0059,0059,0059,0059,0059,0059,0059,0059,0059,0061,0038,0038,0038,0038,0038,0038,0038,0038,0038],
	[0032,0032,0032,0032,0032,0057,0059,0059,0059,0059,0059,0059,0059,0059,0059,0059,0059,0059,0059,0059,0059,0061,0038,0038,0038,0038,0038,0038,0038,0038],
	[0032,0032,0032,0032,0057,0059,0059,0059,0059,0059,0059,0059,0059,0059,0059,0059,0059,0059,0059,0059,0059,0059,0061,0038,0038,0038,0038,0038,0038,0038]
	],
	"couche1": [
	[-001,-001,-001,-001,-001,-001,-001,-001,-001,-001,-001,-001,-001,-001,-001,-001,-001,-001,-001,-001,-001,-001,-001,-001,-001,-001,-001,-001,-001,-001],
	[-001,-001,-001,-001,-001,-001,-001,-001,-001,-001,-001,-001,-001,-001,-001,-001,-001,-001,-001,-001,-001,-001,-001,-001,-001,-001,-001,-001,-001,-001],
	[-001,-001,-001,-001,-001,-001,-001,-001,-001,-001,-001,-001,-001,-001,-001,-001,-001,-001,-001,-001,-001,-001,-001,-001,-001,-001,-001,-001,-001,-001],
	[-001,-001,-001,-001,-001,-001,-001,-001,-001,-001,-001,-001,-001,-001,-001,-001,-001,-001,-001,-001,-001,-001,-001,-001,-001,-001,-001,-001,-001,-001],
	[-001,-001,-001,-001,-001,-001,-001,-001,-001,-001,-001,-001,-001,-001,-001,-001,-001,-001,-001,-001,-001,-001,-001,-001,-001,-001,-001,-001,-001,-001],
	[-001,-001,-001,-001,-001,-001,-001,-001,-001,-001,-001,-001,-001,-001,-001,-001,-001,-001,-001,-001,-001,-001,-001,-001,-001,-001,-001,-001,-001,-001],
	[-001,-001,-001,-001,-001,-001,-001,-001,-001,-001,-001,-001,-001,-001,-001,-001,-001,-001,-001,-001,-001,-001,-001,-001,-001,-001,-001,-001,-001,-001],
	[-001,-001,-001,-001,-001,-001,-001,-001,-001,-001,-001,-001,-001,-001,-001,-001,-001,-001,-001,-001,-001,-001,-001,-001,-001,-001,-001,-001,-001,-001],
	[-001,-001,-001,-001,-001,-001,-001,-001,-001,-001,-001,-001,-001,-001,-001,-001,-001,-001,-001,-001,-001,-001,-001,-001,-001,-001,-001,-001,-001,-001],
	[-001,-001,-001,-001,-001,-001,-001,-001,-001,0133,0134,0135,-001,-001,-001,-001,-001,-001,-001,-001,-001,-001,-001,-001,-001,-001,-001,-001,-001,-001],
	[-001,-001,-001,-001,-001,-001,-001,-001,-001,0141,0142,0143,-001,0036,-001,-001,-001,-001,-001,-001,-001,-001,-001,-001,-001,-001,-001,-001,-001,-001],
	[-001,-001,-001,-001,-001,-001,-001,-001,-001,-001,-001,-001,-001,0004,-001,-001,0127,-001,-001,-001,-001,-001,-001,-001,-001,-001,-001,-001,-001,-001],
	[-001,-001,-001,-001,-001,-001,-001,-001,-001,-001,-001,-001,-001,-001,-001,-001,-001,-001,-001,-001,-001,-001,-001,-001,-001,-001,-001,-001,-001,-001],
	[-001,-001,-001,-001,-001,-001,-001,-001,-001,-001,-001,-001,-001,-001,-001,-001,-001,-001,-001,-001,-001,-001,-001,-001,-001,-001,-001,-001,-001,-001],
	[-001,-001,-001,-001,-001,-001,-001,-001,-001,-001,-001,-001,-001,-005,-001,-001,-001,-001,-001,-001,-001,-001,-001,-001,-001,-001,-001,-001,-001,-001],
	[-001,-001,-001,-001,-001,-001,-001,-001,-001,-001,-001,-001,-001,-005,-001,-001,-001,-001,-001,-001,-001,-001,-001,-001,-001,-001,-001,-001,-001,-001],
	[-001,-001,-001,-001,-001,-001,-001,-001,-001,-001,-001,-001,-001,-005,-001,-001,-001,-001,-001,-001,-001,-001,-001,-001,-001,-001,-001,-001,-001,-001],
	[-001,-001,-001,-001,-001,-001,-001,-001,-001,-001,-001,-001,-001,-005,-001,-001,-001,-001,-001,-001,-001,-001,-001,-001,-001,-001,-001,-001,-001,-001],
	[-001,-001,-001,-001,-001,-001,-001,-001,-001,-001,-001,-001,-001,-005,-001,-001,-001,-001,-001,-001,-001,-001,-001,-001,-001,-001,-001,-001,-001,-001],
	[-001,-001,-001,-001,-001,-001,-001,-001,-001,-001,-001,-001,-001,-005,-001,-001,-001,-001,-001,-001,-001,-001,-001,-001,-001,-001,-001,-001,-001,-001],
	[-001,-001,-001,-001,-001,-001,-001,-001,-001,-001,-001,-001,-001,-005,-001,-001,-001,-001,-001,-001,-001,-001,-001,-001,-001,-001,-001,-001,-001,-001],
	[-001,-001,-001,-001,-001,-001,-001,-001,-001,-001,-001,-001,-001,-005,-001,-001,-001,-001,-001,-001,-001,-001,-001,-001,-001,-001,-001,-001,-001,-001],
	[-001,-001,-001,-001,-001,-001,-001,-001,-001,-001,-001,-001,-001,-005,-001,-001,-001,-001,-001,-001,-001,-001,-001,-001,-001,-001,-001,-001,-001,-001],
	[-001,-001,-001,-001,-001,-001,-001,-001,-001,-001,-001,-001,-001,-005,-001,-001,-001,-001,-001,-001,-001,-001,-001,-001,-001,-001,-001,-001,-001,-001],
	[-001,-001,-001,-001,-001,-001,-001,-001,-001,-001,-001,-001,-001,-005,-001,-001,-001,-001,-001,-001,-001,-001,-001,-001,-001,-001,-001,-001,-001,-001],
	[-001,-001,-001,-001,-001,-001,-001,-001,-001,-001,-001,-001,-001,-005,-001,-001,-001,-001,-001,-001,-001,-001,-001,-001,-001,-001,-001,-001,-001,-001],
	[-001,-001,-001,-001,-001,-001,-001,-001,-001,-001,-001,-001,-001,-005,-001,-001,-001,-001,-001,-001,-001,-001,-001,-001,-001,-001,-001,-001,-001,-001],
	[-001,-001,-001,-001,-001,-001,-001,-001,-001,-001,-001,-001,-001,-005,-001,-001,-001,-001,-001,-001,-001,-001,-001,-001,-001,-001,-001,-001,-001,-001],
	[-001,-001,-001,-001,-001,-001,-001,-001,-001,-001,-001,-001,-001,-005,-001,-001,-001,-001,-001,-001,-001,-001,-001,-001,-001,-001,-001,-001,-001,-001],
	[-001,-001,-001,-001,-001,-001,-001,-001,-001,-001,-001,-001,-001,-005,-001,-001,-001,-001,-001,-001,-001,-001,-001,-001,-001,-001,-001,-001,-001,-001],
	[-001,-001,-001,-001,-001,-001,-001,-001,-001,-001,-001,-001,-001,-001,-001,-001,0044,-001,-001,-001,-001,-001,-001,-001,-001,-001,-001,-001,-001,-001],
	[-001,-001,-001,-001,-001,-001,-001,-001,-001,-001,-001,-001,-001,-001,-001,-001,0045,-001,-001,-001,-001,-001,-001,-001,-001,-001,-001,-001,-001,-001],
	[-001,-001,-001,-001,-001,-001,-001,-001,-001,-001,-001,-001,-001,-001,-001,-001,-001,-001,-001,-001,-001,-001,-001,-001,-001,-001,-001,-001,-001,-001],
	[-001,-001,-001,-001,-001,-001,-001,-001,-001,-001,-001,-001,-001,-001,-001,-001,-001,-001,-001,-001,-001,-001,-001,-001,-001,-001,-001,-001,-001,-001],
	[-001,-001,-001,-001,-001,-001,-001,-001,-001,-001,-001,-001,-001,-001,-001,-001,-001,-001,-001,-001,-001,-001,-001,-001,-001,-001,-001,-001,-001,-001],
	[-001,-001,-001,-001,-001,-001,-001,-001,-001,-001,-001,-001,-001,-001,-001,-001,-001,-001,-001,-001,-001,-001,-001,-001,-001,-001,-001,-001,-001,-001],
	[-001,-001,-001,-001,-001,-001,-001,-001,-001,-001,-001,-001,-001,-001,-001,-001,-001,-001,-001,-001,-001,-001,-001,-001,-001,-001,-001,-001,-001,-001],
	[-001,-001,-001,-001,-001,-001,-001,-001,-001,-001,-001,-001,-001,-001,-001,-001,-001,-001,-001,-001,-001,-001,-001,-001,-001,-001,-001,-001,-001,-001],
	[-001,-001,-001,-001,-001,-001,-001,-001,-001,-001,-001,-001,-001,-001,-001,-001,-001,-001,-001,-001,-001,-001,-001,-001,-001,-001,-001,-001,-001,-001],
	[-001,-001,-001,-001,-001,-001,-001,-001,-001,-001,-001,-001,-001,-001,-001,-001,-001,-001,-001,-001,-001,-001,-001,-001,-001,-001,-001,-001,-001,-001]
	],
	"couche2": [
	[-001,-001,-001,-001,-001,-001,-001,-001,-001,-001,-001,-001,-001,-001,-001,-001,-001,-001,-001,-001,-001,-001,-001,-001,-001,-001,-001,-001,-001,-001],
	[-001,-001,-001,-001,-001,-001,-001,-001,-001,-001,-001,-001,-001,-001,-001,-001,-001,-001,-001,-001,-001,-001,-001,-001,-001,-001,-001,-001,-001,-001],
	[-001,-001,-001,-001,-001,-001,-001,-001,-001,-001,-001,-001,-001,-001,-001,-001,-001,-001,-001,-001,-001,-001,-001,-001,-001,-001,-001,-001,-001,-001],
	[-001,-001,-001,-001,-001,-001,-001,-001,-001,-001,-001,-001,-001,-001,-001,-001,-001,-001,-001,-001,-001,-001,-001,-001,-001,-001,-001,-001,-001,-001],
	[-001,-001,-001,-001,-001,-001,-001,-001,-001,-001,-001,-001,-001,-001,-001,-001,-001,-001,-001,-001,-001,-001,-001,-001,-001,-001,-001,-001,-001,-001],
	[-001,-001,-001,-001,-001,-001,-001,-001,-001,-001,-001,-001,-001,-001,-001,-001,-001,-001,-001,-001,-001,-001,-001,-001,-001,-001,-001,-001,-001,-001],
	[-001,-001,-001,-001,-001,-001,-001,-001,-001,-001,-001,-001,-001,-001,-001,-001,-001,-001,-001,-001,-001,-001,-001,-001,-001,-001,-001,-001,-001,-001],
	[-001,-001,-001,-001,-001,-001,-001,-001,-001,-001,-001,-001,-001,-001,-001,-001,-001,-001,-001,-001,-001,-001,-001,-001,-001,-001,-001,-001,-001,-001],
	[-001,-001,-001,-001,-001,-001,-001,-001,-001,-001,-001,-001,-001,-001,-001,-001,-001,-001,-001,-001,-001,-001,-001,-001,-001,-001,-001,-001,-001,-001],
	[-001,-001,-001,-001,-001,-001,-001,-001,-001,-001,-001,-001,-001,-001,-001,-001,-001,-001,-001,-001,-001,-001,-001,-001,-001,-001,-001,-001,-001,-001],
	[-001,-001,-001,-001,-001,-001,-001,-001,-001,-001,-001,-001,-001,-001,-001,-001,-001,-001,-001,-001,-001,-001,-001,-001,-001,-001,-001,-001,-001,-001],
	[-001,-001,-001,-001,-001,-001,-001,-001,-001,-001,-001,-001,-001,-001,-001,-001,-001,-001,-001,-001,-001,-001,-001,-001,-001,-001,-001,-001,-001,-001],
	[-001,-001,-001,-001,-001,-001,-001,-001,-001,-001,-001,-001,-001,-001,-001,-001,-001,-001,-001,-001,-001,-001,-001,-001,-001,-001,-001,-001,-001,-001],
	[-001,-001,-001,-001,-001,-001,-001,-001,-001,-001,-001,-001,-001,-001,-001,-001,-001,-001,-001,-001,-001,-001,-001,-001,-001,-001,-001,-001,-001,-001],
	[-001,-001,-001,-001,-001,-001,-001,-001,-001,-001,-001,-001,-001,-001,-001,-001,-001,-001,-001,-001,-001,-001,-001,-001,-001,-001,-001,-001,-001,-001],
	[-001,-001,-001,-001,-001,-001,-001,-001,-001,-001,-001,-001,-001,-001,-001,-001,-001,-001,-001,-001,-001,-001,-001,-001,-001,-001,-001,-001,-001,-001],
	[-001,-001,-001,-001,-001,-001,-001,-001,-001,-001,-001,-001,-001,-001,-001,-001,-001,-001,-001,-001,-001,-001,-001,-001,-001,-001,-001,-001,-001,-001],
	[-001,-001,-001,-001,-001,-001,-001,-001,-001,-001,-001,-001,-001,-001,-001,-001,-001,-001,-001,-001,-001,-001,-001,-001,-001,-001,-001,-001,-001,-001],
	[-001,-001,-001,-001,-001,-001,-001,-001,-001,-001,-001,-001,-001,-001,-001,-001,-001,-001,-001,-001,-001,-001,-001,-001,-001,-001,-001,-001,-001,-001],
	[-001,-001,-001,-001,-001,-001,-001,-001,-001,-001,-001,-001,-001,-001,-001,-001,-001,-001,-001,-001,-001,-001,-001,-001,-001,-001,-001,-001,-001,-001],
	[-001,-001,-001,-001,-001,-001,-001,-001,-001,-001,-001,-001,-001,-001,-001,-001,-001,-001,-001,-001,-001,-001,-001,-001,-001,-001,-001,-001,-001,-001],
	[-001,-001,-001,-001,-001,-001,-001,-001,-001,-001,-001,-001,-001,-001,-001,-001,-001,-001,-001,-001,-001,-001,-001,-001,-001,-001,-001,-001,-001,-001],
	[-001,-001,-001,-001,-001,-001,-001,-001,-001,-001,-001,-001,-001,-001,-001,-001,-001,-001,-001,-001,-001,-001,-001,-001,-001,-001,-001,-001,-001,-001],
	[-001,-001,-001,-001,-001,-001,-001,-001,-001,-001,-001,-001,-001,-001,-001,-001,-001,-001,-001,-001,-001,-001,-001,-001,-001,-001,-001,-001,-001,-001],
	[-001,-001,-001,-001,-001,-001,-001,-001,-001,-001,-001,-001,-001,-001,-001,-001,-001,-001,-001,-001,-001,-001,-001,-001,-001,-001,-001,-001,-001,-001],
	[-001,-001,-001,-001,-001,-001,-001,-001,-001,-001,-001,-001,-001,-001,-001,-001,-001,-001,-001,-001,-001,-001,-001,-001,-001,-001,-001,-001,-001,-001],
	[-001,-001,-001,-001,-001,-001,-001,-001,-001,-001,-001,-001,-001,-001,-001,-001,-001,-001,-001,-001,-001,-001,-001,-001,-001,-001,-001,-001,-001,-001],
	[-001,-001,-001,-001,-001,-001,-001,-001,-001,-001,-001,-001,-001,-001,-001,-001,-001,-001,-001,-001,-001,-001,-001,-001,-001,-001,-001,-001,-001,-001],
	[-001,-001,-001,-001,-001,-001,-001,-001,-001,-001,-001,-001,-001,-001,-001,-001,-001,-001,-001,-001,-001,-001,-001,-001,-001,-001,-001,-001,-001,-001],
	[-001,-001,-001,-001,-001,-001,-001,-001,-001,-001,-001,-001,-001,-001,0133,0134,0135,-001,-001,-001,-001,-001,-001,-001,-001,-001,-001,-001,-001,-001],
	[-001,-001,-001,-001,-001,-001,-001,-001,-001,-001,-001,-001,-001,-001,0141,0142,0143,-001,-001,-001,-001,-001,-001,-001,-001,-001,-001,-001,-001,-001],
	[-001,-001,-001,-001,-001,-001,-001,-001,-001,-001,-001,-001,-001,-001,-001,-001,-001,-001,-001,-001,-001,-001,-001,-001,-001,-001,-001,-001,-001,-001],
	[-001,-001,-001,-001,-001,-001,-001,-001,-001,-001,-001,-001,-001,-001,-001,-001,-001,-001,-001,-001,-001,-001,-001,-001,-001,-001,-001,-001,-001,-001],
	[-001,-001,-001,-001,-001,-001,-001,-001,-001,-001,-001,-001,-001,-001,-001,-001,-001,-001,-001,-001,-001,-001,-001,-001,-001,-001,-001,-001,-001,-001],
	[-001,-001,-001,-001,-001,-001,-001,-001,-001,-001,-001,-001,-001,-001,-001,-001,-001,-001,-001,-001,-001,-001,-001,-001,-001,-001,-001,-001,-001,-001],
	[-001,-001,-001,-001,-001,-001,-001,-001,-001,-001,-001,-001,-001,-001,-001,-001,-001,-001,-001,-001,-001,-001,-001,-001,-001,-001,-001,-001,-001,-001],
	[-001,-001,-001,-001,-001,-001,-001,-001,-001,-001,-001,-001,-001,-001,-001,-001,-001,-001,-001,-001,-001,-001,-001,-001,-001,-001,-001,-001,-001,-001],
	[-001,-001,-001,-001,-001,-001,-001,-001,-001,-001,-001,-001,-001,-001,-001,-001,-001,-001,-001,-001,-001,-001,-001,-001,-001,-001,-001,-001,-001,-001],
	[-001,-001,-001,-001,-001,-001,-001,-001,-001,-001,-001,-001,-001,-001,-001,-001,-001,-001,-001,-001,-001,-001,-001,-001,-001,-001,-001,-001,-001,-001],
	[-001,-001,-001,-001,-001,-001,-001,-001,-001,-001,-001,-001,-001,-001,-001,-001,-001,-001,-001,-001,-001,-001,-001,-001,-001,-001,-001,-001,-001,-001]
	],
	"events": [
	{
		"id": 1,
		"nom": "EV001",
		"x": 16,
		"y": 31,
		"pages": [
		{
			"conditions": [
			{
				"nom": "ArriveeAuContact"
			}
			],
			"commandes": [
			{
				"nom": "ChangerDeMap",
				"variable": false,
				"numeroNouvelleMap": 269,
				"xDebutHeros": 10,
				"yDebutHeros": 17
			}
			],
			"vitesse": "moderee",
			"frequence": "basse",
			"animeEnMouvement": true,
			"animeALArret": false,
			"directionFixe": false,
			"traversable": false,
			"auDessusDeTout": false
		}
		]
	},
	{
		"id": 2,
		"nom": "EV002",
		"x": 13,
		"y": 11,
		"pages": [
		{
			"conditions": [
			{
				"nom": "ArriveeAuContact"
			}
			],
			"commandes": [
			{
				"nom": "ChangerDeMap",
				"variable": false,
				"numeroNouvelleMap": 210,
				"xDebutHeros": 12,
				"yDebutHeros": 13
			}
			],
			"vitesse": "moderee",
			"frequence": "basse",
			"animeEnMouvement": true,
			"animeALArret": false,
			"directionFixe": false,
			"traversable": false,
			"auDessusDeTout": false
		}
		]
	},
	{
		"id": 3,
		"nom": "EV003",
		"x": 17,
		"y": 23,
		"pages": [
		{
			"conditions": [
			],
			"commandes": [
			{
				"nom": "ModifierBrouillard",
				"opacite": 150,
				"modeDeFusion": "addition",
				"defilementX": 0,
				"defilementY": 0,
				"zoom": 100,
				"nuance": 0,
				"nomImage": "brouillard echelle grotte"
			}
			],
			"vitesse": "moderee",
			"frequence": "basse",
			"animeEnMouvement": true,
			"animeALArret": false,
			"directionFixe": false,
			"traversable": false,
			"auDessusDeTout": false
		}
		]
	},
	{
		"id": 4,
		"nom": "Clone[341][155]",
		"x": 11,
		"y": 31
	}
	]
}
