{
	"nom": "Enigme du Pissenlit",
	"tileset": "Zone Enneigée",
	"largeur": 30,
	"hauteur": 30,
	"musique": {
		"nomFichierSonore": "",
		"volume": 1.00,
		"tempo": 1.00
	},
	"fondSonore": {
		"nomFichierSonore": "002-Wind02.ogg",
		"volume": 1.00,
		"tempo": 1.50
	},
	"couche0": [
	[0172,0172,0172,0172,0172,0172,0172,0172,0172,0172,0172,0172,0172,0172,0172,0172,0172,0172,0172,0172,0172,0172,0172,0172,0172,0172,0172,0172,0172,0172],
	[0172,0172,0172,0172,0172,0172,0172,0172,0172,0172,0172,0172,0172,0172,0172,0172,0172,0172,0172,0172,0172,0172,0172,0172,0172,0172,0172,0172,0172,0172],
	[0172,0172,0172,0172,0172,0172,0172,0172,0172,0172,0172,0172,0172,0172,0172,0172,0172,0172,0172,0172,0172,0172,0172,0172,0172,0172,0172,0172,0172,0172],
	[0172,0172,0172,0172,0172,0172,0172,0172,0172,0172,0172,0172,0172,0172,0172,0172,0172,0172,0172,0172,0172,0172,0172,0172,0172,0172,0172,0172,0172,0172],
	[0172,0172,0172,0172,0172,0172,0172,0172,0172,0176,0170,0170,0170,0170,0170,0180,0172,0172,0172,0172,0172,0172,0172,0172,0172,0172,0172,0172,0172,0172],
	[0172,0172,0172,0172,0172,0172,0172,0172,0172,0184,0009,0011,0003,0011,0022,0188,0172,0172,0172,0172,0172,0172,0172,0172,0172,0172,0172,0172,0172,0172],
	[0172,0172,0172,0172,0172,0172,0172,0172,0172,0184,0024,0000,0000,0000,0030,0188,0172,0172,0172,0172,0172,0172,0172,0172,0172,0172,0172,0172,0172,0172],
	[0172,0172,0172,0172,0172,0172,0172,0172,0172,0184,0024,0000,0000,0000,0030,0188,0172,0172,0172,0172,0172,0172,0172,0172,0172,0172,0172,0172,0172,0172],
	[0172,0172,0172,0172,0172,0172,0172,0172,0172,0184,0024,0000,0000,0053,0061,0188,0172,0172,0172,0172,0172,0172,0172,0172,0172,0172,0172,0172,0172,0172],
	[0172,0172,0172,0172,0172,0172,0172,0172,0172,0184,0024,0000,0000,0038,0195,0196,0172,0172,0172,0172,0172,0172,0172,0172,0172,0172,0172,0172,0172,0172],
	[0172,0172,0172,0172,0172,0172,0172,0172,0172,0184,0024,0000,0000,0038,0188,0172,0172,0172,0172,0172,0176,0170,0170,0170,0180,0172,0172,0172,0172,0172],
	[0172,0172,0172,0172,0172,0172,0172,0172,0172,0184,0024,0000,0000,0038,0188,0172,0172,0176,0170,0170,0177,0009,0011,0013,0179,0170,0170,0170,0180,0172],
	[0172,0172,0172,0172,0172,0172,0172,0172,0176,0177,0024,0000,0000,0038,0179,0180,0172,0184,0009,0011,0011,0017,0000,0021,0011,0011,0011,0022,0188,0172],
	[0172,0172,0172,0176,0170,0170,0170,0170,0177,0009,0017,0000,0000,0021,0022,0188,0172,0184,0032,-008,-008,-008,-008,-008,-008,-008,-008,0038,0188,0172],
	[0172,0172,0172,0184,0009,0010,0011,0011,0011,0017,0000,0000,0000,0005,0038,0179,0170,0177,0032,-008,-008,-008,-008,-008,-008,-008,-008,0038,0188,0172],
	[0172,0172,0172,0184,0024,-008,-008,-008,-008,0000,0000,0000,0000,0000,0021,0011,0011,0011,0017,-008,-008,-008,-008,-008,-008,-008,-008,0038,0188,0172],
	[0172,0172,0172,0184,0024,-008,-008,-008,-008,0000,0000,0000,0000,0000,0000,0000,0000,0000,-008,-008,-008,-008,-008,0000,-008,-008,0000,0038,0188,0172],
	[0172,0172,0172,0184,0024,-008,-008,0053,0059,0059,0059,0049,0000,0000,0053,0059,0059,0059,0059,0059,0059,0059,0049,0000,0000,0000,0000,0046,0188,0172],
	[0170,0170,0170,0177,0024,-008,-008,0038,0000,0000,0000,0024,0000,0053,0061,0195,0202,0202,0202,0202,0202,0193,0057,0059,0059,0059,0059,0054,0188,0172],
	[0010,0010,0010,0010,0017,-008,-008,0038,0000,0000,0000,0057,0059,0061,0195,0203,0172,0172,0172,0172,0172,0201,0202,0202,0202,0202,0202,0202,0203,0172],
	[0000,0000,0000,-008,-008,-008,-008,0029,0000,0000,0000,0195,0202,0202,0203,0172,0172,0172,0172,0172,0172,0172,0172,0172,0172,0172,0172,0172,0172,0172],
	[0000,0000,0000,-008,-008,-008,-008,0046,0195,0202,0202,0203,0172,0172,0172,0172,0172,0172,0172,0172,0172,0172,0172,0172,0172,0172,0172,0172,0172,0172],
	[0059,0059,0059,0059,0059,0059,0059,0054,0188,0172,0172,0172,0172,0172,0172,0172,0172,0172,0172,0172,0172,0172,0172,0172,0172,0172,0172,0172,0172,0172],
	[0202,0202,0202,0202,0202,0202,0202,0202,0203,0172,0172,0172,0172,0172,0172,0172,0172,0172,0172,0172,0172,0172,0172,0172,0172,0172,0172,0172,0172,0172],
	[0172,0172,0172,0172,0172,0172,0172,0172,0172,0172,0172,0172,0172,0172,0172,0172,0172,0172,0172,0172,0172,0172,0172,0172,0172,0172,0172,0172,0172,0172],
	[0172,0172,0172,0172,0172,0172,0172,0172,0172,0172,0172,0172,0172,0172,0172,0172,0172,0172,0172,0172,0172,0172,0172,0172,0172,0172,0172,0172,0172,0172],
	[0172,0172,0172,0172,0172,0172,0172,0172,0172,0172,0172,0172,0172,0172,0172,0172,0172,0172,0172,0172,0172,0172,0172,0172,0172,0172,0172,0172,0172,0172],
	[0172,0172,0172,0172,0172,0172,0172,0172,0172,0172,0172,0172,0172,0172,0172,0172,0172,0172,0172,0172,0172,0172,0172,0172,0172,0172,0172,0172,0172,0172],
	[0172,0172,0172,0172,0172,0172,0172,0172,0172,0172,0172,0172,0172,0172,0172,0172,0172,0172,0172,0172,0172,0172,0172,0172,0172,0172,0172,0172,0172,0172],
	[0172,0172,0172,0172,0172,0172,0172,0172,0172,0172,0172,0172,0172,0172,0172,0172,0172,0172,0172,0172,0172,0172,0172,0172,0172,0172,0172,0172,0172,0172]
	],
	"couche1": [
	[-001,-001,-001,-001,-001,-001,-001,-001,-001,-001,-001,-001,-001,-001,-001,-001,-001,-001,-001,-001,-001,-001,-001,-001,-001,-001,-001,-001,-001,-001],
	[-001,-001,-001,-001,-001,-001,-001,-001,-001,-001,-001,-001,-001,-001,-001,-001,-001,-001,-001,-001,-001,-001,-001,-001,-001,-001,-001,-001,-001,-001],
	[-001,-001,-001,-001,-001,-001,-001,-001,-001,-001,-001,-001,-001,-001,-001,-001,-001,-001,-001,-001,-001,-001,-001,-001,-001,-001,-001,-001,-001,-001],
	[-001,-001,-001,-001,-001,-001,-001,-001,-001,-001,-001,-001,-001,-001,-001,-001,-001,-001,-001,-001,-001,-001,-001,-001,-001,-001,-001,-001,-001,-001],
	[-001,-001,-001,-001,-001,-001,-001,-001,-001,-001,-001,0039,-001,-001,-001,-001,-001,-001,-001,-001,-001,-001,-001,-001,-001,-001,-001,-001,-001,-001],
	[-001,-001,-001,-001,-001,-001,-001,-001,-001,-001,-001,0047,0004,-001,-001,-001,-001,-001,-001,-001,-001,-001,-001,-001,-001,-001,-001,-001,-001,-001],
	[-001,-001,-001,-001,-001,-001,-001,-001,-001,-001,-001,-001,-001,-001,-001,-001,-001,-001,-001,-001,-001,-001,-001,-001,-001,-001,-001,-001,-001,-001],
	[-001,-001,-001,-001,-001,-001,-001,-001,-001,-001,-001,-001,-001,-001,-001,-001,-001,-001,-001,-001,-001,-001,-001,-001,-001,-001,-001,-001,-001,-001],
	[-001,-001,-001,-001,-001,-001,-001,-001,-001,-001,-001,-001,-001,-001,-001,-001,-001,-001,-001,-001,-001,-001,-001,-001,-001,-001,-001,-001,-001,-001],
	[-001,-001,-001,-001,-001,-001,-001,-001,-001,-001,-001,0125,-001,-001,-001,-001,-001,-001,-001,-001,-001,-001,-001,-001,-001,-001,-001,-001,-001,-001],
	[-001,-001,-001,-001,-001,-001,-001,-001,-001,-001,-001,0133,-001,-001,-001,-001,-001,-001,-001,-001,-001,-001,-001,-001,-001,-001,-001,-001,-001,-001],
	[-001,-001,-001,-001,-001,-001,-001,-001,-001,-001,-001,-001,-001,-001,-001,-001,-001,-001,-001,-001,-001,-001,-001,-001,-001,-001,-001,-001,-001,-001],
	[-001,-001,-001,-001,-001,-001,-001,-001,-001,-001,-001,-001,-001,-001,-001,-001,-001,-001,-001,-001,-001,-001,-001,-001,-001,-001,-001,-001,-001,-001],
	[-001,-001,-001,-001,-001,-001,-001,-001,-001,-001,-001,-001,-001,-001,-001,-001,-001,-001,-001,-001,-001,-001,-001,-001,-001,-001,-001,-001,-001,-001],
	[-001,-001,-001,-001,-001,-001,-001,-001,-001,-001,-001,-001,-001,-001,-001,-001,-001,-001,-001,-001,-001,-001,-001,-001,-001,-001,-001,-001,-001,-001],
	[-001,-001,-001,-001,-001,-001,-001,-001,-001,-001,-001,-001,-001,-001,-001,-001,-001,-001,-001,-001,-001,-001,-001,-001,-001,-001,-001,-001,-001,-001],
	[-001,-001,-001,-001,-001,-001,-001,-001,-001,-001,-001,-001,-001,-001,-001,-001,-001,-001,-001,-001,-001,-001,-001,0212,-001,-001,-001,-001,-001,-001],
	[-001,-001,-001,-001,-001,-001,-001,-001,-001,-001,-001,-001,-001,-001,-001,-001,-001,-001,-001,-001,-001,-001,-001,-001,-001,-001,-001,-001,-001,-001],
	[-001,-001,-001,-001,-001,-001,-001,-001,-001,-001,-001,-001,-001,-001,-001,-001,-001,-001,-001,-001,-001,-001,-001,-001,-001,-001,-001,-001,-001,-001],
	[-001,-001,-001,-001,-001,-001,-001,-001,-001,-001,-001,-001,-001,-001,-001,-001,-001,-001,-001,-001,-001,-001,-001,-001,-001,-001,-001,-001,-001,-001],
	[-001,-001,-001,-001,-001,-001,-001,-001,-001,-001,-001,-001,-001,-001,-001,-001,-001,-001,-001,-001,-001,-001,-001,-001,-001,-001,-001,-001,-001,-001],
	[-001,-001,-001,-001,-001,-001,-001,-001,-001,-001,-001,-001,-001,-001,-001,-001,-001,-001,-001,-001,-001,-001,-001,-001,-001,-001,-001,-001,-001,-001],
	[-001,-001,-001,-001,-001,-001,-001,-001,-001,-001,-001,-001,-001,-001,-001,-001,-001,-001,-001,-001,-001,-001,-001,-001,-001,-001,-001,-001,-001,-001],
	[-001,-001,-001,-001,-001,-001,-001,-001,-001,-001,-001,-001,-001,-001,-001,-001,-001,-001,-001,-001,-001,-001,-001,-001,-001,-001,-001,-001,-001,-001],
	[-001,-001,-001,-001,-001,-001,-001,-001,-001,-001,-001,-001,-001,-001,-001,-001,-001,-001,-001,-001,-001,-001,-001,-001,-001,-001,-001,-001,-001,-001],
	[-001,-001,-001,-001,-001,-001,-001,-001,-001,-001,-001,-001,-001,-001,-001,-001,-001,-001,-001,-001,-001,-001,-001,-001,-001,-001,-001,-001,-001,-001],
	[-001,-001,-001,-001,-001,-001,-001,-001,-001,-001,-001,-001,-001,-001,-001,-001,-001,-001,-001,-001,-001,-001,-001,-001,-001,-001,-001,-001,-001,-001],
	[-001,-001,-001,-001,-001,-001,-001,-001,-001,-001,-001,-001,-001,-001,-001,-001,-001,-001,-001,-001,-001,-001,-001,-001,-001,-001,-001,-001,-001,-001],
	[-001,-001,-001,-001,-001,-001,-001,-001,-001,-001,-001,-001,-001,-001,-001,-001,-001,-001,-001,-001,-001,-001,-001,-001,-001,-001,-001,-001,-001,-001],
	[-001,-001,-001,-001,-001,-001,-001,-001,-001,-001,-001,-001,-001,-001,-001,-001,-001,-001,-001,-001,-001,-001,-001,-001,-001,-001,-001,-001,-001,-001]
	],
	"couche2": [
	[-001,-001,-001,-001,-001,-001,-001,-001,-001,-001,-001,-001,-001,-001,-001,-001,-001,-001,-001,-001,-001,-001,-001,-001,-001,-001,-001,-001,-001,-001],
	[-001,-001,-001,-001,-001,-001,-001,-001,-001,-001,-001,-001,-001,-001,-001,-001,-001,-001,-001,-001,-001,-001,-001,-001,-001,-001,-001,-001,-001,-001],
	[-001,-001,-001,-001,-001,-001,-001,-001,-001,-001,-001,-001,-001,-001,-001,-001,-001,-001,-001,-001,-001,-001,-001,-001,-001,-001,-001,-001,-001,-001],
	[-001,-001,-001,-001,-001,-001,-001,-001,-001,-001,-001,-001,-001,-001,-001,-001,-001,-001,-001,-001,-001,-001,-001,-001,-001,-001,-001,-001,-001,-001],
	[-001,-001,-001,-001,-001,-001,-001,-001,-001,-001,-001,-001,-001,-001,-001,-001,-001,-001,-001,-001,-001,-001,-001,-001,-001,-001,-001,-001,-001,-001],
	[-001,-001,-001,-001,-001,-001,-001,-001,-001,-001,-001,-001,-001,-001,-001,-001,-001,-001,-001,-001,-001,-001,-001,-001,-001,-001,-001,-001,-001,-001],
	[-001,-001,-001,-001,-001,-001,-001,-001,-001,-001,-001,-001,-001,-001,-001,-001,-001,-001,-001,-001,-001,-001,-001,-001,-001,-001,-001,-001,-001,-001],
	[-001,-001,-001,-001,-001,-001,-001,-001,-001,-001,-001,-001,-001,-001,-001,-001,-001,-001,-001,-001,-001,-001,-001,-001,-001,-001,-001,-001,-001,-001],
	[-001,-001,-001,-001,-001,-001,-001,-001,-001,-001,-001,-001,-001,-001,-001,-001,-001,-001,-001,-001,-001,-001,-001,-001,-001,-001,-001,-001,-001,-001],
	[-001,-001,-001,-001,-001,-001,-001,-001,-001,-001,-001,-001,-001,-001,-001,-001,-001,-001,-001,-001,-001,-001,-001,-001,-001,-001,-001,-001,-001,-001],
	[-001,-001,-001,-001,-001,-001,-001,-001,-001,-001,-001,-001,-001,-001,-001,-001,-001,-001,-001,-001,-001,-001,-001,-001,-001,-001,-001,-001,-001,-001],
	[-001,-001,-001,-001,-001,-001,-001,-001,-001,-001,-001,-001,-001,-001,-001,-001,-001,-001,-001,-001,-001,-001,-001,-001,-001,-001,-001,-001,-001,-001],
	[-001,-001,-001,-001,-001,-001,-001,-001,-001,-001,-001,-001,-001,-001,-001,-001,-001,-001,-001,-001,-001,-001,-001,-001,-001,-001,-001,-001,-001,-001],
	[-001,-001,-001,-001,-001,-001,-001,-001,-001,-001,-001,-001,-001,-001,-001,-001,-001,-001,-001,-001,-001,-001,-001,-001,-001,-001,-001,-001,-001,-001],
	[-001,-001,-001,-001,-001,-001,-001,-001,-001,-001,-001,-001,-001,-001,-001,-001,-001,-001,-001,-001,-001,-001,-001,-001,-001,-001,-001,-001,-001,-001],
	[-001,-001,-001,-001,-001,-001,-001,-001,-001,-001,-001,-001,-001,-001,-001,-001,-001,-001,-001,-001,-001,-001,-001,-001,-001,-001,-001,-001,-001,-001],
	[-001,-001,-001,-001,-001,-001,-001,-001,-001,-001,-001,-001,-001,-001,-001,-001,-001,-001,-001,-001,-001,-001,-001,-001,-001,-001,-001,-001,-001,-001],
	[-001,-001,-001,-001,-001,-001,-001,-001,-001,-001,-001,-001,-001,-001,-001,-001,-001,-001,-001,-001,-001,-001,-001,-001,-001,-001,-001,-001,-001,-001],
	[-001,-001,-001,-001,-001,-001,-001,-001,-001,-001,-001,-001,-001,-001,-001,-001,-001,-001,-001,-001,-001,-001,-001,-001,-001,-001,-001,-001,-001,-001],
	[-001,-001,-001,-001,-001,-001,-001,-001,-001,-001,-001,-001,-001,-001,-001,-001,-001,-001,-001,-001,-001,-001,-001,-001,-001,-001,-001,-001,-001,-001],
	[-001,-001,-001,-001,-001,-001,-001,-001,-001,-001,-001,-001,-001,-001,-001,-001,-001,-001,-001,-001,-001,-001,-001,-001,-001,-001,-001,-001,-001,-001],
	[-001,-001,-001,-001,-001,-001,-001,-001,-001,-001,-001,-001,-001,-001,-001,-001,-001,-001,-001,-001,-001,-001,-001,-001,-001,-001,-001,-001,-001,-001],
	[-001,-001,-001,-001,-001,-001,-001,-001,-001,-001,-001,-001,-001,-001,-001,-001,-001,-001,-001,-001,-001,-001,-001,-001,-001,-001,-001,-001,-001,-001],
	[-001,-001,-001,-001,-001,-001,-001,-001,-001,-001,-001,-001,-001,-001,-001,-001,-001,-001,-001,-001,-001,-001,-001,-001,-001,-001,-001,-001,-001,-001],
	[-001,-001,-001,-001,-001,-001,-001,-001,-001,-001,-001,-001,-001,-001,-001,-001,-001,-001,-001,-001,-001,-001,-001,-001,-001,-001,-001,-001,-001,-001],
	[-001,-001,-001,-001,-001,-001,-001,-001,-001,-001,-001,-001,-001,-001,-001,-001,-001,-001,-001,-001,-001,-001,-001,-001,-001,-001,-001,-001,-001,-001],
	[-001,-001,-001,-001,-001,-001,-001,-001,-001,-001,-001,-001,-001,-001,-001,-001,-001,-001,-001,-001,-001,-001,-001,-001,-001,-001,-001,-001,-001,-001],
	[-001,-001,-001,-001,-001,-001,-001,-001,-001,-001,-001,-001,-001,-001,-001,-001,-001,-001,-001,-001,-001,-001,-001,-001,-001,-001,-001,-001,-001,-001],
	[-001,-001,-001,-001,-001,-001,-001,-001,-001,-001,-001,-001,-001,-001,-001,-001,-001,-001,-001,-001,-001,-001,-001,-001,-001,-001,-001,-001,-001,-001],
	[-001,-001,-001,-001,-001,-001,-001,-001,-001,-001,-001,-001,-001,-001,-001,-001,-001,-001,-001,-001,-001,-001,-001,-001,-001,-001,-001,-001,-001,-001]
	],
	"events": [
	{
		"id": 5,
		"nom": "Clone[341][113]",
		"x": 12,
		"y": 18
	},
	{
		"id": 55,
		"nom": "EV055",
		"x": 0,
		"y": 20,
		"pages": [
		{
			"conditions": [
			{
				"nom": "ArriveeAuContact"
			}
			],
			"commandes": [
			{
				"nom": "ChangerDeMap",
				"variable": false,
				"numeroNouvelleMap": 245,
				"xDebutHeros": 28,
				"yDebutHeros": 12
			}
			],
			"vitesse": "moderee",
			"frequence": "basse",
			"animeEnMouvement": true,
			"animeALArret": false,
			"directionFixe": false,
			"traversable": false,
			"auDessusDeTout": false
		}
		]
	},
	{
		"id": 6,
		"nom": "EV006",
		"x": 1,
		"y": 22,
		"pages": [
		{
			"conditions": [
			],
			"commandes": [
			{
				"nom": "Commentaire",
				"texte": "activer le verglas"
			},
			{
				"nom": "ModifierInterrupteur",
				"numeroInterrupteur": 36,
				"valeur": true
			},
			{
				"nom": "SupprimerEvent"
			}
			],
			"vitesse": "moderee",
			"frequence": "basse",
			"animeEnMouvement": true,
			"animeALArret": false,
			"directionFixe": false,
			"traversable": false,
			"auDessusDeTout": false
		}
		]
	},
	{
		"id": 1,
		"nom": "Clone[341][050]",
		"x": 23,
		"y": 16
	},
	{
		"id": 56,
		"nom": "EV056",
		"x": 0,
		"y": 21,
		"pages": [
		{
			"conditions": [
			{
				"nom": "ArriveeAuContact"
			}
			],
			"commandes": [
			{
				"nom": "ChangerDeMap",
				"variable": false,
				"numeroNouvelleMap": 245,
				"xDebutHeros": 28,
				"yDebutHeros": 13
			}
			],
			"vitesse": "moderee",
			"frequence": "basse",
			"animeEnMouvement": true,
			"animeALArret": false,
			"directionFixe": false,
			"traversable": false,
			"auDessusDeTout": false
		}
		]
	},
	{
		"id": 62,
		"nom": "Parchemin",
		"x": 11,
		"y": 5,
		"pages": [
		{
			"conditions": [
			{
				"nom": "Parler"
			}
			],
			"commandes": [
			{
				"nom": "ModifierInterrupteur",
				"numeroInterrupteur": 12,
				"valeur": true
			},
			{
				"nom": "Message",
				"texte": "\"Minuit de givre,\\nj’ai emprunté pour dormir\\nla manche d’un épouvantail !\""
			},
			{
				"nom": "Message",
				"texte": "\\c[02]Matsuo Bashô\\c[02]"
			},
			{
				"nom": "Attendre",
				"nombreDeFrames": 8
			},
			{
				"nom": "ModifierInterrupteur",
				"numeroInterrupteur": 12,
				"valeur": false
			}
			],
			"vitesse": "moderee",
			"frequence": "basse",
			"animeEnMouvement": true,
			"animeALArret": false,
			"directionFixe": false,
			"traversable": false,
			"auDessusDeTout": false
		}
		]
	},
	{
		"id": 57,
		"nom": "EV057",
		"x": 12,
		"y": 5,
		"pages": [
		{
			"conditions": [
			{
				"nom": "ArriveeAuContact"
			}
			],
			"commandes": [
			{
				"nom": "ChangerDeMap",
				"variable": false,
				"numeroNouvelleMap": 288,
				"xDebutHeros": 6,
				"yDebutHeros": 32
			}
			],
			"vitesse": "moderee",
			"frequence": "basse",
			"animeEnMouvement": true,
			"animeALArret": false,
			"directionFixe": false,
			"traversable": false,
			"auDessusDeTout": false
		}
		]
	},
	{
		"id": 2,
		"nom": "Clone[341][006]",
		"x": 22,
		"y": 12
	},
	{
		"id": 63,
		"nom": "Clone[341][008]",
		"x": 10,
		"y": 19
	},
	{
		"id": 3,
		"nom": "brouillard de forêt",
		"x": 14,
		"y": 13,
		"pages": [
		{
			"conditions": [
			],
			"commandes": [
			{
				"nom": "ModifierMeteo",
				"type": "neige",
				"intensite": 9
			},
			{
				"nom": "SupprimerEvent"
			}
			],
			"vitesse": "moderee",
			"frequence": "basse",
			"animeEnMouvement": true,
			"animeALArret": false,
			"directionFixe": false,
			"traversable": false,
			"auDessusDeTout": false
		}
		]
	},
	{
		"id": 59,
		"nom": "Pancarte",
		"x": 13,
		"y": 14,
		"pages": [
		{
			"conditions": [
			{
				"nom": "Parler"
			}
			],
			"commandes": [
			{
				"nom": "ConditionDirection",
				"idEventConcerne": 0,
				"direction": 3,
				"numero": 0
			},
			{
				"nom": "ModifierInterrupteur",
				"numeroInterrupteur": 12,
				"valeur": true
			},
			{
				"nom": "Message",
				"texte": "/\\ Village viking jaune\\n< Station AGV"
			},
			{
				"nom": "Attendre",
				"nombreDeFrames": 8
			},
			{
				"nom": "ConditionFin",
				"numero": 0
			},
			{
				"nom": "ModifierInterrupteur",
				"numeroInterrupteur": 12,
				"valeur": false
			}
			],
			"vitesse": "moderee",
			"frequence": "basse",
			"animeEnMouvement": false,
			"animeALArret": false,
			"directionFixe": false,
			"traversable": false,
			"auDessusDeTout": false
		}
		]
	},
	{
		"id": 4,
		"nom": "Clone[341][039]",
		"x": 8,
		"y": 18
	}
	]
}
