{
	"nom": "Salle 11,5 (ballon)",
	"tileset": "Sanctuaire de Kaze",
	"largeur": 25,
	"hauteur": 25,
	"musique": {
		"nomFichierSonore": "",
		"volume": 1.00,
		"tempo": 1.00
	},
	"fondSonore": {
		"nomFichierSonore": "",
		"volume": 0.80,
		"tempo": 1.00
	},
	"couche0": [
	[0002,0002,0002,0002,0002,0002,0002,0002,0002,0002,0002,0002,0002,0002,0002,0002,0002,0002,0002,0002,0002,0002,0002,0002,0002],
	[0002,0002,0002,0002,0002,0002,0002,0002,0002,0002,0002,0002,0002,0002,0002,0002,0002,0002,0002,0002,0002,0002,0002,0002,0002],
	[0002,0002,0002,0002,0002,0002,0002,0002,0002,0002,0002,0002,0002,0002,0002,0002,0002,0002,0002,0002,0002,0002,0002,0002,0002],
	[0002,0002,0002,0002,0002,0002,0002,0002,0002,0002,0002,0002,0002,0002,0002,0002,0002,0002,0002,0002,0002,0002,0002,0002,0002],
	[0002,0002,0002,0002,0002,0002,0002,0002,0002,0002,0002,0002,0002,0002,0002,0002,0002,0002,0002,0002,0002,0002,0002,0002,0002],
	[0002,0002,0002,0002,0002,0002,0002,0036,0037,0004,0005,0004,0005,0004,0005,0004,0038,0039,0002,0002,0002,0002,0002,0002,0002],
	[0002,0002,0002,0002,0002,0002,0002,0044,0045,0012,0013,0012,0013,0012,0013,0012,0046,0047,0002,0002,0002,0002,0002,0002,0002],
	[0002,0002,0002,0002,0002,0002,0002,0020,0021,-004,-004,-004,-006,-004,-004,-004,0006,0007,0002,0002,0002,0002,0002,0002,0002],
	[0002,0002,0002,0002,0002,0002,-004,0048,0049,-004,-006,-006,-006,-006,-006,-004,0014,0015,0002,0002,0002,0002,0002,0002,0002],
	[0002,0002,0002,0002,0002,0002,-004,0056,0057,0000,-006,-004,-004,-004,-006,-004,0006,0007,0002,0002,0002,0002,0002,0002,0002],
	[0002,0002,0002,0002,0002,0002,-004,0064,0065,-004,-004,-004,-006,-004,-006,-004,0014,0015,0002,0002,0002,0002,0002,0002,0002],
	[0002,0002,0002,0002,0002,0002,0002,0020,0021,-004,-006,-006,-006,-006,-006,-004,0006,0007,0002,0002,0002,0002,0002,0002,0002],
	[0002,0002,0002,0002,0002,0002,0002,0028,0029,-004,-006,-004,-006,-004,-004,-004,0050,0051,-004,0002,0002,0002,0002,0002,0002],
	[0002,0002,0002,0002,0002,0002,0002,0020,0021,-004,-006,-004,-004,-004,-006,0000,0058,0059,-004,0002,0002,0002,0002,0002,0002],
	[0002,0002,0002,0002,0002,0002,0002,0028,0029,-004,-006,-006,-006,-006,-006,-004,0066,0067,-004,0002,0002,0002,0002,0002,0002],
	[0002,0002,0002,0002,0002,0002,0002,0020,0021,-004,-004,-004,-004,-004,-004,-004,0006,0007,0002,0002,0002,0002,0002,0002,0002],
	[0002,0002,0002,0002,0002,0002,0002,0052,0053,0022,0023,0022,0023,0022,0023,0022,0054,0055,0002,0002,0002,0002,0002,0002,0002],
	[0002,0002,0002,0002,0002,0002,0002,0060,0061,0030,0031,0030,0031,0030,0031,0030,0062,0063,0002,0002,0002,0002,0002,0002,0002],
	[0002,0002,0002,0002,0002,0002,0002,0002,0002,0002,0002,0002,0002,0002,0002,0002,0002,0002,0002,0002,0002,0002,0002,0002,0002],
	[0002,0002,0002,0002,0002,0002,0002,0002,0002,0002,0002,0002,0002,0002,0002,0002,0002,0002,0002,0002,0002,0002,0002,0002,0002],
	[0002,0002,0002,0002,0002,0002,0002,0002,0002,0002,0002,0002,0002,0002,0002,0002,0002,0002,0002,0002,0002,0002,0002,0002,0002],
	[0002,0002,0002,0002,0002,0002,0002,0002,0002,0002,0002,0002,0002,0002,0002,0002,0002,0002,0002,0002,0002,0002,0002,0002,0002],
	[0002,0002,0002,0002,0002,0002,0002,0002,0002,0002,0002,0002,0002,0002,0002,0002,0002,0002,0002,0002,0002,0002,0002,0002,0002],
	[0002,0002,0002,0002,0002,0002,0002,0002,0002,0002,0002,0002,0002,0002,0002,0002,0002,0002,0002,0002,0002,0002,0002,0002,0002],
	[0002,0002,0002,0002,0002,0002,0002,0002,0002,0002,0002,0002,0002,0002,0002,0002,0002,0002,0002,0002,0002,0002,0002,0002,0002]
	],
	"couche1": [
	[-001,-001,-001,-001,-001,-001,-001,-001,-001,-001,-001,-001,-001,-001,-001,-001,-001,-001,-001,-001,-001,-001,-001,-001,-001],
	[-001,-001,-001,-001,-001,-001,-001,-001,-001,-001,-001,-001,-001,-001,-001,-001,-001,-001,-001,-001,-001,-001,-001,-001,-001],
	[-001,-001,-001,-001,-001,-001,-001,-001,-001,-001,-001,-001,-001,-001,-001,-001,-001,-001,-001,-001,-001,-001,-001,-001,-001],
	[-001,-001,-001,-001,-001,-001,-001,-001,-001,-001,-001,-001,-001,-001,-001,-001,-001,-001,-001,-001,-001,-001,-001,-001,-001],
	[-001,-001,-001,-001,-001,-001,-001,-001,-001,-001,-001,-001,-001,-001,-001,-001,-001,-001,-001,-001,-001,-001,-001,-001,-001],
	[-001,-001,-001,-001,-001,-001,-001,-001,-001,-001,-001,-001,-001,-001,-001,-001,-001,-001,-001,-001,-001,-001,-001,-001,-001],
	[-001,-001,-001,-001,-001,-001,-001,-001,-001,-001,-001,-001,-001,-001,-001,-001,-001,-001,-001,-001,-001,-001,-001,-001,-001],
	[-001,-001,-001,-001,-001,-001,-001,-001,-001,-001,-001,-001,0011,-001,-001,-001,-001,-001,-001,-001,-001,-001,-001,-001,-001],
	[-001,-001,-001,-001,-001,-001,0232,0104,0105,-001,-001,-001,-001,-001,-001,-001,-001,-001,-001,-001,-001,-001,-001,-001,-001],
	[-001,-001,-001,-001,-001,-001,0232,0112,0113,-001,-001,-001,-001,-001,-001,-001,-001,-001,-001,-001,-001,-001,-001,-001,-001],
	[-001,-001,-001,-001,-001,-001,0232,0120,0121,-001,-001,-001,-001,-001,-001,-001,-001,-001,-001,-001,-001,-001,-001,-001,-001],
	[-001,-001,-001,-001,-001,-001,-001,-001,-001,-001,-001,-001,-001,-001,-001,-001,-001,-001,-001,-001,-001,-001,-001,-001,-001],
	[-001,-001,-001,-001,-001,-001,-001,-001,-001,-001,-001,-001,-001,-001,-001,-001,0106,0107,0232,-001,-001,-001,-001,-001,-001],
	[-001,-001,-001,-001,-001,-001,-001,-001,-001,-001,-001,-001,-001,-001,-001,-001,0114,0115,0232,-001,-001,-001,-001,-001,-001],
	[-001,-001,-001,-001,-001,-001,-001,-001,-001,-001,-001,-001,-001,-001,-001,-001,0122,0123,0232,-001,-001,-001,-001,-001,-001],
	[-001,-001,-001,-001,-001,-001,-001,-001,-001,-001,-001,-001,-001,-001,-001,-001,-001,-001,-001,-001,-001,-001,-001,-001,-001],
	[-001,-001,-001,-001,-001,-001,-001,-001,-001,-001,-001,-001,-001,-001,-001,-001,-001,-001,-001,-001,-001,-001,-001,-001,-001],
	[-001,-001,-001,-001,-001,-001,-001,-001,-001,-001,-001,-001,-001,-001,-001,-001,-001,-001,-001,-001,-001,-001,-001,-001,-001],
	[-001,-001,-001,-001,-001,-001,-001,-001,-001,-001,-001,-001,-001,-001,-001,-001,-001,-001,-001,-001,-001,-001,-001,-001,-001],
	[-001,-001,-001,-001,-001,-001,-001,-001,-001,-001,-001,-001,-001,-001,-001,-001,-001,-001,-001,-001,-001,-001,-001,-001,-001],
	[-001,-001,-001,-001,-001,-001,-001,-001,-001,-001,-001,-001,-001,-001,-001,-001,-001,-001,-001,-001,-001,-001,-001,-001,-001],
	[-001,-001,-001,-001,-001,-001,-001,-001,-001,-001,-001,-001,-001,-001,-001,-001,-001,-001,-001,-001,-001,-001,-001,-001,-001],
	[-001,-001,-001,-001,-001,-001,-001,-001,-001,-001,-001,-001,-001,-001,-001,-001,-001,-001,-001,-001,-001,-001,-001,-001,-001],
	[-001,-001,-001,-001,-001,-001,-001,-001,-001,-001,-001,-001,-001,-001,-001,-001,-001,-001,-001,-001,-001,-001,-001,-001,-001],
	[-001,-001,-001,-001,-001,-001,-001,-001,-001,-001,-001,-001,-001,-001,-001,-001,-001,-001,-001,-001,-001,-001,-001,-001,-001]
	],
	"couche2": [
	[-001,-001,-001,-001,-001,-001,-001,-001,-001,-001,-001,-001,-001,-001,-001,-001,-001,-001,-001,-001,-001,-001,-001,-001,-001],
	[-001,-001,-001,-001,-001,-001,-001,-001,-001,-001,-001,-001,-001,-001,-001,-001,-001,-001,-001,-001,-001,-001,-001,-001,-001],
	[-001,-001,-001,-001,-001,-001,-001,-001,-001,-001,-001,-001,-001,-001,-001,-001,-001,-001,-001,-001,-001,-001,-001,-001,-001],
	[-001,-001,-001,-001,-001,-001,-001,-001,-001,-001,-001,-001,-001,-001,-001,-001,-001,-001,-001,-001,-001,-001,-001,-001,-001],
	[-001,-001,-001,-001,-001,-001,-001,-001,-001,-001,-001,-001,-001,-001,-001,-001,-001,-001,-001,-001,-001,-001,-001,-001,-001],
	[-001,-001,-001,-001,-001,-001,-001,-001,-001,-001,-001,-001,-001,-001,-001,-001,-001,-001,-001,-001,-001,-001,-001,-001,-001],
	[-001,-001,-001,-001,-001,-001,-001,-001,-001,-001,-001,-001,-001,-001,-001,-001,-001,-001,-001,-001,-001,-001,-001,-001,-001],
	[-001,-001,-001,-001,-001,-001,-001,-001,-001,-001,-001,-001,-001,-001,-001,-001,-001,-001,-001,-001,-001,-001,-001,-001,-001],
	[-001,-001,-001,-001,-001,-001,-001,-001,-001,-001,-001,-001,-001,-001,-001,-001,-001,-001,-001,-001,-001,-001,-001,-001,-001],
	[-001,-001,-001,-001,-001,-001,-001,-001,-001,-001,-001,-001,-001,-001,-001,-001,-001,-001,-001,-001,-001,-001,-001,-001,-001],
	[-001,-001,-001,-001,-001,-001,-001,-001,-001,-001,-001,-001,-001,-001,-001,-001,-001,-001,-001,-001,-001,-001,-001,-001,-001],
	[-001,-001,-001,-001,-001,-001,-001,-001,-001,-001,-001,-001,-001,-001,-001,-001,-001,-001,-001,-001,-001,-001,-001,-001,-001],
	[-001,-001,-001,-001,-001,-001,-001,-001,-001,-001,-001,-001,-001,-001,-001,-001,-001,-001,-001,-001,-001,-001,-001,-001,-001],
	[-001,-001,-001,-001,-001,-001,-001,-001,-001,-001,-001,-001,-001,-001,-001,-001,-001,-001,-001,-001,-001,-001,-001,-001,-001],
	[-001,-001,-001,-001,-001,-001,-001,-001,-001,-001,-001,-001,-001,-001,-001,-001,-001,-001,-001,-001,-001,-001,-001,-001,-001],
	[-001,-001,-001,-001,-001,-001,-001,-001,-001,-001,-001,-001,-001,-001,-001,-001,-001,-001,-001,-001,-001,-001,-001,-001,-001],
	[-001,-001,-001,-001,-001,-001,-001,-001,-001,-001,-001,-001,-001,-001,-001,-001,-001,-001,-001,-001,-001,-001,-001,-001,-001],
	[-001,-001,-001,-001,-001,-001,-001,-001,-001,-001,-001,-001,-001,-001,-001,-001,-001,-001,-001,-001,-001,-001,-001,-001,-001],
	[-001,-001,-001,-001,-001,-001,-001,-001,-001,-001,-001,-001,-001,-001,-001,-001,-001,-001,-001,-001,-001,-001,-001,-001,-001],
	[-001,-001,-001,-001,-001,-001,-001,-001,-001,-001,-001,-001,-001,-001,-001,-001,-001,-001,-001,-001,-001,-001,-001,-001,-001],
	[-001,-001,-001,-001,-001,-001,-001,-001,-001,-001,-001,-001,-001,-001,-001,-001,-001,-001,-001,-001,-001,-001,-001,-001,-001],
	[-001,-001,-001,-001,-001,-001,-001,-001,-001,-001,-001,-001,-001,-001,-001,-001,-001,-001,-001,-001,-001,-001,-001,-001,-001],
	[-001,-001,-001,-001,-001,-001,-001,-001,-001,-001,-001,-001,-001,-001,-001,-001,-001,-001,-001,-001,-001,-001,-001,-001,-001],
	[-001,-001,-001,-001,-001,-001,-001,-001,-001,-001,-001,-001,-001,-001,-001,-001,-001,-001,-001,-001,-001,-001,-001,-001,-001],
	[-001,-001,-001,-001,-001,-001,-001,-001,-001,-001,-001,-001,-001,-001,-001,-001,-001,-001,-001,-001,-001,-001,-001,-001,-001]
	],
	"events": [
	{
		"id": 1,
		"nom": "Clone[341][055]",
		"x": 12,
		"y": 11
	},
	{
		"id": 2,
		"nom": "EV002",
		"x": 7,
		"y": 9,
		"pages": [
		{
			"conditions": [
			{
				"nom": "ArriveeAuContact"
			}
			],
			"commandes": [
			{
				"nom": "ChangerDeMap",
				"variable": false,
				"numeroNouvelleMap": 375,
				"xDebutHeros": 28,
				"yDebutHeros": 25
			}
			],
			"vitesse": 8,
			"frequence": 8,
			"animeEnMouvement": true,
			"animeALArret": false,
			"directionFixe": false,
			"traversable": false,
			"auDessusDeTout": false
		}
		]
	},
	{
		"id": 3,
		"nom": "EV003",
		"x": 17,
		"y": 13,
		"pages": [
		{
			"conditions": [
			{
				"nom": "ArriveeAuContact"
			}
			],
			"commandes": [
			{
				"nom": "ModifierVariable",
				"numeroVariable": 115,
				"operationAFaire": "rendre egal a",
				"valeurADonner": 2,
				"operationAFaire2": "valeur brute"
			},
			{
				"nom": "ChangerDeMap",
				"variable": false,
				"numeroNouvelleMap": 272,
				"xDebutHeros": 14,
				"yDebutHeros": 26
			}
			],
			"vitesse": 8,
			"frequence": 8,
			"animeEnMouvement": true,
			"animeALArret": false,
			"directionFixe": false,
			"traversable": false,
			"auDessusDeTout": false
		}
		]
	},
	{
		"id": 4,
		"nom": "Pancarte",
		"x": 12,
		"y": 7,
		"pages": [
		{
			"conditions": [
			{
				"nom": "Parler"
			}
			],
			"commandes": [
			{
				"nom": "ConditionDirection",
				"idEventConcerne": 0,
				"direction": 3,
				"numero": 0
			},
			{
				"nom": "ModifierInterrupteur",
				"numeroInterrupteur": 12,
				"valeur": true
			},
			{
				"nom": "Message",
				"texte": "Si vous ne pressez pas assez fort la touche \\nESPACE, il se peut que la bourrasque de\\nl'éventail ne soit pas assez puissante pour\\ndéplacer des objets."
			},
			{
				"nom": "Attendre",
				"nombreDeFrames": 8
			},
			{
				"nom": "ConditionSinon",
				"numero": 0
			},
			{
				"nom": "ConditionFin",
				"numero": 0
			},
			{
				"nom": "ModifierInterrupteur",
				"numeroInterrupteur": 12,
				"valeur": false
			}
			],
			"vitesse": 8,
			"frequence": 8,
			"animeEnMouvement": false,
			"animeALArret": false,
			"directionFixe": false,
			"traversable": false,
			"auDessusDeTout": false
		}
		]
	}
	]
}
