{
	"nom": "FIN DE LA DEMO",
	"tileset": "Ventre",
	"largeur": 20,
	"hauteur": 15,
	"musique": {
		"nomFichierSonore": "Docteur Ralph.mp3",
		"volume": 1.00,
		"tempo": 1.00
	},
	"fondSonore": {
		"nomFichierSonore": "InterieurDeLaBaleine.ogg",
		"volume": 0.50,
		"tempo": 1.50
	},
	"couche0": [
	[0809,0809,0809,0809,0809,0809,0809,0809,0809,0809,0809,0809,0809,0809,0809,0809,0809,0809,0809,0809],
	[0809,0809,0809,0809,0809,0809,0809,0809,0809,0809,0809,0809,0809,0809,0809,0809,0809,0809,0809,0809],
	[0809,0809,0809,0809,0809,0809,0809,0809,0809,0809,0809,0809,0809,0809,0809,0809,0809,0809,0809,0809],
	[0809,0809,0809,0809,0809,0809,0809,0809,0809,0809,0809,0809,0809,0809,0809,0809,0809,0809,0809,0809],
	[0809,0809,0809,0809,0809,0809,0809,0809,0809,0809,0809,0809,0809,0809,0809,0809,0809,0809,0809,0809],
	[0809,0809,0809,0809,0809,0809,0809,0809,0809,0809,0809,0809,0809,0809,0809,0809,0809,0809,0809,0809],
	[0809,0809,0809,0809,0809,0809,0809,0809,0809,0809,0809,0809,0809,0809,0809,0809,0809,0809,0809,0809],
	[0809,0809,0809,0809,0809,0809,0809,0809,0809,0809,0809,0809,0809,0809,0809,0809,0809,0809,0809,0809],
	[0809,0809,0809,0809,0809,0809,0809,0809,0809,0809,0809,0809,0809,0809,0809,0809,0809,0809,0809,0809],
	[0809,0809,0809,0809,0809,0809,0809,0809,0809,0809,0809,0809,0809,0809,0809,0809,0809,0809,0809,0809],
	[0809,0809,0809,0809,0809,0809,0809,0809,0809,0809,0809,0809,0809,0809,0809,0809,0809,0809,0809,0809],
	[0809,0809,0809,0809,0809,0809,0809,0809,0809,0809,0809,0809,0809,0809,0809,0809,0809,0809,0809,0809],
	[0809,0809,0809,0809,0809,0809,0809,0809,0809,0809,0809,0809,0809,0809,0809,0809,0809,0809,0809,0809],
	[0809,0809,0809,0809,0809,0809,0809,0809,0809,0809,0809,0809,0809,0809,0809,0809,0809,0809,0809,0809],
	[0809,0809,0809,0809,0809,0809,0809,0809,0809,0809,0809,0809,0809,0809,0809,0809,0809,0809,0809,0809]
	],
	"couche1": [
	[-001,-001,-001,-001,-001,-001,-001,-001,-001,-001,-001,-001,-001,-001,-001,-001,-001,-001,-001,-001],
	[-001,-001,-001,-001,-001,-001,-001,-001,-001,-001,-001,-001,-001,-001,-001,-001,-001,-001,-001,-001],
	[-001,-001,-001,-001,-001,-001,-001,-001,-001,-001,-001,-001,-001,-001,-001,-001,-001,-001,-001,-001],
	[-001,-001,-001,-001,-001,-001,-001,-001,-001,-001,-001,-001,-001,-001,-001,-001,-001,-001,-001,-001],
	[-001,-001,-001,-001,-001,-001,-001,-001,-001,-001,-001,-001,-001,-001,-001,-001,-001,-001,-001,-001],
	[-001,-001,-001,-001,-001,-001,-001,-001,-001,-001,-001,-001,-001,-001,-001,-001,-001,-001,-001,-001],
	[-001,-001,-001,-001,-001,-001,-001,-001,-001,-001,-001,-001,-001,-001,-001,-001,-001,-001,-001,-001],
	[-001,-001,-001,-001,-001,-001,-001,-001,-001,-001,-001,-001,-001,-001,-001,-001,-001,-001,-001,-001],
	[-001,-001,-001,-001,-001,-001,-001,-001,-001,-001,-001,-001,-001,-001,-001,-001,-001,-001,-001,-001],
	[-001,-001,-001,-001,-001,-001,-001,-001,-001,-001,-001,-001,-001,-001,-001,-001,-001,-001,-001,-001],
	[-001,-001,-001,-001,-001,-001,-001,-001,-001,-001,-001,-001,-001,-001,-001,-001,-001,-001,-001,-001],
	[-001,-001,-001,-001,-001,-001,-001,-001,-001,-001,-001,-001,-001,-001,-001,-001,-001,-001,-001,-001],
	[-001,-001,-001,-001,-001,-001,-001,-001,-001,-001,-001,-001,-001,-001,-001,-001,-001,-001,-001,-001],
	[-001,-001,-001,-001,-001,-001,-001,-001,-001,-001,-001,-001,-001,-001,-001,-001,-001,-001,-001,-001],
	[-001,-001,-001,-001,-001,-001,-001,-001,-001,-001,-001,-001,-001,-001,-001,-001,-001,-001,-001,-001]
	],
	"couche2": [
	[-001,-001,-001,-001,-001,-001,-001,-001,-001,-001,-001,-001,-001,-001,-001,-001,-001,-001,-001,-001],
	[-001,-001,-001,-001,-001,-001,-001,-001,-001,-001,-001,-001,-001,-001,-001,-001,-001,-001,-001,-001],
	[-001,-001,-001,-001,-001,-001,-001,-001,-001,-001,-001,-001,-001,-001,-001,-001,-001,-001,-001,-001],
	[-001,-001,-001,-001,-001,-001,-001,-001,-001,-001,-001,-001,-001,-001,-001,-001,-001,-001,-001,-001],
	[-001,-001,-001,-001,-001,-001,-001,-001,-001,-001,-001,-001,-001,-001,-001,-001,-001,-001,-001,-001],
	[-001,-001,-001,-001,-001,-001,-001,-001,-001,-001,-001,-001,-001,-001,-001,-001,-001,-001,-001,-001],
	[-001,-001,-001,-001,-001,-001,-001,-001,-001,-001,-001,-001,-001,-001,-001,-001,-001,-001,-001,-001],
	[-001,-001,-001,-001,-001,-001,-001,-001,-001,-001,-001,-001,-001,-001,-001,-001,-001,-001,-001,-001],
	[-001,-001,-001,-001,-001,-001,-001,-001,-001,-001,-001,-001,-001,-001,-001,-001,-001,-001,-001,-001],
	[-001,-001,-001,-001,-001,-001,-001,-001,-001,-001,-001,-001,-001,-001,-001,-001,-001,-001,-001,-001],
	[-001,-001,-001,-001,-001,-001,-001,-001,-001,-001,-001,-001,-001,-001,-001,-001,-001,-001,-001,-001],
	[-001,-001,-001,-001,-001,-001,-001,-001,-001,-001,-001,-001,-001,-001,-001,-001,-001,-001,-001,-001],
	[-001,-001,-001,-001,-001,-001,-001,-001,-001,-001,-001,-001,-001,-001,-001,-001,-001,-001,-001,-001],
	[-001,-001,-001,-001,-001,-001,-001,-001,-001,-001,-001,-001,-001,-001,-001,-001,-001,-001,-001,-001],
	[-001,-001,-001,-001,-001,-001,-001,-001,-001,-001,-001,-001,-001,-001,-001,-001,-001,-001,-001,-001]
	],
	"events": [
	{
		"id": 1,
		"nom": "Fin de la démo",
		"x": 2,
		"y": 2,
		"pages": [
		{
			"conditions": [
			],
			"commandes": [
			{
				"nom": "ModifierInterrupteur",
				"numeroInterrupteur": 12,
				"valeur": true
			},
			{
				"nom": "AfficherImage",
				"numero": 10,
				"nomImage": "ecran noir",
				"centre": false,
				"variables": false,
				"x": 0,
				"y": 0,
				"zoomX": 100,
				"zoomY": 100,
				"opacite": 255,
				"modeDeFusion": "normal"
			},
			{
				"nom": "Attendre",
				"nombreDeFrames": 33
			},
			{
				"nom": "AfficherImage",
				"numero": 11,
				"nomImage": "demofin1",
				"centre": false,
				"variables": false,
				"x": 0,
				"y": 0,
				"zoomX": 100,
				"zoomY": 100,
				"opacite": 0,
				"modeDeFusion": "normal"
			},
			{
				"nom": "DeplacerImage",
				"numero": 11,
				"nombreDeFrames": 66,
				"centre": false,
				"variables": false,
				"x": 0,
				"y": 0,
				"zoomX": 100,
				"zoomY": 100,
				"opacite": 255,
				"modeDeFusion": "normal"
			},
			{
				"nom": "Attendre",
				"nombreDeFrames": 66
			},
			{
				"nom": "ModifierOptionsMessages",
				"position": "bas",
				"masquer": true
			},
			{
				"nom": "Message",
				"texte": ""
			},
			{
				"nom": "DeplacerImage",
				"numero": 11,
				"nombreDeFrames": 66,
				"centre": false,
				"variables": false,
				"x": 0,
				"y": 0,
				"zoomX": 100,
				"zoomY": 100,
				"opacite": 0,
				"modeDeFusion": "normal"
			},
			{
				"nom": "Attendre",
				"nombreDeFrames": 66
			},
			{
				"nom": "AfficherImage",
				"numero": 11,
				"nomImage": "demofin2",
				"centre": false,
				"variables": false,
				"x": 0,
				"y": 0,
				"zoomX": 100,
				"zoomY": 100,
				"opacite": 0,
				"modeDeFusion": "normal"
			},
			{
				"nom": "DeplacerImage",
				"numero": 11,
				"nombreDeFrames": 66,
				"centre": false,
				"variables": false,
				"x": 0,
				"y": 0,
				"zoomX": 100,
				"zoomY": 100,
				"opacite": 255,
				"modeDeFusion": "normal"
			},
			{
				"nom": "Attendre",
				"nombreDeFrames": 66
			},
			{
				"nom": "Message",
				"texte": ""
			},
			{
				"nom": "DeplacerImage",
				"numero": 11,
				"nombreDeFrames": 66,
				"centre": false,
				"variables": false,
				"x": 0,
				"y": 0,
				"zoomX": 100,
				"zoomY": 100,
				"opacite": 0,
				"modeDeFusion": "normal"
			},
			{
				"nom": "Attendre",
				"nombreDeFrames": 66
			},
			{
				"nom": "AfficherImage",
				"numero": 11,
				"nomImage": "demofin3",
				"centre": false,
				"variables": false,
				"x": 0,
				"y": 0,
				"zoomX": 100,
				"zoomY": 100,
				"opacite": 0,
				"modeDeFusion": "normal"
			},
			{
				"nom": "DeplacerImage",
				"numero": 11,
				"nombreDeFrames": 66,
				"centre": false,
				"variables": false,
				"x": 0,
				"y": 0,
				"zoomX": 100,
				"zoomY": 100,
				"opacite": 255,
				"modeDeFusion": "normal"
			},
			{
				"nom": "Attendre",
				"nombreDeFrames": 66
			},
			{
				"nom": "Message",
				"texte": ""
			},
			{
				"nom": "ArreterMusique",
				"nombreDeFrames": 150
			},
			{
				"nom": "DeplacerImage",
				"numero": 11,
				"nombreDeFrames": 66,
				"centre": false,
				"variables": false,
				"x": 0,
				"y": 0,
				"zoomX": 100,
				"zoomY": 100,
				"opacite": 0,
				"modeDeFusion": "normal"
			},
			{
				"nom": "Attendre",
				"nombreDeFrames": 100
			},
			{
				"nom": "ModifierInterrupteur",
				"numeroInterrupteur": 12,
				"valeur": false
			},
			{
				"nom": "OuvrirMenu",
				"nomMenu": "GameOver"
			},
			{
				"nom": "ModifierInterrupteur",
				"numeroInterrupteur": 12,
				"valeur": false
			}
			],
			"vitesse": "moderee",
			"frequence": "basse",
			"animeEnMouvement": true,
			"animeALArret": false,
			"directionFixe": false,
			"traversable": false,
			"auDessusDeTout": false
		}
		]
	}
	]
}
