{
	"nom": "Maison 1",
	"tileset": "Maison",
	"largeur": 21,
	"hauteur": 15,
	"musique": {
		"nomFichierSonore": "Maison.ogg",
		"volume": 1.00,
		"tempo": 1.00
	},
	"fondSonore": {
		"nomFichierSonore": "013-Fire01.ogg",
		"volume": 0.80,
		"tempo": 1.00
	},
	"couche0": [
	[0017,0017,0017,0017,0017,0017,0017,0017,0017,0017,0017,0017,0017,0017,0017,0017,0017,0017,0017,0017,0017],
	[0017,0017,0017,0017,0017,0017,0017,0017,0017,0017,0017,0017,0017,0017,0017,0017,0017,0017,0017,0017,0017],
	[0017,0017,0017,0017,0017,0017,0145,0146,0147,0148,0148,0148,0149,0150,0151,0017,0017,0017,0017,0017,0017],
	[0017,0017,0017,0017,0017,0152,0153,0154,0155,0156,0156,0156,0157,0158,0159,0224,0017,0017,0017,0017,0017],
	[0017,0017,0017,0017,0017,0160,0144,0162,0163,0164,0164,0164,0165,0166,0167,0232,0017,0017,0017,0017,0017],
	[0017,0017,0017,0017,0017,0168,0169,0170,0171,0172,0172,0172,0173,0174,0175,0240,0017,0017,0017,0017,0017],
	[0017,0017,0017,0017,0017,0176,0177,0178,0179,0180,0180,0180,0181,0182,0183,0248,0017,0017,0017,0017,0017],
	[0017,0017,0017,0017,0017,0176,0177,0178,0179,0180,0180,0180,0181,0182,0183,0248,0017,0017,0017,0017,0017],
	[0017,0017,0017,0017,0017,0176,0177,0178,0179,0180,0180,0180,0181,0182,0183,0248,0017,0017,0017,0017,0017],
	[0017,0017,0017,0017,0017,0184,0185,0186,0187,0188,0188,0188,0189,0190,0191,0256,0017,0017,0017,0017,0017],
	[0017,0017,0017,0017,0017,0192,0193,0194,0195,0196,0188,0188,0197,0198,0199,0264,0017,0017,0017,0017,0017],
	[0017,0017,0017,0017,0017,0200,0201,0208,0203,0204,0204,0204,0205,0206,0207,0272,0017,0017,0017,0017,0017],
	[0017,0017,0017,0017,0017,0017,0209,0210,0211,0212,0236,0212,0213,0214,0215,0017,0017,0017,0017,0017,0017],
	[0017,0017,0017,0017,0017,0017,0017,0017,0017,0017,0017,0017,0017,0017,0017,0017,0017,0017,0017,0017,0017],
	[0017,0017,0017,0017,0017,0017,0017,0017,0017,0017,0017,0017,0017,0017,0017,0017,0017,0017,0017,0017,0017]
	],
	"couche1": [
	[-001,-001,-001,-001,-001,-001,-001,-001,-001,-001,-001,-001,-001,-001,-001,-001,-001,-001,-001,-001,-001],
	[-001,-001,-001,-001,-001,-001,-001,-001,-001,-001,-001,-001,-001,-001,-001,-001,-001,-001,-001,-001,-001],
	[-001,-001,-001,-001,-001,-001,-001,-001,-001,0070,0003,0004,-001,-001,-001,-001,-001,-001,-001,-001,-001],
	[-001,-001,-001,-001,-001,-001,-001,-001,-001,0078,0011,0012,-001,-001,-001,-001,-001,-001,-001,-001,-001],
	[-001,-001,-001,-001,-001,-001,-001,-001,-001,-001,0019,0020,0030,0031,-001,-001,-001,-001,-001,-001,-001],
	[-001,-001,-001,-001,-001,-001,-001,-001,-001,-001,-001,-001,0038,0039,-001,-001,-001,-001,-001,-001,-001],
	[-001,-001,-001,-001,-001,-001,-001,-001,-001,-001,-001,-001,0046,0047,-001,-001,-001,-001,-001,-001,-001],
	[-001,-001,-001,-001,-001,-001,-001,0005,0006,0007,-001,-001,-001,-001,-001,-001,-001,-001,-001,-001,-001],
	[-001,-001,-001,-001,-001,-001,-001,0013,0014,0015,-001,-001,-001,-001,-001,-001,-001,-001,-001,-001,-001],
	[-001,-001,-001,-001,-001,-001,-001,0002,-001,-001,-001,-001,-001,-001,-001,-001,-001,-001,-001,-001,-001],
	[-001,-001,-001,-001,-001,-001,-001,-001,-001,-001,-001,-001,-001,-001,-001,-001,-001,-001,-001,-001,-001],
	[-001,-001,-001,-001,-001,-001,-001,-001,-001,0219,0220,0221,-001,-001,-001,-001,-001,-001,-001,-001,-001],
	[-001,-001,-001,-001,-001,-001,-001,-001,-001,0227,0228,0229,-001,-001,-001,-001,-001,-001,-001,-001,-001],
	[-001,-001,-001,-001,-001,-001,-001,-001,-001,-001,-001,-001,-001,-001,-001,-001,-001,-001,-001,-001,-001],
	[-001,-001,-001,-001,-001,-001,-001,-001,-001,-001,-001,-001,-001,-001,-001,-001,-001,-001,-001,-001,-001]
	],
	"couche2": [
	[-001,-001,-001,-001,-001,-001,-001,-001,-001,-001,-001,-001,-001,-001,-001,-001,-001,-001,-001,-001,-001],
	[-001,-001,-001,-001,-001,-001,-001,-001,-001,-001,-001,-001,-001,-001,-001,-001,-001,-001,-001,-001,-001],
	[-001,-001,-001,-001,-001,-001,-001,-001,-001,-001,-001,-001,-001,-001,-001,-001,-001,-001,-001,-001,-001],
	[-001,-001,-001,-001,-001,-001,-001,-001,-001,-001,-001,-001,-001,-001,-001,-001,-001,-001,-001,-001,-001],
	[-001,-001,-001,-001,-001,-001,-001,-001,-001,-001,-001,-001,-001,-001,-001,-001,-001,-001,-001,-001,-001],
	[-001,-001,-001,-001,-001,-001,-001,-001,-001,-001,-001,-001,-001,-001,-001,-001,-001,-001,-001,-001,-001],
	[-001,-001,-001,-001,-001,-001,-001,-001,-001,-001,-001,-001,-001,-001,-001,-001,-001,-001,-001,-001,-001],
	[-001,-001,-001,-001,-001,-001,-001,-001,-001,-001,-001,-001,-001,-001,-001,-001,-001,-001,-001,-001,-001],
	[-001,-001,-001,-001,-001,-001,-001,-001,-001,-001,-001,-001,-001,-001,-001,-001,-001,-001,-001,-001,-001],
	[-001,-001,-001,-001,-001,-001,-001,-001,-001,-001,-001,-001,-001,-001,-001,-001,-001,-001,-001,-001,-001],
	[-001,-001,-001,-001,-001,-001,-001,-001,-001,-001,-001,-001,-001,-001,-001,-001,-001,-001,-001,-001,-001],
	[-001,-001,-001,-001,-001,-001,-001,-001,-001,-001,-001,-001,-001,-001,-001,-001,-001,-001,-001,-001,-001],
	[-001,-001,-001,-001,-001,-001,-001,-001,-001,-001,-001,-001,-001,-001,-001,-001,-001,-001,-001,-001,-001],
	[-001,-001,-001,-001,-001,-001,-001,-001,-001,-001,-001,-001,-001,-001,-001,-001,-001,-001,-001,-001,-001],
	[-001,-001,-001,-001,-001,-001,-001,-001,-001,-001,-001,-001,-001,-001,-001,-001,-001,-001,-001,-001,-001]
	],
	"events": [
	{
		"id": 5,
		"nom": "Clone[341][004]",
		"x": 12,
		"y": 10
	},
	{
		"id": 6,
		"nom": "Clone[341][008]",
		"x": 13,
		"y": 7
	},
	{
		"id": 1,
		"nom": "Clone[341][039]",
		"x": 13,
		"y": 9
	},
	{
		"id": 7,
		"nom": "Colibri",
		"x": 8,
		"y": 9,
		"pages": [
		{
			"conditions": [
			{
				"nom": "Parler"
			}
			],
			"commandes": [
			{
				"nom": "ModifierInterrupteur",
				"numeroInterrupteur": 12,
				"valeur": true
			},
			{
				"nom": "AppelerPageCommune",
				"numeroPageCommune": 76
			},
			{
				"nom": "AppelerUnScript",
				"script": "$game_temp.faceset = \"colibri jaune\""
			},
			{
				"nom": "Message",
				"texte": "Saluzalu !"
			},
			{
				"nom": "ConditionGadgetPossede",
				"idGadget": 2,
				"numero": 0
			},
			{
				"nom": "Message",
				"texte": "Le \\c[2]roi Flivouille\\c[1] est le roi des \\c[2]Colibris\\c[1],\\nson palais est au Nord du village."
			},
			{
				"nom": "ConditionSinon",
				"numero": 0
			},
			{
				"nom": "Message",
				"texte": "On m'a dit qu'à la boutique de \\c[02]Mercator\\c[01]\\nil y avait une réduction sur les tubas."
			},
			{
				"nom": "ConditionFin",
				"numero": 0
			},
			{
				"nom": "Attendre",
				"nombreDeFrames": 8
			},
			{
				"nom": "ModifierInterrupteur",
				"numeroInterrupteur": 12,
				"valeur": false
			}
			],
			"deplacement": {
				"nom": "Deplacement",
				"ignorerLesMouvementsImpossibles": false,
				"repeterLeDeplacement": true,
				"attendreLaFinDuDeplacement": false,
				"mouvements": [
				{
					"nom": "RegarderUnEvent",
					"idEvent": 0
				}
				]
			},
			"image": "colibri jaune character",
			"directionInitiale": 2,
			"vitesse": "tres rapide",
			"frequence": "la plus haute",
			"animeEnMouvement": false,
			"animeALArret": true,
			"directionFixe": false,
			"traversable": false,
			"auDessusDeTout": false
		}
		]
	},
	{
		"id": 13,
		"nom": "Plante en pot",
		"x": 8,
		"y": 7,
		"pages": [
		{
			"conditions": [
			{
				"nom": "Parler"
			}
			],
			"commandes": [
			],
			"image": "plante en pot character",
			"directionInitiale": 3,
			"vitesse": "moderee",
			"frequence": "basse",
			"animeEnMouvement": false,
			"animeALArret": false,
			"directionFixe": true,
			"traversable": false,
			"auDessusDeTout": false
		}
		]
	},
	{
		"id": 2,
		"nom": "Clone[582][32]",
		"x": 7,
		"y": 7
	},
	{
		"id": 8,
		"nom": "Parchemin",
		"x": 9,
		"y": 3,
		"pages": [
		{
			"conditions": [
			{
				"nom": "Parler"
			}
			],
			"commandes": [
			{
				"nom": "ModifierInterrupteur",
				"numeroInterrupteur": 12,
				"valeur": true
			},
			{
				"nom": "Message",
				"texte": "\"Dans la chambre d'été,\\nle jardin et les montagnes entrent\\npar la fenêtre.\""
			},
			{
				"nom": "Message",
				"texte": "\\c[02]Matsuo Bashô\\c[02]"
			},
			{
				"nom": "Attendre",
				"nombreDeFrames": 8
			},
			{
				"nom": "ModifierInterrupteur",
				"numeroInterrupteur": 12,
				"valeur": false
			}
			],
			"vitesse": "moderee",
			"frequence": "basse",
			"animeEnMouvement": true,
			"animeALArret": false,
			"directionFixe": false,
			"traversable": false,
			"auDessusDeTout": false
		}
		]
	},
	{
		"id": 3,
		"nom": "Clone[341][004]",
		"x": 9,
		"y": 4
	},
	{
		"id": 9,
		"nom": "Clone[341][165]",
		"x": 10,
		"y": 8
	},
	{
		"id": 15,
		"nom": "EV015",
		"x": 10,
		"y": 11,
		"pages": [
		{
			"conditions": [
			{
				"nom": "ArriveeAuContact"
			}
			],
			"commandes": [
			{
				"nom": "ChangerDeMap",
				"variable": false,
				"numeroNouvelleMap": 143,
				"xDebutHeros": 21,
				"yDebutHeros": 15
			},
			{
				"nom": "EffacerImage",
				"numero": 3
			}
			],
			"vitesse": "moderee",
			"frequence": "basse",
			"animeEnMouvement": true,
			"animeALArret": false,
			"directionFixe": false,
			"traversable": false,
			"auDessusDeTout": false
		}
		]
	},
	{
		"id": 4,
		"nom": "Clone[341][004]",
		"x": 8,
		"y": 4
	}
	]
}
