{
	"nom": "Monsieur Spacudi",
	"tileset": "Monsieur Spacudi",
	"largeur": 20,
	"hauteur": 15,
	"fondSonore": {
		"nomFichierSonore": "RotS_eau.ogg",
		"volume": 1.00,
		"tempo": 1.00
	},
	"couche0": [
	[-008,-008,-008,-008,-008,-008,-008,-008,-008,-008,-008,-008,-008,-008,-008,-008,-008,-008,-008,-008],
	[-008,-008,-008,-008,-008,-008,-008,-008,-008,-008,-008,-008,-008,-008,-008,-008,-008,-008,-008,-008],
	[-008,-008,-008,-008,-008,-008,-008,-008,-008,-008,-008,-008,-008,-008,-008,-008,-008,-008,-008,-008],
	[-008,-008,-008,-008,-008,-008,-008,-008,-008,-008,-008,-008,-008,-008,-008,-008,-008,-008,-008,-008],
	[-008,-008,-008,-008,-008,-008,-008,-008,-008,-008,-008,-008,-008,-008,-008,-008,-008,-008,-008,-008],
	[-008,-008,-008,-008,-008,-008,-008,-008,-008,-008,-008,-008,-008,-008,-008,-008,-008,-008,-008,-008],
	[-008,-008,-008,-008,-008,-008,-008,-008,-008,-008,-008,-008,-008,-008,-008,-008,-008,-008,-008,-008],
	[-008,-008,-008,-008,-008,-008,-008,-008,-008,-008,-008,-008,-008,-008,-008,-008,-008,-008,-008,-008],
	[-008,-008,-008,-008,-008,-008,-008,-008,-008,-008,-008,-008,-008,-008,-008,-008,-008,-008,-008,-008],
	[-008,-008,-008,-008,-008,-008,-008,-008,-008,-008,-008,-008,-008,-008,-008,-008,-008,-008,-008,-008],
	[-008,-008,-008,-008,-008,-008,-008,-008,-008,-008,-008,-008,-008,-008,-008,-008,-008,-008,-008,-008],
	[-008,-008,-008,-008,-008,-008,-008,-008,-008,-008,-008,-008,-008,-008,-008,-008,-008,-008,-008,-008],
	[-008,-008,-008,-008,-008,-008,-008,-008,-008,-008,-008,-008,-008,-008,-008,-008,-008,-008,-008,-008],
	[-008,-008,-008,-008,-008,-008,-008,-008,-008,-008,-008,-008,-008,-008,-008,-008,-008,-008,-008,-008],
	[-008,-008,-008,-008,-008,-008,-008,-008,-008,-008,-008,-008,-008,-008,-008,-008,-008,-008,-008,-008]
	],
	"couche1": [
	[0095,0095,0095,0095,0095,0095,0095,0095,0095,0095,0095,0095,0095,0095,0095,0095,0095,0095,0095,0095],
	[0095,0095,0095,0095,0095,0095,0095,0095,0095,0095,0095,0095,0095,0095,0095,0095,0095,0095,0095,0095],
	[0095,0095,0095,0095,0095,0095,0000,0001,0002,0003,0004,0005,0006,0007,0088,0089,0090,0091,0092,0093],
	[0095,0095,0095,0095,0095,0095,0008,0009,0010,0011,0012,0013,0014,0015,0096,0097,0098,0099,0100,0101],
	[0095,0095,0095,0095,0095,0095,0016,0017,0018,0019,0020,0021,0022,0023,0104,0105,0106,0107,0108,0109],
	[0095,0095,0095,0095,0095,0095,0024,0025,0026,0027,0028,0029,0030,0031,0112,0113,0114,0115,0116,0117],
	[0095,0095,0095,0095,0095,0095,0032,0033,0034,0035,0036,0037,0038,0039,0120,0121,0122,0123,0124,0125],
	[0095,0095,0095,0095,0095,0095,0040,0041,0042,0043,0044,0045,0046,0047,0128,0129,0130,0131,0132,0133],
	[0095,0095,0095,0095,0095,0095,0048,0049,0050,0051,0052,0053,0054,0055,0136,0137,0138,0139,0140,0141],
	[0095,0095,0095,0095,0095,0095,0056,0057,0058,0059,0060,0061,0062,0063,0144,0145,0146,0147,0148,0149],
	[0095,0095,0095,0095,0095,0095,0064,0065,0066,0067,0068,0069,0070,0071,0152,0153,0154,0155,0156,0157],
	[0095,0095,0095,0095,0095,0095,0072,0073,0074,0075,0076,0077,0078,0079,0160,0161,0162,0163,0164,0165],
	[0095,0095,0095,0095,0095,0095,0080,0081,0082,0083,0084,0085,0086,0087,0168,0169,0170,0171,0172,0173],
	[0095,0095,0095,0095,0095,0095,0095,0095,0095,0095,0095,0095,0095,0095,0095,0095,0095,0095,0095,0095],
	[0095,0095,0095,0095,0095,0095,0095,0095,0095,0095,0095,0095,0095,0095,0095,0095,0095,0095,0095,0095]
	],
	"couche2": [
	[-001,-001,-001,-001,-001,-001,-001,-001,-001,-001,-001,-001,-001,-001,-001,-001,-001,-001,-001,-001],
	[-001,-001,-001,-001,-001,-001,-001,-001,-001,-001,-001,-001,-001,-001,-001,-001,-001,-001,-001,-001],
	[-001,-001,-001,-001,-001,-001,-001,-001,-001,-001,-001,-001,-001,-001,-001,-001,-001,-001,-001,-001],
	[-001,-001,-001,-001,-001,-001,-001,-001,-001,-001,-001,-001,-001,-001,-001,-001,-001,-001,-001,-001],
	[-001,-001,-001,-001,-001,-001,-001,-001,-001,-001,-001,-001,-001,-001,-001,-001,-001,-001,-001,-001],
	[-001,-001,-001,-001,-001,-001,-001,-001,-001,-001,-001,-001,-001,-001,-001,-001,-001,-001,-001,-001],
	[-001,-001,-001,-001,-001,-001,-001,-001,-001,-001,-001,-001,-001,-001,-001,-001,-001,-001,-001,-001],
	[-001,-001,-001,-001,-001,-001,-001,-001,-001,-001,-001,-001,-001,-001,-001,-001,-001,-001,-001,-001],
	[-001,-001,-001,-001,-001,-001,-001,-001,-001,-001,-001,-001,-001,-001,-001,-001,-001,-001,-001,-001],
	[-001,-001,-001,-001,-001,-001,-001,-001,-001,-001,-001,-001,-001,-001,-001,-001,-001,-001,-001,-001],
	[-001,-001,-001,-001,-001,-001,-001,-001,-001,-001,-001,-001,-001,-001,-001,-001,-001,-001,-001,-001],
	[-001,-001,-001,-001,-001,-001,-001,-001,-001,-001,-001,-001,-001,-001,-001,-001,-001,-001,-001,-001],
	[-001,-001,-001,-001,-001,-001,-001,-001,-001,-001,-001,-001,-001,-001,-001,-001,-001,-001,-001,-001],
	[-001,-001,-001,-001,-001,-001,-001,-001,-001,-001,-001,-001,-001,-001,-001,-001,-001,-001,-001,-001],
	[-001,-001,-001,-001,-001,-001,-001,-001,-001,-001,-001,-001,-001,-001,-001,-001,-001,-001,-001,-001]
	],
	"events": [
	{
		"id": 5,
		"nom": "Clone[582][37]",
		"x": 14,
		"y": 7
	},
	{
		"id": 6,
		"nom": "Clone[582][37]",
		"x": 17,
		"y": 8
	},
	{
		"id": 1,
		"nom": "Monsieur Spacudi",
		"x": 10,
		"y": 8,
		"pages": [
		{
			"conditions": [
			{
				"nom": "Parler"
			}
			],
			"commandes": [
			],
			"image": "spacudi character",
			"vitesse": "moderee",
			"frequence": "basse",
			"animeEnMouvement": false,
			"animeALArret": true,
			"directionFixe": false,
			"traversable": false,
			"auDessusDeTout": true
		}
		]
	},
	{
		"id": 7,
		"nom": "caustiques",
		"x": 17,
		"y": 3,
		"pages": [
		{
			"conditions": [
			],
			"commandes": [
			{
				"nom": "AppelerPageCommune",
				"numeroPageCommune": 133
			}
			],
			"vitesse": "moderee",
			"frequence": "basse",
			"animeEnMouvement": true,
			"animeALArret": false,
			"directionFixe": false,
			"traversable": false,
			"auDessusDeTout": false
		}
		]
	},
	{
		"id": 2,
		"nom": "EV002",
		"x": 12,
		"y": 8,
		"pages": [
		{
			"conditions": [
			{
				"nom": "Parler"
			}
			],
			"commandes": [
			{
				"nom": "Commentaire",
				"texte": "(en) Hi little guy."
			},
			{
				"nom": "Message",
				"texte": "Bonjour petit bonhomme."
			},
			{
				"nom": "Commentaire",
				"texte": "(en) I am \\c[02]mister Spacudi\\c[01]."
			},
			{
				"nom": "Message",
				"texte": "Je suis \\c[2]monsieur Spacudi\\c[1]."
			},
			{
				"nom": "ModifierAvancementQuete",
				"numero": 52,
				"avancement": "FAITE"
			},
			{
				"nom": "Commentaire",
				"texte": "(en) Don't stare at me like that!"
			},
			{
				"nom": "Message",
				"texte": "Ne me regarde pas comme ça !"
			},
			{
				"nom": "Commentaire",
				"texte": "(en) I'm only a walrus, but I can tell you \\nthat you just unlocked the second \\nartwork gallery in the bonus menu!"
			},
			{
				"nom": "Message",
				"texte": "Je ne suis qu'un morse, mais je peux te \\ndire que tu as débloqué la seconde galerie \\nd'artworks du jeu dans les bonus !"
			}
			],
			"image": 0,
			"opacite": 0,
			"vitesse": "moderee",
			"frequence": "basse",
			"animeEnMouvement": false,
			"animeALArret": false,
			"directionFixe": true,
			"traversable": false,
			"auDessusDeTout": false
		}
		]
	},
	{
		"id": 3,
		"nom": "EV003",
		"x": 19,
		"y": 8,
		"pages": [
		{
			"conditions": [
			{
				"nom": "ArriveeAuContact"
			}
			],
			"commandes": [
			{
				"nom": "EffacerImage",
				"numero": 9
			},
			{
				"nom": "ChangerDeMap",
				"variable": false,
				"numeroNouvelleMap": 14,
				"xDebutHeros": 1,
				"yDebutHeros": 11
			}
			],
			"vitesse": "moderee",
			"frequence": "basse",
			"animeEnMouvement": true,
			"animeALArret": false,
			"directionFixe": false,
			"traversable": false,
			"auDessusDeTout": false
		}
		]
	},
	{
		"id": 4,
		"nom": "EV004",
		"x": 16,
		"y": 3,
		"pages": [
		{
			"conditions": [
			],
			"commandes": [
			{
				"nom": "JouerEffetMusical",
				"nomFichierSonore": "Fanfare (paquerette).ogg",
				"volume": 1.00,
				"tempo": 1.00
			},
			{
				"nom": "ModifierAvancementQuete",
				"numero": 52,
				"avancement": "FAITE"
			},
			{
				"nom": "Attendre",
				"nombreDeFrames": 1
			},
			{
				"nom": "ModifierInterrupteurLocal",
				"numeroInterrupteurLocal": 0,
				"valeurADonner": true
			}
			],
			"vitesse": "moderee",
			"frequence": "basse",
			"animeEnMouvement": true,
			"animeALArret": false,
			"directionFixe": false,
			"traversable": false,
			"auDessusDeTout": false
		},
		{
			"conditions": [
			{
				"nom": "InterrupteurLocal",
				"numeroEvent": 4,
				"numeroInterrupteurLocal": 0,
				"valeurQuIlEstCenseAvoir": true
			}
			],
			"commandes": [
			{
				"nom": "SupprimerEvent"
			}
			],
			"vitesse": "moderee",
			"frequence": "basse",
			"animeEnMouvement": true,
			"animeALArret": false,
			"directionFixe": false,
			"traversable": false,
			"auDessusDeTout": false
		}
		]
	}
	]
}
