{
	"nom": "Salle 4 (statues)",
	"tileset": "Sanctuaire de Kaze",
	"largeur": 25,
	"hauteur": 30,
	"bgm": "",
	"bgs": "001-Wind01",
	"couche0": [
	[0002,0002,0002,0002,0002,0002,0002,0002,0002,0002,0002,0002,0002,0002,0002,0002,0002,0002,0002,0002,0002,0002,0002,0002,0002],
	[0002,0002,0002,0002,0002,0002,0002,0002,0002,0002,0002,0002,0002,0002,0002,0002,0002,0002,0002,0002,0002,0002,0002,0002,0002],
	[0002,0002,0002,0002,0002,0002,0002,0002,0002,0002,0002,0002,0002,0002,0002,0002,0002,0002,0002,0002,0002,0002,0002,0002,0002],
	[0002,0002,0002,0002,0002,0002,0002,0036,0037,0005,0004,0005,0038,0039,0002,0002,0002,0002,0002,0002,0002,0002,0002,0002,0002],
	[0002,0002,0002,0002,0002,0002,0002,0044,0045,0013,0012,0013,0046,0047,0002,0002,0002,0002,0002,0002,0002,0002,0002,0002,0002],
	[0002,0002,0002,0002,0002,0002,0002,0020,0021,-006,-006,-006,0006,0007,0002,0002,0002,0002,0002,0002,0002,0002,0002,0002,0002],
	[0002,0002,0002,0002,0002,0002,0002,0028,0029,-006,-006,-006,0014,0015,0002,0002,0002,0002,0002,0002,0002,0002,0002,0002,0002],
	[0002,0002,0002,0002,0002,0002,0002,0020,0021,-006,-006,-006,0144,0145,0005,0005,0004,0005,0004,0038,0039,0002,0002,0002,0002],
	[0002,0002,0002,0002,0002,0002,0002,0028,0029,-004,-006,-004,0152,0153,0013,0013,0012,0013,0012,0046,0047,0002,0002,0002,0002],
	[0002,0002,0002,0002,0002,0002,0002,0020,0021,-004,0001,0000,0001,0000,0001,0000,0001,0000,0001,0006,0007,0002,0002,0002,0002],
	[0002,0002,0002,0002,0002,0002,0002,0052,0053,0022,0023,0022,0130,0131,0009,0128,0129,0022,0023,0054,0055,0002,0002,0002,0002],
	[0002,0002,0002,0002,0002,0002,0002,0060,0061,0030,0031,0030,0138,0139,0001,0136,0137,0030,0031,0062,0063,0002,0002,0002,0002],
	[0002,0002,0002,0002,0002,0002,0002,0002,0036,0037,0004,0005,0146,0147,0009,0006,0007,0002,0002,0002,0002,0002,0002,0002,0002],
	[0002,0002,0002,0002,0002,0002,0002,0002,0044,0045,0012,0013,0154,0155,0001,0014,0015,0002,0002,0002,0002,0002,0002,0002,0002],
	[0002,0002,0002,0002,0002,0002,0002,0002,0020,0021,0009,0008,0009,0008,0009,0006,0007,0002,0002,0002,0002,0002,0002,0002,0002],
	[0002,0002,0002,0002,0002,0002,0002,0002,0052,0053,0130,0131,0001,0128,0129,0054,0055,0002,0002,0002,0002,0002,0002,0002,0002],
	[0002,0002,0002,0002,0002,0002,0002,0002,0060,0061,0138,0139,0009,0136,0137,0062,0063,0002,0002,0002,0002,0002,0002,0002,0002],
	[0002,0002,0002,0002,0002,0002,0002,0002,0036,0037,0146,0147,0001,0144,0145,0004,0038,0039,0002,0002,0002,0002,0002,0002,0002],
	[0002,0002,0002,0002,0002,0002,0002,0002,0044,0045,0154,0155,0009,0152,0153,0012,0046,0047,0002,0002,0002,0002,0002,0002,0002],
	[0002,0002,0002,0002,0002,0002,0002,0002,0020,0021,0001,0000,0001,0000,0001,0000,0006,0007,0002,0002,0002,0002,0002,0002,0002],
	[0002,0002,0002,0002,0002,0002,0002,0002,0052,0053,0022,0023,0022,0032,0033,0034,0054,0055,0002,0002,0002,0002,0002,0002,0002],
	[0002,0002,0002,0002,0002,0002,0002,0002,0060,0061,0030,0031,0030,0040,0041,0042,0062,0063,0002,0002,0002,0002,0002,0002,0002],
	[0002,0002,0002,0002,0002,0002,0002,0002,0002,0002,0002,0002,0002,-004,-004,-004,0002,0002,0002,0002,0002,0002,0002,0002,0002],
	[0002,0002,0002,0002,0002,0002,0002,0002,0002,0002,0002,0002,0002,0002,0002,0002,0002,0002,0002,0002,0002,0002,0002,0002,0002],
	[0002,0002,0002,0002,0002,0002,0002,0002,0002,0002,0002,0002,0002,0002,0002,0002,0002,0002,0002,0002,0002,0002,0002,0002,0002],
	[0002,0002,0002,0002,0002,0002,0002,0002,0002,0002,0002,0002,0002,0002,0002,0002,0002,0002,0002,0002,0002,0002,0002,0002,0002],
	[0002,0002,0002,0002,0002,0002,0002,0002,0002,0002,0002,0002,0002,0002,0002,0002,0002,0002,0002,0002,0002,0002,0002,0002,0002],
	[0002,0002,0002,0002,0002,0002,0002,0002,0002,0002,0002,0002,0002,0002,0002,0002,0002,0002,0002,0002,0002,0002,0002,0002,0002],
	[0002,0002,0002,0002,0002,0002,0002,0002,0002,0002,0002,0002,0002,0002,0002,0002,0002,0002,0002,0002,0002,0002,0002,0002,0002],
	[0002,0002,0002,0002,0002,0002,0002,0002,0002,0002,0002,0002,0002,0002,0002,0002,0002,0002,0002,0002,0002,0002,0002,0002,0002]
	],
	"couche1": [
	[-001,-001,-001,-001,-001,-001,-001,-001,-001,-001,-001,-001,-001,-001,-001,-001,-001,-001,-001,-001,-001,-001,-001,-001,-001],
	[-001,-001,-001,-001,-001,-001,-001,-001,-001,-001,-001,-001,-001,-001,-001,-001,-001,-001,-001,-001,-001,-001,-001,-001,-001],
	[-001,-001,-001,-001,-001,-001,-001,-001,-001,-001,-001,-001,-001,-001,-001,-001,-001,-001,-001,-001,-001,-001,-001,-001,-001],
	[-001,-001,-001,-001,-001,-001,-001,-001,-001,-001,-001,-001,-001,-001,-001,-001,-001,-001,-001,-001,-001,-001,-001,-001,-001],
	[-001,-001,-001,-001,-001,-001,-001,-001,-001,-001,-001,-001,-001,-001,-001,-001,-001,-001,-001,-001,-001,-001,-001,-001,-001],
	[-001,-001,-001,-001,-001,-001,-001,-001,-001,-001,0011,-001,-001,-001,-001,-001,-001,-001,-001,-001,-001,-001,-001,-001,-001],
	[-001,-001,-001,-001,-001,-001,-001,-001,-001,-001,-001,-001,-001,-001,-001,-001,-001,-001,-001,-001,-001,-001,-001,-001,-001],
	[-001,-001,-001,-001,-001,-001,-001,-001,-001,-001,-001,-001,-001,-001,-001,-001,-001,-001,-001,-001,-001,-001,-001,-001,-001],
	[-001,-001,-001,-001,-001,-001,-001,-001,-001,-001,-001,-001,-001,-001,-001,-001,-001,-001,-001,-001,-001,-001,-001,-001,-001],
	[-001,-001,-001,-001,-001,-001,-001,-001,-001,-001,-001,-001,-001,-001,-001,-001,-001,-001,-001,-001,-001,-001,-001,-001,-001],
	[-001,-001,-001,-001,-001,-001,-001,-001,-001,-001,-001,-001,-001,-001,-001,-001,-001,-001,-001,-001,-001,-001,-001,-001,-001],
	[-001,-001,-001,-001,-001,-001,-001,-001,-001,-001,-001,-001,-001,-001,-001,-001,-001,-001,-001,-001,-001,-001,-001,-001,-001],
	[-001,-001,-001,-001,-001,-001,-001,-001,-001,-001,-001,-001,-001,-001,-001,-001,-001,-001,-001,-001,-001,-001,-001,-001,-001],
	[-001,-001,-001,-001,-001,-001,-001,-001,-001,-001,-001,-001,-001,-001,-001,-001,-001,-001,-001,-001,-001,-001,-001,-001,-001],
	[-001,-001,-001,-001,-001,-001,-001,-001,-001,-001,-001,-001,-001,-001,-001,-001,-001,-001,-001,-001,-001,-001,-001,-001,-001],
	[-001,-001,-001,-001,-001,-001,-001,-001,-001,-001,-001,-001,-001,-001,-001,-001,-001,-001,-001,-001,-001,-001,-001,-001,-001],
	[-001,-001,-001,-001,-001,-001,-001,-001,-001,-001,-001,-001,-001,-001,-001,-001,-001,-001,-001,-001,-001,-001,-001,-001,-001],
	[-001,-001,-001,-001,-001,-001,-001,-001,-001,-001,-001,-001,-001,-001,-001,-001,-001,-001,-001,-001,-001,-001,-001,-001,-001],
	[-001,-001,-001,-001,-001,-001,-001,-001,-001,-001,-001,-001,-001,-001,-001,-001,-001,-001,-001,-001,-001,-001,-001,-001,-001],
	[-001,-001,-001,-001,-001,-001,-001,-001,-001,-001,-001,-001,-001,-001,-001,-001,-001,-001,-001,-001,-001,-001,-001,-001,-001],
	[-001,-001,-001,-001,-001,-001,-001,-001,-001,-001,-001,-001,-001,0088,0089,0090,-001,-001,-001,-001,-001,-001,-001,-001,-001],
	[-001,-001,-001,-001,-001,-001,-001,-001,-001,-001,-001,-001,-001,0096,0097,0098,-001,-001,-001,-001,-001,-001,-001,-001,-001],
	[-001,-001,-001,-001,-001,-001,-001,-001,-001,-001,-001,-001,-001,0232,0232,0232,-001,-001,-001,-001,-001,-001,-001,-001,-001],
	[-001,-001,-001,-001,-001,-001,-001,-001,-001,-001,-001,-001,-001,-001,-001,-001,-001,-001,-001,-001,-001,-001,-001,-001,-001],
	[-001,-001,-001,-001,-001,-001,-001,-001,-001,-001,-001,-001,-001,-001,-001,-001,-001,-001,-001,-001,-001,-001,-001,-001,-001],
	[-001,-001,-001,-001,-001,-001,-001,-001,-001,-001,-001,-001,-001,-001,-001,-001,-001,-001,-001,-001,-001,-001,-001,-001,-001],
	[-001,-001,-001,-001,-001,-001,-001,-001,-001,-001,-001,-001,-001,-001,-001,-001,-001,-001,-001,-001,-001,-001,-001,-001,-001],
	[-001,-001,-001,-001,-001,-001,-001,-001,-001,-001,-001,-001,-001,-001,-001,-001,-001,-001,-001,-001,-001,-001,-001,-001,-001],
	[-001,-001,-001,-001,-001,-001,-001,-001,-001,-001,-001,-001,-001,-001,-001,-001,-001,-001,-001,-001,-001,-001,-001,-001,-001],
	[-001,-001,-001,-001,-001,-001,-001,-001,-001,-001,-001,-001,-001,-001,-001,-001,-001,-001,-001,-001,-001,-001,-001,-001,-001]
	],
	"couche2": [
	[-001,-001,-001,-001,-001,-001,-001,-001,-001,-001,-001,-001,-001,-001,-001,-001,-001,-001,-001,-001,-001,-001,-001,-001,-001],
	[-001,-001,-001,-001,-001,-001,-001,-001,-001,-001,-001,-001,-001,-001,-001,-001,-001,-001,-001,-001,-001,-001,-001,-001,-001],
	[-001,-001,-001,-001,-001,-001,-001,-001,-001,-001,-001,-001,-001,-001,-001,-001,-001,-001,-001,-001,-001,-001,-001,-001,-001],
	[-001,-001,-001,-001,-001,-001,-001,-001,-001,-001,-001,-001,-001,-001,-001,-001,-001,-001,-001,-001,-001,-001,-001,-001,-001],
	[-001,-001,-001,-001,-001,-001,-001,-001,-001,-001,-001,-001,-001,-001,-001,-001,-001,-001,-001,-001,-001,-001,-001,-001,-001],
	[-001,-001,-001,-001,-001,-001,-001,-001,-001,-001,-001,-001,-001,-001,-001,-001,-001,-001,-001,-001,-001,-001,-001,-001,-001],
	[-001,-001,-001,-001,-001,-001,-001,-001,-001,-001,-001,-001,-001,-001,-001,-001,-001,-001,-001,-001,-001,-001,-001,-001,-001],
	[-001,-001,-001,-001,-001,-001,-001,-001,-001,-001,-001,-001,-001,-001,-001,-001,-001,-001,-001,-001,-001,-001,-001,-001,-001],
	[-001,-001,-001,-001,-001,-001,-001,-001,-001,-001,-001,-001,-001,-001,-001,-001,-001,-001,-001,-001,-001,-001,-001,-001,-001],
	[-001,-001,-001,-001,-001,-001,-001,-001,-001,-001,-001,-001,-001,-001,-001,-001,-001,-001,-001,-001,-001,-001,-001,-001,-001],
	[-001,-001,-001,-001,-001,-001,-001,-001,-001,-001,-001,-001,-001,-001,-001,-001,-001,-001,-001,-001,-001,-001,-001,-001,-001],
	[-001,-001,-001,-001,-001,-001,-001,-001,-001,-001,-001,-001,-001,-001,-001,-001,-001,-001,-001,-001,-001,-001,-001,-001,-001],
	[-001,-001,-001,-001,-001,-001,-001,-001,-001,-001,-001,-001,-001,-001,-001,-001,-001,-001,-001,-001,-001,-001,-001,-001,-001],
	[-001,-001,-001,-001,-001,-001,-001,-001,-001,-001,-001,-001,-001,-001,-001,-001,-001,-001,-001,-001,-001,-001,-001,-001,-001],
	[-001,-001,-001,-001,-001,-001,-001,-001,-001,-001,-001,-001,-001,-001,-001,-001,-001,-001,-001,-001,-001,-001,-001,-001,-001],
	[-001,-001,-001,-001,-001,-001,-001,-001,-001,-001,-001,-001,-001,-001,-001,-001,-001,-001,-001,-001,-001,-001,-001,-001,-001],
	[-001,-001,-001,-001,-001,-001,-001,-001,-001,-001,-001,-001,-001,-001,-001,-001,-001,-001,-001,-001,-001,-001,-001,-001,-001],
	[-001,-001,-001,-001,-001,-001,-001,-001,-001,-001,-001,-001,-001,-001,-001,-001,-001,-001,-001,-001,-001,-001,-001,-001,-001],
	[-001,-001,-001,-001,-001,-001,-001,-001,-001,-001,-001,-001,-001,-001,-001,-001,-001,-001,-001,-001,-001,-001,-001,-001,-001],
	[-001,-001,-001,-001,-001,-001,-001,-001,-001,-001,-001,-001,-001,-001,-001,-001,-001,-001,-001,-001,-001,-001,-001,-001,-001],
	[-001,-001,-001,-001,-001,-001,-001,-001,-001,-001,-001,-001,-001,-001,-001,-001,-001,-001,-001,-001,-001,-001,-001,-001,-001],
	[-001,-001,-001,-001,-001,-001,-001,-001,-001,-001,-001,-001,-001,-001,-001,-001,-001,-001,-001,-001,-001,-001,-001,-001,-001],
	[-001,-001,-001,-001,-001,-001,-001,-001,-001,-001,-001,-001,-001,-001,-001,-001,-001,-001,-001,-001,-001,-001,-001,-001,-001],
	[-001,-001,-001,-001,-001,-001,-001,-001,-001,-001,-001,-001,-001,-001,-001,-001,-001,-001,-001,-001,-001,-001,-001,-001,-001],
	[-001,-001,-001,-001,-001,-001,-001,-001,-001,-001,-001,-001,-001,-001,-001,-001,-001,-001,-001,-001,-001,-001,-001,-001,-001],
	[-001,-001,-001,-001,-001,-001,-001,-001,-001,-001,-001,-001,-001,-001,-001,-001,-001,-001,-001,-001,-001,-001,-001,-001,-001],
	[-001,-001,-001,-001,-001,-001,-001,-001,-001,-001,-001,-001,-001,-001,-001,-001,-001,-001,-001,-001,-001,-001,-001,-001,-001],
	[-001,-001,-001,-001,-001,-001,-001,-001,-001,-001,-001,-001,-001,-001,-001,-001,-001,-001,-001,-001,-001,-001,-001,-001,-001],
	[-001,-001,-001,-001,-001,-001,-001,-001,-001,-001,-001,-001,-001,-001,-001,-001,-001,-001,-001,-001,-001,-001,-001,-001,-001],
	[-001,-001,-001,-001,-001,-001,-001,-001,-001,-001,-001,-001,-001,-001,-001,-001,-001,-001,-001,-001,-001,-001,-001,-001,-001]
	],
	"events": [
	{
		"id": 5,
		"nom": "Blocage anti-évènement",
		"x": 10,
		"y": 8,
		"pages": [
		{
			"conditions": [
			{
				"name": "ConditionParler"
			}
			],
			"commandes": [
			],
			"directionInitiale": 2,
			"vitesse": 8,
			"frequence": 4,
			"animeEnMouvement": true,
			"animeALArret": false,
			"directionFixe": false,
			"traversable": false,
			"auDessusDeTout": false
		}
		]
	},
	{
		"id": 6,
		"nom": "Clone[341][023]",
		"x": 11,
		"y": 5
	},
	{
		"id": 1,
		"nom": "Clone[341][0021]",
		"x": 13,
		"y": 19
	},
	{
		"id": 7,
		"nom": "EV007",
		"x": 14,
		"y": 21,
		"pages": [
		{
			"conditions": [
			{
				"name": "ConditionArriveeAuContact"
			}
			],
			"commandes": [
			{
				"nom": "ChangerDeMap",
				"variable": false,
				"numeroNouvelleMap": 387,
				"xDebutHeros": 10,
				"yDebutHeros": 7
			}
			],
			"directionInitiale": 2,
			"vitesse": 8,
			"frequence": 4,
			"animeEnMouvement": true,
			"animeALArret": false,
			"directionFixe": false,
			"traversable": false,
			"auDessusDeTout": false
		}
		]
	},
	{
		"id": 2,
		"nom": "Clone[341][0021]",
		"x": 10,
		"y": 14
	},
	{
		"id": 8,
		"nom": "Clone[341][059]",
		"x": 9,
		"y": 5
	},
	{
		"id": 3,
		"nom": "Clone[341][0021]",
		"x": 14,
		"y": 14
	},
	{
		"id": 9,
		"nom": "Pancarte",
		"x": 10,
		"y": 5,
		"pages": [
		{
			"conditions": [
			{
				"name": "ConditionParler"
			}
			],
			"commandes": [
			{
				"nom": "ConditionDirection",
				"idEventConcerne": 0,
				"direction": 3,
				"numero": 0
			},
			{
				"nom": "ModifierInterrupteur",
				"numeroInterrupteur": 12,
				"valeur": true
			},
			{
				"nom": "Message",
				"texte": "N'hésitez pas à sonner la cloche de retour \\npour revenir au début du donjon."
			},
			{
				"nom": "ConditionSinon",
				"numero": 0
			},
			{
				"nom": "ConditionFin",
				"numero": 0
			},
			{
				"nom": "Deplacement",
				"ignorerLesMouvementsImpossibles": false,
				"repeterLeDeplacement": false,
				"attendreLaFinDuDeplacement": true,
				"mouvements": [
				{
					"nom": "Attendre",
					"nombreDeFrames": 5
				}
				]
			},
			{
				"nom": "ModifierInterrupteur",
				"numeroInterrupteur": 12,
				"valeur": false
			}
			],
			"directionInitiale": 2,
			"vitesse": 8,
			"frequence": 4,
			"animeEnMouvement": false,
			"animeALArret": false,
			"directionFixe": false,
			"traversable": false,
			"auDessusDeTout": false
		}
		]
	},
	{
		"id": 4,
		"nom": "Clone[341][0021]",
		"x": 10,
		"y": 9
	}
	]
}
