{
	"nom": "Grotte de l'arcade",
	"tileset": "Ventre",
	"largeur": 25,
	"hauteur": 20,
	"bgm": "",
	"bgs": "",
	"couche0": [
	[0809,0809,0809,0809,0809,0809,0809,0809,0809,0809,0809,0809,0809,0809,0809,0809,0809,0809,0809,0809,0809,0809,0809,0809,0809],
	[0809,0809,0809,0809,0809,0809,0809,0809,0809,0809,0809,0809,0809,0809,0809,0809,0809,0809,0809,0809,0809,0809,0809,0809,0809],
	[0809,0809,0809,0809,0809,0809,0809,0809,0809,0809,0809,0809,0809,0809,0809,0809,0809,0809,0809,0809,0809,0809,0809,0809,0809],
	[0809,0809,0809,0809,0809,0809,0809,0809,0809,0809,0809,0809,0809,0809,0809,0809,0809,0809,0809,0809,0809,0809,0809,0809,0809],
	[0809,0809,0809,0809,0809,0809,0809,0809,0809,0809,0809,0809,0809,0809,0809,0809,0809,0809,0809,0809,0809,0809,0809,0809,0809],
	[0800,0801,0801,0801,0801,0801,0801,0801,0801,0801,0801,0801,0801,0802,0809,0809,0809,0809,0809,0809,0809,0809,0809,0809,0809],
	[0808,0009,0011,0011,0011,0011,0011,0011,0011,0011,0011,0011,0022,0021,0801,0802,0809,0809,0809,0809,0809,0809,0809,0809,0809],
	[0808,0032,0009,0011,0011,0011,0011,0011,0011,0011,0022,0000,0021,0003,0022,0021,0801,0801,0801,0802,0809,0809,0809,0809,0809],
	[0017,0032,0032,-007,-007,-007,-007,-007,-007,-007,0021,0022,0000,0000,0021,0011,0011,0011,0022,0021,0802,0809,0809,0809,0809],
	[0011,0017,0032,-007,-007,-007,-007,-007,-007,-007,0000,0021,0011,0011,0011,0011,0022,0000,0021,0022,0810,0809,0809,0809,0809],
	[0011,0011,0017,-007,-007,-007,-007,-007,-007,-007,0000,0000,0000,0000,0008,0052,0021,0011,0022,0038,0810,0809,0809,0809,0809],
	[-007,-007,-007,-007,-007,-007,0053,0059,0059,0059,0059,0049,0000,0000,0000,0000,0000,0000,0038,0038,0810,0809,0809,0809,0809],
	[-007,-007,-007,-007,-007,-007,0038,0053,0059,0059,0049,0032,0000,0000,0000,0005,0000,0000,0038,0038,0810,0809,0809,0809,0809],
	[-007,-007,-007,-007,-007,-007,0038,0038,0053,0049,0032,0032,0000,0000,0000,0000,0000,0000,0038,0038,0810,0809,0809,0809,0809],
	[0059,0059,0059,0059,0059,0059,0061,0038,0810,0808,0032,0032,0000,0000,0000,0000,0000,0000,0038,0038,0810,0809,0809,0809,0809],
	[0059,0059,0059,0059,0059,0059,0059,0061,0810,0808,0032,0032,0000,0000,-007,-007,0000,0008,0038,0038,0810,0809,0809,0809,0809],
	[0817,0817,0817,0817,0817,0817,0817,0817,0818,0808,0032,0057,0059,0049,-007,-007,0053,0059,0061,0038,0810,0809,0809,0809,0809],
	[0809,0809,0809,0809,0809,0809,0809,0809,0809,0808,0057,0059,0049,0032,-007,-007,0038,0053,0059,0061,0810,0809,0809,0809,0809],
	[0809,0809,0809,0809,0809,0809,0809,0809,0809,0816,0817,0049,0032,0032,-007,-007,0038,0038,0053,0817,0818,0809,0809,0809,0809],
	[0809,0809,0809,0809,0809,0809,0809,0809,0809,0809,0809,0808,0032,0032,-007,-007,0038,0038,0810,0809,0809,0809,0809,0809,0809]
	],
	"couche1": [
	[-001,-001,-001,-001,-001,-001,-001,-001,-001,-001,-001,-001,-001,-001,-001,-001,-001,-001,-001,-001,-001,-001,-001,-001,-001],
	[-001,-001,-001,-001,-001,-001,-001,-001,-001,-001,-001,-001,-001,-001,-001,-001,-001,-001,-001,-001,-001,-001,-001,-001,-001],
	[-001,-001,-001,-001,-001,-001,-001,-001,-001,-001,-001,-001,-001,-001,-001,-001,-001,-001,-001,-001,-001,-001,-001,-001,-001],
	[-001,-001,-001,-001,-001,-001,-001,-001,-001,-001,-001,-001,-001,-001,-001,-001,-001,-001,-001,-001,-001,-001,-001,-001,-001],
	[-001,-001,-001,-001,-001,-001,-001,-001,-001,-001,-001,-001,-001,-001,-001,-001,-001,-001,-001,-001,-001,-001,-001,-001,-001],
	[-001,-001,-001,-001,-001,-001,-001,-001,-001,-001,-001,-001,-001,-001,-001,-001,-001,-001,-001,-001,-001,-001,-001,-001,-001],
	[-001,-001,-001,0248,0249,0250,-001,-001,-001,-001,-001,-001,-001,-001,-001,-001,-001,-001,-001,-001,-001,-001,-001,-001,-001],
	[-001,-001,-001,0256,0257,0258,-001,-001,-001,-001,-001,-001,-001,0004,-001,-001,-001,-001,-001,-001,-001,-001,-001,-001,-001],
	[-001,-001,-001,0264,0265,0266,-001,-001,-001,-001,-001,-001,-001,-001,-001,-001,-001,-001,-001,-001,-001,-001,-001,-001,-001],
	[-001,-001,-001,-001,-001,-001,-001,-001,-001,-001,-001,-001,-005,-001,-001,0044,-001,-001,-001,-001,-001,-001,-001,-001,-001],
	[-001,-001,-001,-001,-001,-001,-001,-001,-001,-001,-001,-001,-001,-001,-001,-001,-001,-001,-001,-001,-001,-001,-001,-001,-001],
	[-001,-001,-001,-001,-001,-001,-001,-001,-001,-001,-001,-001,-001,-001,-001,-001,-001,-001,-001,-001,-001,-001,-001,-001,-001],
	[-001,-001,-001,-001,-001,-001,-001,-001,-001,-001,-001,-001,-001,-001,-001,-001,-001,-001,-001,-001,-001,-001,-001,-001,-001],
	[-001,-001,-001,-001,-001,-001,-001,-001,-001,-001,-001,-001,-001,-001,-001,-001,-001,-001,-001,-001,-001,-001,-001,-001,-001],
	[-001,-001,-001,-001,-001,-001,-001,-001,-001,-001,-001,-001,-001,-001,-001,-001,-001,-001,-001,-001,-001,-001,-001,-001,-001],
	[-001,-001,-001,-001,-001,-001,-001,-001,-001,-001,-001,-001,-001,-001,-001,-001,-001,-001,-001,-001,-001,-001,-001,-001,-001],
	[-001,-001,-001,-001,-001,-001,-001,-001,-001,-001,-001,-001,-001,-001,-001,-001,-001,-001,-001,-001,-001,-001,-001,-001,-001],
	[-001,-001,-001,-001,-001,-001,-001,-001,-001,-001,-001,-001,-001,-001,-001,-001,-001,-001,-001,-001,-001,-001,-001,-001,-001],
	[-001,-001,-001,-001,-001,-001,-001,-001,-001,-001,-001,-001,-001,-001,-001,-001,-001,-001,-001,-001,-001,-001,-001,-001,-001],
	[-001,-001,-001,-001,-001,-001,-001,-001,-001,-001,-001,-001,-001,-001,-001,-001,-001,-001,-001,-001,-001,-001,-001,-001,-001]
	],
	"couche2": [
	[-001,-001,-001,-001,-001,-001,-001,-001,-001,-001,-001,-001,-001,-001,-001,-001,-001,-001,-001,-001,-001,-001,-001,-001,-001],
	[-001,-001,-001,-001,-001,-001,-001,-001,-001,-001,-001,-001,-001,-001,-001,-001,-001,-001,-001,-001,-001,-001,-001,-001,-001],
	[-001,-001,-001,-001,-001,-001,-001,-001,-001,-001,-001,-001,-001,-001,-001,-001,-001,-001,-001,-001,-001,-001,-001,-001,-001],
	[-001,-001,-001,-001,-001,-001,-001,-001,-001,-001,-001,-001,-001,-001,-001,-001,-001,-001,-001,-001,-001,-001,-001,-001,-001],
	[-001,-001,-001,-001,-001,-001,-001,-001,-001,-001,-001,-001,-001,-001,-001,-001,-001,-001,-001,-001,-001,-001,-001,-001,-001],
	[-001,-001,-001,-001,-001,-001,-001,-001,-001,-001,-001,-001,-001,-001,-001,-001,-001,-001,-001,-001,-001,-001,-001,-001,-001],
	[-001,-001,-001,-001,-001,-001,-001,-001,-001,-001,-001,-001,-001,-001,-001,-001,-001,-001,-001,-001,-001,-001,-001,-001,-001],
	[-001,-001,-001,-001,-001,-001,-001,-001,-001,-001,-001,-001,-001,-001,-001,-001,-001,-001,-001,-001,-001,-001,-001,-001,-001],
	[-001,-001,-001,-001,-001,-001,-001,-001,-001,-001,-001,-001,-001,-001,-001,-001,-001,-001,-001,-001,-001,-001,-001,-001,-001],
	[-001,-001,-001,-001,-001,-001,-001,-001,-001,-001,-001,-001,-001,-001,-001,-001,-001,-001,-001,-001,-001,-001,-001,-001,-001],
	[-001,-001,-001,-001,-001,-001,-001,-001,-001,-001,-001,-001,-001,-001,-001,-001,-001,-001,-001,-001,-001,-001,-001,-001,-001],
	[-001,-001,-001,-001,-001,-001,-001,-001,-001,-001,-001,-001,-001,-001,-001,-001,-001,-001,-001,-001,-001,-001,-001,-001,-001],
	[-001,-001,-001,-001,-001,-001,-001,-001,-001,-001,-001,-001,-001,-001,-001,-001,-001,-001,-001,-001,-001,-001,-001,-001,-001],
	[-001,-001,-001,-001,-001,-001,-001,-001,-001,-001,-001,-001,-001,-001,-001,-001,-001,-001,-001,-001,-001,-001,-001,-001,-001],
	[-001,-001,-001,-001,-001,-001,-001,-001,-001,-001,-001,-001,-001,-001,-001,-001,-001,-001,-001,-001,-001,-001,-001,-001,-001],
	[-001,-001,-001,-001,-001,-001,-001,-001,-001,-001,-001,-001,-001,-001,-001,-001,-001,-001,-001,-001,-001,-001,-001,-001,-001],
	[-001,-001,-001,-001,-001,-001,-001,-001,-001,-001,-001,-001,-001,-001,-001,-001,-001,-001,-001,-001,-001,-001,-001,-001,-001],
	[-001,-001,-001,-001,-001,-001,-001,-001,-001,-001,-001,-001,-001,-001,-001,-001,-001,-001,-001,-001,-001,-001,-001,-001,-001],
	[-001,-001,-001,-001,-001,-001,-001,-001,-001,-001,-001,-001,-001,-001,-001,-001,-001,-001,-001,-001,-001,-001,-001,-001,-001],
	[-001,-001,-001,-001,-001,-001,-001,-001,-001,-001,-001,-001,-001,-001,-001,-001,-001,-001,-001,-001,-001,-001,-001,-001,-001]
	],
	"events": [
	{
		"id": 16,
		"nom": "EV016",
		"x": 13,
		"y": 6,
		"pages": [
		{
			"conditions": [
			{
				"name": "ConditionParler"
			}
			],
			"commandes": [
			],
			"image": 21,
			"directionInitiale": 2,
			"vitesse": 8,
			"frequence": 4,
			"animeEnMouvement": false,
			"animeALArret": false,
			"directionFixe": true,
			"traversable": true,
			"auDessusDeTout": true
		}
		]
	},
	{
		"id": 5,
		"nom": "Clone[341][061]",
		"x": 8,
		"y": 8
	},
	{
		"id": 11,
		"nom": "EV011",
		"x": 15,
		"y": 19,
		"pages": [
		{
			"conditions": [
			{
				"name": "ConditionArriveeAuContact"
			}
			],
			"commandes": [
			{
				"nom": "ChangerDeMap",
				"variable": false,
				"numeroNouvelleMap": 321,
				"xDebutHeros": 10,
				"yDebutHeros": 1
			}
			],
			"directionInitiale": 2,
			"vitesse": 8,
			"frequence": 4,
			"animeEnMouvement": true,
			"animeALArret": false,
			"directionFixe": false,
			"traversable": false,
			"auDessusDeTout": false
		}
		]
	},
	{
		"id": 6,
		"nom": "Clone[341][061]",
		"x": 5,
		"y": 13
	},
	{
		"id": 1,
		"nom": "Arche",
		"x": 12,
		"y": 11,
		"pages": [
		{
			"conditions": [
			{
				"name": "ConditionParler"
			}
			],
			"commandes": [
			],
			"image": "arches kujira character",
			"directionInitiale": 2,
			"vitesse": 8,
			"frequence": 4,
			"animeEnMouvement": false,
			"animeALArret": false,
			"directionFixe": true,
			"traversable": true,
			"auDessusDeTout": true
		}
		]
	},
	{
		"id": 12,
		"nom": "Clone[341][030]",
		"x": 2,
		"y": 11
	},
	{
		"id": 7,
		"nom": "Clone[341][001]",
		"x": 17,
		"y": 11
	},
	{
		"id": 13,
		"nom": "Clone[341][030]",
		"x": 3,
		"y": 12
	},
	{
		"id": 2,
		"nom": "EV002",
		"x": 13,
		"y": 7,
		"pages": [
		{
			"conditions": [
			{
				"name": "ConditionArriveeAuContact"
			}
			],
			"commandes": [
			{
				"nom": "ChangerDeMap",
				"variable": false,
				"numeroNouvelleMap": 460,
				"xDebutHeros": 8,
				"yDebutHeros": 9
			}
			],
			"directionInitiale": 2,
			"vitesse": 8,
			"frequence": 4,
			"animeEnMouvement": true,
			"animeALArret": false,
			"directionFixe": false,
			"traversable": false,
			"auDessusDeTout": false
		}
		]
	},
	{
		"id": 8,
		"nom": "EV008",
		"x": 14,
		"y": 19,
		"pages": [
		{
			"conditions": [
			{
				"name": "ConditionArriveeAuContact"
			}
			],
			"commandes": [
			{
				"nom": "ChangerDeMap",
				"variable": false,
				"numeroNouvelleMap": 321,
				"xDebutHeros": 9,
				"yDebutHeros": 1
			}
			],
			"directionInitiale": 2,
			"vitesse": 8,
			"frequence": 4,
			"animeEnMouvement": true,
			"animeALArret": false,
			"directionFixe": false,
			"traversable": false,
			"auDessusDeTout": false
		}
		]
	},
	{
		"id": 3,
		"nom": "Clone[341][028]",
		"x": 3,
		"y": 9
	},
	{
		"id": 14,
		"nom": "Clone[341][030]",
		"x": 3,
		"y": 13
	},
	{
		"id": 9,
		"nom": "Clone[341][001]",
		"x": 12,
		"y": 15
	},
	{
		"id": 15,
		"nom": "Pancarte",
		"x": 15,
		"y": 12,
		"pages": [
		{
			"conditions": [
			{
				"name": "ConditionParler"
			}
			],
			"commandes": [
			{
				"nom": "ConditionDirection",
				"idEventConcerne": 0,
				"direction": 3,
				"numero": 0
			},
			{
				"nom": "ModifierInterrupteur",
				"numeroInterrupteur": 12,
				"valeur": true
			},
			{
				"nom": "Message",
				"texte": "< Désert\\nV Plaines aquatiques"
			},
			{
				"nom": "Deplacement",
				"ignorerLesMouvementsImpossibles": false,
				"repeterLeDeplacement": false,
				"attendreLaFinDuDeplacement": true,
				"mouvements": [
				{
					"nom": "Attendre",
					"nombreDeFrames": 5
				}
				]
			},
			{
				"nom": "ModifierInterrupteur",
				"numeroInterrupteur": 12,
				"valeur": false
			},
			{
				"nom": "ConditionFin",
				"numero": 0
			},
			{
				"nom": "ModifierInterrupteur",
				"numeroInterrupteur": 12,
				"valeur": false
			}
			],
			"directionInitiale": 2,
			"vitesse": 8,
			"frequence": 4,
			"animeEnMouvement": false,
			"animeALArret": false,
			"directionFixe": false,
			"traversable": false,
			"auDessusDeTout": false
		}
		]
	},
	{
		"id": 4,
		"nom": "Clone[341][028]",
		"x": 7,
		"y": 8
	},
	{
		"id": 10,
		"nom": "Clone[341][001]",
		"x": 12,
		"y": 14
	}
	]
}
