{
	"nom": "Machine à musique",
	"tileset": "Maison",
	"largeur": 25,
	"hauteur": 20,
	"musique": {
		"nomFichierSonore": "",
		"volume": 1.00,
		"tempo": 1.00
	},
	"fondSonore": {
		"nomFichierSonore": "001-Wind01.ogg",
		"volume": 0.00,
		"tempo": 1.00
	},
	"couche0": [
	[0017,0017,0017,0017,0017,0017,0017,0017,0017,0017,0017,0017,0017,0017,0017,0017,0017,0017,0017,0017,0017,0017,0017,0017,0017],
	[0017,0017,0017,0017,0017,0017,0017,0017,0017,0017,0017,0017,0017,0017,0017,0017,0017,0017,0017,0017,0017,0017,0017,0017,0017],
	[0017,0017,0017,0017,0017,0017,0017,0017,0017,0017,0017,0017,0017,0017,0017,0017,0017,0017,0017,0017,0017,0017,0017,0017,0017],
	[0017,0017,0017,0017,0017,0017,0017,0017,0017,0017,0017,0017,0017,0017,0017,0017,0017,0017,0017,0017,0017,0017,0017,0017,0017],
	[0017,0017,0017,0017,0017,0017,0017,0017,0017,0017,0017,0017,0017,0017,0017,0017,0017,0017,0017,0017,0017,0017,0017,0017,0017],
	[0017,0017,0017,0017,0017,0017,0017,0017,0017,0017,0017,0017,0017,0017,0017,0017,0017,0017,0017,0017,0017,0017,0017,0017,0017],
	[0017,0017,0017,0017,0017,0017,0017,0017,0017,0340,0341,0308,0309,0308,0342,0343,0017,0017,0017,0017,0017,0017,0017,0017,0017],
	[0017,0017,0017,0017,0017,0017,0017,0017,0017,0348,0349,0316,0317,0316,0350,0351,0017,0017,0017,0017,0017,0017,0017,0017,0017],
	[0017,0017,0017,0017,0017,0017,0017,0017,0017,0324,0325,-008,-008,-008,0310,0311,0017,0017,0017,0017,0017,0017,0017,0017,0017],
	[0017,0017,0017,0017,0017,0017,0017,0017,0017,0332,0333,-008,-008,-008,0318,0319,0017,0017,0017,0017,0017,0017,0017,0017,0017],
	[0017,0017,0017,0017,0017,0017,0017,0017,0017,0324,0325,-008,-008,-008,0310,0311,0017,0017,0017,0017,0017,0017,0017,0017,0017],
	[0017,0017,0017,0017,0017,0017,0017,0017,0017,0332,0333,0000,0000,0000,0318,0319,0017,0017,0017,0017,0017,0017,0017,0017,0017],
	[0017,0017,0017,0017,0017,0017,0017,0017,0017,0356,0357,0326,0103,0326,0358,0359,0017,0017,0017,0017,0017,0017,0017,0017,0017],
	[0017,0017,0017,0017,0017,0017,0017,0017,0017,0364,0365,0334,0393,0334,0366,0367,0017,0017,0017,0017,0017,0017,0017,0017,0017],
	[0017,0017,0017,0017,0017,0017,0017,0017,0017,0017,0017,0017,0017,0017,0017,0017,0017,0017,0017,0017,0017,0017,0017,0017,0017],
	[0017,0017,0017,0017,0017,0017,0017,0017,0017,0017,0017,0017,0017,0017,0017,0017,0017,0017,0017,0017,0017,0017,0017,0017,0017],
	[0017,0017,0017,0017,0017,0017,0017,0017,0017,0017,0017,0017,0017,0017,0017,0017,0017,0017,0017,0017,0017,0017,0017,0017,0017],
	[0017,0017,0017,0017,0017,0017,0017,0017,0017,0017,0017,0017,0017,0017,0017,0017,0017,0017,0017,0017,0017,0017,0017,0017,0017],
	[0017,0017,0017,0017,0017,0017,0017,0017,0017,0017,0017,0017,0017,0017,0017,0017,0017,0017,0017,0017,0017,0017,0017,0017,0017],
	[0017,0017,0017,0017,0017,0017,0017,0017,0017,0017,0017,0017,0017,0017,0017,0017,0017,0017,0017,0017,0017,0017,0017,0017,0017]
	],
	"couche1": [
	[-001,-001,-001,-001,-001,-001,-001,-001,-001,-001,-001,-001,-001,-001,-001,-001,-001,-001,-001,-001,-001,-001,-001,-001,-001],
	[-001,-001,-001,-001,-001,-001,-001,-001,-001,-001,-001,-001,-001,-001,-001,-001,-001,-001,-001,-001,-001,-001,-001,-001,-001],
	[-001,-001,-001,-001,-001,-001,-001,-001,-001,-001,-001,-001,-001,-001,-001,-001,-001,-001,-001,-001,-001,-001,-001,-001,-001],
	[-001,-001,-001,-001,-001,-001,-001,-001,-001,-001,-001,-001,-001,-001,-001,-001,-001,-001,-001,-001,-001,-001,-001,-001,-001],
	[-001,-001,-001,-001,-001,-001,-001,-001,-001,-001,-001,-001,-001,-001,-001,-001,-001,-001,-001,-001,-001,-001,-001,-001,-001],
	[-001,-001,-001,-001,-001,-001,-001,-001,-001,-001,-001,-001,-001,-001,-001,-001,-001,-001,-001,-001,-001,-001,-001,-001,-001],
	[-001,-001,-001,-001,-001,-001,-001,-001,-001,-001,-001,-001,-001,-001,-001,-001,-001,-001,-001,-001,-001,-001,-001,-001,-001],
	[-001,-001,-001,-001,-001,-001,-001,-001,-001,-001,-001,-001,-001,-001,-001,-001,-001,-001,-001,-001,-001,-001,-001,-001,-001],
	[-001,-001,-001,-001,-001,-001,-001,-001,-001,-001,-001,-001,-001,-001,-001,-001,-001,-001,-001,-001,-001,-001,-001,-001,-001],
	[-001,-001,-001,-001,-001,-001,-001,-001,-001,-001,-001,-001,-001,-001,-001,-001,-001,-001,-001,-001,-001,-001,-001,-001,-001],
	[-001,-001,-001,-001,-001,-001,-001,-001,-001,-001,-001,-001,-001,-001,-001,-001,-001,-001,-001,-001,-001,-001,-001,-001,-001],
	[-001,-001,-001,-001,-001,-001,-001,-001,-001,-001,-001,-001,-001,-001,-001,-001,-001,-001,-001,-001,-001,-001,-001,-001,-001],
	[-001,-001,-001,-001,-001,-001,-001,-001,-001,-001,-001,0384,0385,0386,-001,-001,-001,-001,-001,-001,-001,-001,-001,-001,-001],
	[-001,-001,-001,-001,-001,-001,-001,-001,-001,-001,-001,0392,0393,0394,-001,-001,-001,-001,-001,-001,-001,-001,-001,-001,-001],
	[-001,-001,-001,-001,-001,-001,-001,-001,-001,-001,-001,-001,-001,-001,-001,-001,-001,-001,-001,-001,-001,-001,-001,-001,-001],
	[-001,-001,-001,-001,-001,-001,-001,-001,-001,-001,-001,-001,-001,-001,-001,-001,-001,-001,-001,-001,-001,-001,-001,-001,-001],
	[-001,-001,-001,-001,-001,-001,-001,-001,-001,-001,-001,-001,-001,-001,-001,-001,-001,-001,-001,-001,-001,-001,-001,-001,-001],
	[-001,-001,-001,-001,-001,-001,-001,-001,-001,-001,-001,-001,-001,-001,-001,-001,-001,-001,-001,-001,-001,-001,-001,-001,-001],
	[-001,-001,-001,-001,-001,-001,-001,-001,-001,-001,-001,-001,-001,-001,-001,-001,-001,-001,-001,-001,-001,-001,-001,-001,-001],
	[-001,-001,-001,-001,-001,-001,-001,-001,-001,-001,-001,-001,-001,-001,-001,-001,-001,-001,-001,-001,-001,-001,-001,-001,-001]
	],
	"couche2": [
	[-001,-001,-001,-001,-001,-001,-001,-001,-001,-001,-001,-001,-001,-001,-001,-001,-001,-001,-001,-001,-001,-001,-001,-001,-001],
	[-001,-001,-001,-001,-001,-001,-001,-001,-001,-001,-001,-001,-001,-001,-001,-001,-001,-001,-001,-001,-001,-001,-001,-001,-001],
	[-001,-001,-001,-001,-001,-001,-001,-001,-001,-001,-001,-001,-001,-001,-001,-001,-001,-001,-001,-001,-001,-001,-001,-001,-001],
	[-001,-001,-001,-001,-001,-001,-001,-001,-001,-001,-001,-001,-001,-001,-001,-001,-001,-001,-001,-001,-001,-001,-001,-001,-001],
	[-001,-001,-001,-001,-001,-001,-001,-001,-001,-001,-001,-001,-001,-001,-001,-001,-001,-001,-001,-001,-001,-001,-001,-001,-001],
	[-001,-001,-001,-001,-001,-001,-001,-001,-001,-001,-001,-001,-001,-001,-001,-001,-001,-001,-001,-001,-001,-001,-001,-001,-001],
	[-001,-001,-001,-001,-001,-001,-001,-001,-001,-001,-001,-001,-001,-001,-001,-001,-001,-001,-001,-001,-001,-001,-001,-001,-001],
	[-001,-001,-001,-001,-001,-001,-001,-001,-001,-001,-001,-001,-001,-001,-001,-001,-001,-001,-001,-001,-001,-001,-001,-001,-001],
	[-001,-001,-001,-001,-001,-001,-001,-001,-001,-001,-001,-001,-001,-001,-001,-001,-001,-001,-001,-001,-001,-001,-001,-001,-001],
	[-001,-001,-001,-001,-001,-001,-001,-001,-001,-001,-001,-001,-001,-001,-001,-001,-001,-001,-001,-001,-001,-001,-001,-001,-001],
	[-001,-001,-001,-001,-001,-001,-001,-001,-001,-001,-001,-001,-001,-001,-001,-001,-001,-001,-001,-001,-001,-001,-001,-001,-001],
	[-001,-001,-001,-001,-001,-001,-001,-001,-001,-001,-001,-001,-001,-001,-001,-001,-001,-001,-001,-001,-001,-001,-001,-001,-001],
	[-001,-001,-001,-001,-001,-001,-001,-001,-001,-001,-001,-001,-001,-001,-001,-001,-001,-001,-001,-001,-001,-001,-001,-001,-001],
	[-001,-001,-001,-001,-001,-001,-001,-001,-001,-001,-001,-001,-001,-001,-001,-001,-001,-001,-001,-001,-001,-001,-001,-001,-001],
	[-001,-001,-001,-001,-001,-001,-001,-001,-001,-001,-001,-001,-001,-001,-001,-001,-001,-001,-001,-001,-001,-001,-001,-001,-001],
	[-001,-001,-001,-001,-001,-001,-001,-001,-001,-001,-001,-001,-001,-001,-001,-001,-001,-001,-001,-001,-001,-001,-001,-001,-001],
	[-001,-001,-001,-001,-001,-001,-001,-001,-001,-001,-001,-001,-001,-001,-001,-001,-001,-001,-001,-001,-001,-001,-001,-001,-001],
	[-001,-001,-001,-001,-001,-001,-001,-001,-001,-001,-001,-001,-001,-001,-001,-001,-001,-001,-001,-001,-001,-001,-001,-001,-001],
	[-001,-001,-001,-001,-001,-001,-001,-001,-001,-001,-001,-001,-001,-001,-001,-001,-001,-001,-001,-001,-001,-001,-001,-001,-001],
	[-001,-001,-001,-001,-001,-001,-001,-001,-001,-001,-001,-001,-001,-001,-001,-001,-001,-001,-001,-001,-001,-001,-001,-001,-001]
	],
	"events": [
	{
		"id": 1,
		"nom": "Machine à musique",
		"x": 12,
		"y": 8,
		"pages": [
		{
			"conditions": [
			{
				"nom": "Parler"
			}
			],
			"commandes": [
			{
				"nom": "ModifierInterrupteur",
				"numeroInterrupteur": 12,
				"valeur": true
			},
			{
				"nom": "Message",
				"texte": "Une machine sans doute mise au point par \\nle \\c[02]Maître de Musique\\c[01]..."
			},
			{
				"nom": "ModifierAvancementQuete",
				"numero": 54,
				"avancement": "FAITE"
			},
			{
				"nom": "Attendre",
				"nombreDeFrames": 8
			},
			{
				"nom": "ModifierInterrupteur",
				"numeroInterrupteur": 12,
				"valeur": false
			}
			],
			"image": "machine a musique character",
			"vitesse": 24,
			"frequence": 1,
			"animeEnMouvement": true,
			"animeALArret": true,
			"directionFixe": true,
			"traversable": false,
			"auDessusDeTout": false
		}
		]
	},
	{
		"id": 2,
		"nom": "EV002",
		"x": 17,
		"y": 8,
		"pages": [
		{
			"conditions": [
			],
			"commandes": [
			{
				"nom": "ConditionEtatQuete",
				"idQuete": 53,
				"etat": "CONNUE",
				"numero": 0
			},
			{
				"nom": "JouerEffetMusical",
				"nomFichierSonore": "Fanfare (paquerette).mid",
				"volume": 1.00,
				"tempo": 1.00
			},
			{
				"nom": "ModifierAvancementQuete",
				"numero": 54,
				"avancement": "FAITE"
			},
			{
				"nom": "ConditionSinon",
				"numero": 0
			},
			{
				"nom": "ConditionFin",
				"numero": 0
			},
			{
				"nom": "ModifierBrouillard",
				"opacite": 20,
				"modeDeFusion": "addition",
				"defilementX": 0,
				"defilementY": 0,
				"zoom": 200,
				"nuance": 0,
				"nomImage": "001-Fog01"
			},
			{
				"nom": "SupprimerEvent"
			}
			],
			"vitesse": 8,
			"frequence": 8,
			"animeEnMouvement": true,
			"animeALArret": false,
			"directionFixe": false,
			"traversable": false,
			"auDessusDeTout": false
		}
		]
	},
	{
		"id": 3,
		"nom": "EV003",
		"x": 12,
		"y": 13,
		"pages": [
		{
			"conditions": [
			{
				"nom": "ArriveeAuContact"
			}
			],
			"commandes": [
			{
				"nom": "ChangerDeMap",
				"variable": false,
				"numeroNouvelleMap": 153,
				"xDebutHeros": 21,
				"yDebutHeros": 14
			},
			{
				"nom": "EffacerImage",
				"numero": 3
			}
			],
			"vitesse": 8,
			"frequence": 8,
			"animeEnMouvement": false,
			"animeALArret": false,
			"directionFixe": false,
			"traversable": true,
			"auDessusDeTout": false
		}
		]
	}
	]
}
