{
	"nom": "Echelle",
	"tileset": "Sanctuaire de Kakeru",
	"largeur": 20,
	"hauteur": 15,
	"musique": {
		"nomFichierSonore": "Donjon 4.mid",
		"volume": 0.50,
		"tempo": 1.00
	},
	"fondSonore": {
		"nomFichierSonore": "",
		"volume": 0.80,
		"tempo": 1.00
	},
	"couche0": [
	[0232,0232,0232,0232,0232,0232,0232,0232,0232,0232,0232,0232,0232,0232,0232,0232,0232,0232,0232,0232],
	[0232,0232,0232,0232,0232,0232,0232,0232,0232,0232,0232,0232,0232,0232,0232,0232,0232,0232,0232,0232],
	[0232,0232,0232,0232,0232,0232,0232,0232,0232,0312,0232,0232,0232,0232,0232,0232,0232,0232,0232,0232],
	[0232,0232,0232,0232,0232,0232,0265,0266,0267,0268,0269,0270,0271,0232,0232,0232,0232,0232,0232,0232],
	[0232,0232,0232,0232,0232,0232,0273,0274,0275,0276,0277,0278,0279,0232,0232,0232,0232,0232,0232,0232],
	[0232,0232,0232,0232,0232,0232,0281,0282,0283,0284,0285,0286,0287,0232,0232,0232,0232,0232,0232,0232],
	[0232,0232,0232,0232,0232,0232,0289,0290,0291,0292,0293,0294,0295,0232,0232,0232,0232,0232,0232,0232],
	[0232,0232,0232,0232,0232,0232,0297,0298,0299,0300,0301,0302,0303,0232,0232,0232,0232,0232,0232,0232],
	[0232,0232,0232,0232,0232,0232,0305,0306,0307,0308,0309,0310,0311,0232,0232,0232,0232,0232,0232,0232],
	[0232,0232,0232,0232,0232,0232,0313,0314,0315,0316,0317,0318,0319,0232,0232,0232,0232,0232,0232,0232],
	[0232,0232,0232,0232,0232,0232,0232,0232,0232,0312,0232,0232,0232,0232,0232,0232,0232,0232,0232,0232],
	[0232,0232,0232,0232,0232,0232,0232,0232,0232,0232,0232,0232,0232,0232,0232,0232,0232,0232,0232,0232],
	[0232,0232,0232,0232,0232,0232,0232,0232,0232,0232,0232,0232,0232,0232,0232,0232,0232,0232,0232,0232],
	[0232,0232,0232,0232,0232,0232,0232,0232,0232,0232,0232,0232,0232,0232,0232,0232,0232,0232,0232,0232],
	[0232,0232,0232,0232,0232,0232,0232,0232,0232,0232,0232,0232,0232,0232,0232,0232,0232,0232,0232,0232]
	],
	"couche1": [
	[-001,-001,-001,-001,-001,-001,-001,-001,-001,-001,-001,-001,-001,-001,-001,-001,-001,-001,-001,-001],
	[-001,-001,-001,-001,-001,-001,-001,-001,-001,-001,-001,-001,-001,-001,-001,-001,-001,-001,-001,-001],
	[-001,-001,-001,-001,-001,-001,-001,-001,-001,-001,-001,-001,-001,-001,-001,-001,-001,-001,-001,-001],
	[-001,-001,-001,-001,-001,-001,-001,-001,-001,-005,-001,-001,-001,-001,-001,-001,-001,-001,-001,-001],
	[-001,-001,-001,-001,-001,-001,-001,-001,-001,-005,-001,-001,-001,-001,-001,-001,-001,-001,-001,-001],
	[-001,-001,-001,-001,-001,-001,-001,-001,-001,-005,-001,-001,-001,-001,-001,-001,-001,-001,-001,-001],
	[-001,-001,-001,-001,-001,-001,-001,-001,-001,-005,-001,-001,-001,-001,-001,-001,-001,-001,-001,-001],
	[-001,-001,-001,-001,-001,-001,-001,-001,-001,-005,-001,-001,-001,-001,-001,-001,-001,-001,-001,-001],
	[-001,-001,-001,-001,-001,-001,-001,-001,-001,-005,-001,-001,-001,-001,-001,-001,-001,-001,-001,-001],
	[-001,-001,-001,-001,-001,-001,-001,-001,-001,-005,-001,-001,-001,-001,-001,-001,-001,-001,-001,-001],
	[-001,-001,-001,-001,-001,-001,-001,-001,-001,-001,-001,-001,-001,-001,-001,-001,-001,-001,-001,-001],
	[-001,-001,-001,-001,-001,-001,-001,-001,-001,-001,-001,-001,-001,-001,-001,-001,-001,-001,-001,-001],
	[-001,-001,-001,-001,-001,-001,-001,-001,-001,-001,-001,-001,-001,-001,-001,-001,-001,-001,-001,-001],
	[-001,-001,-001,-001,-001,-001,-001,-001,-001,-001,-001,-001,-001,-001,-001,-001,-001,-001,-001,-001],
	[-001,-001,-001,-001,-001,-001,-001,-001,-001,-001,-001,-001,-001,-001,-001,-001,-001,-001,-001,-001]
	],
	"couche2": [
	[-001,-001,-001,-001,-001,-001,-001,-001,-001,-001,-001,-001,-001,-001,-001,-001,-001,-001,-001,-001],
	[-001,-001,-001,-001,-001,-001,-001,-001,-001,-001,-001,-001,-001,-001,-001,-001,-001,-001,-001,-001],
	[-001,-001,-001,-001,-001,-001,-001,-001,-001,-001,-001,-001,-001,-001,-001,-001,-001,-001,-001,-001],
	[-001,-001,-001,-001,-001,-001,-001,-001,-001,-001,-001,-001,-001,-001,-001,-001,-001,-001,-001,-001],
	[-001,-001,-001,-001,-001,-001,-001,-001,-001,-001,-001,-001,-001,-001,-001,-001,-001,-001,-001,-001],
	[-001,-001,-001,-001,-001,-001,-001,-001,-001,-001,-001,-001,-001,-001,-001,-001,-001,-001,-001,-001],
	[-001,-001,-001,-001,-001,-001,-001,-001,-001,-001,-001,-001,-001,-001,-001,-001,-001,-001,-001,-001],
	[-001,-001,-001,-001,-001,-001,-001,-001,-001,-001,-001,-001,-001,-001,-001,-001,-001,-001,-001,-001],
	[-001,-001,-001,-001,-001,-001,-001,-001,-001,-001,-001,-001,-001,-001,-001,-001,-001,-001,-001,-001],
	[-001,-001,-001,-001,-001,-001,-001,-001,-001,-001,-001,-001,-001,-001,-001,-001,-001,-001,-001,-001],
	[-001,-001,-001,-001,-001,-001,-001,-001,-001,-001,-001,-001,-001,-001,-001,-001,-001,-001,-001,-001],
	[-001,-001,-001,-001,-001,-001,-001,-001,-001,-001,-001,-001,-001,-001,-001,-001,-001,-001,-001,-001],
	[-001,-001,-001,-001,-001,-001,-001,-001,-001,-001,-001,-001,-001,-001,-001,-001,-001,-001,-001,-001],
	[-001,-001,-001,-001,-001,-001,-001,-001,-001,-001,-001,-001,-001,-001,-001,-001,-001,-001,-001,-001],
	[-001,-001,-001,-001,-001,-001,-001,-001,-001,-001,-001,-001,-001,-001,-001,-001,-001,-001,-001,-001]
	],
	"events": [
	{
		"id": 1,
		"nom": "EV001",
		"x": 9,
		"y": 10,
		"pages": [
		{
			"conditions": [
			{
				"nom": "ArriveeAuContact"
			}
			],
			"commandes": [
			{
				"nom": "ChangerDeMap",
				"variable": false,
				"numeroNouvelleMap": 422,
				"xDebutHeros": 19,
				"yDebutHeros": 11
			}
			],
			"image": 4,
			"opacite": 0,
			"vitesse": 8,
			"frequence": 8,
			"animeEnMouvement": false,
			"animeALArret": false,
			"directionFixe": true,
			"traversable": false,
			"auDessusDeTout": false
		}
		]
	},
	{
		"id": 2,
		"nom": "EV002",
		"x": 9,
		"y": 2,
		"pages": [
		{
			"conditions": [
			{
				"nom": "ArriveeAuContact"
			}
			],
			"commandes": [
			{
				"nom": "Deplacement",
				"idEventADeplacer": 0,
				"ignorerLesMouvementsImpossibles": false,
				"repeterLeDeplacement": false,
				"attendreLaFinDuDeplacement": false,
				"mouvements": [
				{
					"nom": "RendreAuDessusDeTout",
					"auDessusDeTout": true
				}
				]
			},
			{
				"nom": "ChangerDeMap",
				"variable": false,
				"numeroNouvelleMap": 429,
				"xDebutHeros": 14,
				"yDebutHeros": 12
			}
			],
			"image": 4,
			"opacite": 0,
			"vitesse": 8,
			"frequence": 8,
			"animeEnMouvement": false,
			"animeALArret": false,
			"directionFixe": true,
			"traversable": false,
			"auDessusDeTout": false
		}
		]
	},
	{
		"id": 3,
		"nom": "EV003",
		"x": 16,
		"y": 6,
		"pages": [
		{
			"conditions": [
			],
			"commandes": [
			{
				"nom": "ModifierVariable",
				"numeroVariable": 138,
				"operationAFaire": "rendre egal a",
				"valeurADonner": 1,
				"valeurADonner2": 999,
				"operationAFaire2": "nombre aleatoire"
			},
			{
				"nom": "Attendre",
				"nombreDeFrames": 1
			},
			{
				"nom": "ModifierVariable",
				"numeroVariable": 139,
				"operationAFaire": "rendre egal a",
				"valeurADonner": 1,
				"valeurADonner2": 999,
				"operationAFaire2": "nombre aleatoire"
			},
			{
				"nom": "Attendre",
				"nombreDeFrames": 1
			},
			{
				"nom": "ModifierInterrupteurLocal",
				"numeroInterrupteurLocal": 0,
				"valeurADonner": true
			}
			],
			"vitesse": 8,
			"frequence": 8,
			"animeEnMouvement": true,
			"animeALArret": false,
			"directionFixe": false,
			"traversable": false,
			"auDessusDeTout": false
		},
		{
			"conditions": [
			{
				"nom": "InterrupteurLocal",
				"numeroMap": 430,
				"numeroEvent": 3,
				"numeroInterrupteurLocal": 0,
				"valeurQuIlEstCenseAvoir": true
			}
			],
			"commandes": [
			{
				"nom": "SupprimerEvent"
			}
			],
			"vitesse": 8,
			"frequence": 8,
			"animeEnMouvement": true,
			"animeALArret": false,
			"directionFixe": false,
			"traversable": false,
			"auDessusDeTout": false
		}
		]
	},
	{
		"id": 4,
		"nom": "EV004",
		"x": 16,
		"y": 4,
		"pages": [
		{
			"conditions": [
			],
			"commandes": [
			{
				"nom": "Deplacement",
				"idEventADeplacer": 0,
				"ignorerLesMouvementsImpossibles": false,
				"repeterLeDeplacement": false,
				"attendreLaFinDuDeplacement": false,
				"mouvements": [
				{
					"nom": "RegarderDansUneDirection",
					"direction": 3
				},
				{
					"nom": "RendreDirectionFixe",
					"directionFixe": true
				}
				]
			},
			{
				"nom": "Attendre",
				"nombreDeFrames": 1
			}
			],
			"vitesse": 8,
			"frequence": 8,
			"animeEnMouvement": true,
			"animeALArret": false,
			"directionFixe": false,
			"traversable": false,
			"auDessusDeTout": false
		}
		]
	}
	]
}
