{
	"nom": "Vers les vikings rouges",
	"tileset": "Ventre",
	"largeur": 30,
	"hauteur": 30,
	"bgm": "Nouveaux Chemins",
	"bgs": "001-Wind01",
	"couche0": [
	[0728,0728,0728,0728,0728,0728,0728,0728,0728,0728,0728,0728,0728,0728,0728,0728,0728,0728,0728,0728,0728,0728,0728,0728,0728,0728,0728,0728,0728,0728],
	[0728,0728,0728,0728,0728,0728,0728,0728,0728,0728,0728,0728,0728,0728,0728,0728,0728,0728,0728,0728,0728,0728,0728,0728,0728,0728,0728,0728,0728,0728],
	[0728,0728,0728,0728,0728,0728,0728,0728,0728,0728,0728,0728,0728,0728,0728,0728,0728,0728,0728,0728,0728,0728,0728,0728,0728,0728,0728,0728,0728,0728],
	[0728,0728,0728,0728,0728,0728,0728,0728,0728,0728,0728,0728,0728,0728,0728,0728,0728,0728,0728,0728,0728,0728,0728,0728,0728,0728,0728,0728,0728,0728],
	[0728,0728,0728,0728,0728,0728,0728,0728,0728,0728,0728,0728,0728,0728,0728,0728,0728,0728,0728,0728,0728,0728,0728,0728,0728,0728,0728,0728,0728,0728],
	[0728,0728,0728,0728,0728,0728,0728,0800,0801,0801,0801,0801,0801,0801,0801,0801,0801,0801,0801,0801,0802,0728,0728,0728,0728,0728,0728,0728,0728,0728],
	[0728,0728,0728,0728,0728,0728,0728,0808,0000,0009,0011,0011,0011,0011,0011,0011,0011,0011,0011,0013,0021,0801,0802,0728,0728,0728,0728,0728,0728,0728],
	[0728,0728,0728,0728,0728,0728,0728,0808,0009,0017,0009,0011,0011,0011,0011,0011,0011,0011,0013,0021,0011,0022,0810,0728,0728,0728,0728,0728,0728,0728],
	[0728,0728,0728,0800,0801,0801,0801,0017,0024,0009,0017,0000,0008,0052,0000,0000,0000,0000,0021,0011,0022,0046,0810,0728,0728,0728,0728,0728,0728,0728],
	[0801,0801,0801,0017,0009,0011,0011,0011,0017,0032,0008,0000,0000,0000,0000,0000,0000,0000,0000,0000,0030,0046,0810,0728,0728,0728,0728,0728,0728,0728],
	[0011,0011,0011,0011,0017,0000,0000,0000,0000,0032,-002,-002,0000,0000,0000,-002,-002,0000,0000,0052,0038,0046,0810,0728,0728,0728,0728,0728,0728,0728],
	[-007,-007,-007,-007,-007,-007,-007,0000,0000,0032,-002,-002,-002,0000,-002,-002,-002,0000,0000,0008,0038,0046,0810,0728,0728,0728,0728,0728,0728,0728],
	[-007,-007,-007,-007,-007,-007,-007,0000,0000,0032,-002,-002,-002,0000,-002,-002,0000,0000,0000,0000,0046,0046,0021,0801,0801,0801,0801,0801,0801,0801],
	[0059,0059,0059,0059,0049,0000,0000,0000,0000,0025,-002,-002,-002,0000,0000,0000,0000,0000,0005,0000,0046,0021,0011,0011,0011,0011,0011,0011,0011,0011],
	[0817,0817,0817,0049,0057,0059,0059,0059,0049,0057,0059,0059,0059,0049,0000,0000,0000,0000,0000,0000,0021,0011,0011,0011,0011,0011,0011,0011,0011,0011],
	[0728,0728,0728,0816,0817,0817,0817,0049,0057,0059,0059,0059,0049,0032,0000,0000,0000,0000,0000,0000,0000,0000,0000,0000,0000,0000,0000,0000,0000,0000],
	[0728,0728,0728,0728,0728,0728,0728,0816,0817,0817,0817,0049,0032,0032,0052,0008,0000,0000,0000,0053,0059,0059,0059,0059,0059,0059,0059,0059,0059,0059],
	[0728,0728,0728,0728,0728,0728,0728,0728,0728,0728,0728,0808,0032,0057,0059,0059,0059,0059,0059,0061,0053,0059,0059,0059,0059,0059,0059,0059,0059,0059],
	[0728,0728,0728,0728,0728,0728,0728,0728,0728,0728,0728,0808,0057,0059,0059,0059,0059,0059,0059,0059,0061,0053,0817,0817,0817,0817,0817,0817,0817,0817],
	[0728,0728,0728,0728,0728,0728,0728,0728,0728,0728,0728,0816,0817,0817,0817,0817,0817,0817,0817,0817,0817,0818,0728,0728,0728,0728,0728,0728,0728,0728],
	[0728,0728,0728,0728,0728,0728,0728,0728,0728,0728,0728,0728,0728,0728,0728,0728,0728,0728,0728,0728,0728,0728,0728,0728,0728,0728,0728,0728,0728,0728],
	[0728,0728,0728,0728,0728,0728,0728,0728,0728,0728,0728,0728,0728,0728,0728,0728,0728,0728,0728,0728,0728,0728,0728,0728,0728,0728,0728,0728,0728,0728],
	[0728,0728,0728,0728,0728,0728,0728,0728,0728,0728,0728,0728,0728,0728,0728,0728,0728,0728,0728,0728,0728,0728,0728,0728,0728,0728,0728,0728,0728,0728],
	[0728,0728,0728,0728,0728,0728,0728,0728,0728,0728,0728,0728,0728,0728,0728,0728,0728,0728,0728,0728,0728,0728,0728,0728,0728,0728,0728,0728,0728,0728],
	[0728,0728,0728,0728,0728,0728,0728,0728,0728,0728,0728,0728,0728,0728,0728,0728,0728,0728,0728,0728,0728,0728,0728,0728,0728,0728,0728,0728,0728,0728],
	[0728,0728,0728,0728,0728,0728,0728,0728,0728,0728,0728,0728,0728,0728,0728,0728,0728,0728,0728,0728,0728,0728,0728,0728,0728,0728,0728,0728,0728,0728],
	[0728,0728,0728,0728,0728,0728,0728,0728,0728,0728,0728,0728,0728,0728,0728,0728,0728,0728,0728,0728,0728,0728,0728,0728,0728,0728,0728,0728,0728,0728],
	[0728,0728,0728,0728,0728,0728,0728,0728,0728,0728,0728,0728,0728,0728,0728,0728,0728,0728,0728,0728,0728,0728,0728,0728,0728,0728,0728,0728,0728,0728],
	[0728,0728,0728,0728,0728,0728,0728,0728,0728,0728,0728,0728,0728,0728,0728,0728,0728,0728,0728,0728,0728,0728,0728,0728,0728,0728,0728,0728,0728,0728],
	[0728,0728,0728,0728,0728,0728,0728,0728,0728,0728,0728,0728,0728,0728,0728,0728,0728,0728,0728,0728,0728,0728,0728,0728,0728,0728,0728,0728,0728,0728]
	],
	"couche1": [
	[-001,-001,-001,-001,-001,-001,-001,-001,-001,-001,-001,-001,-001,-001,-001,-001,-001,-001,-001,-001,-001,-001,-001,-001,-001,-001,-001,-001,-001,-001],
	[-001,-001,-001,-001,-001,-001,-001,-001,-001,-001,-001,-001,-001,-001,-001,-001,-001,-001,-001,-001,-001,-001,-001,-001,-001,-001,-001,-001,-001,-001],
	[-001,-001,-001,-001,-001,-001,-001,-001,-001,-001,-001,-001,-001,-001,-001,-001,-001,-001,-001,-001,-001,-001,-001,-001,-001,-001,-001,-001,-001,-001],
	[-001,-001,-001,-001,-001,-001,-001,-001,-001,-001,-001,-001,-001,-001,-001,-001,-001,-001,-001,-001,-001,-001,-001,-001,-001,-001,-001,-001,-001,-001],
	[-001,-001,-001,-001,-001,-001,-001,-001,-001,-001,-001,-001,-001,-001,-001,-001,-001,-001,-001,-001,-001,-001,-001,-001,-001,-001,-001,-001,-001,-001],
	[-001,-001,-001,-001,-001,-001,-001,-001,-001,-001,-001,-001,-001,-001,-001,-001,-001,-001,-001,-001,-001,-001,-001,-001,-001,-001,-001,-001,-001,-001],
	[-001,-001,-001,-001,-001,-001,-001,-001,-001,-001,-001,-001,-001,-001,-001,-001,-001,-001,-001,-001,-001,-001,-001,-001,-001,-001,-001,-001,-001,-001],
	[-001,-001,-001,-001,-001,-001,-001,-001,-001,-001,-001,-001,-001,0044,-001,-001,-001,-001,-001,-001,-001,-001,-001,-001,-001,-001,-001,-001,-001,-001],
	[-001,-001,-001,-001,-001,0248,0249,0250,-001,-001,-001,-001,-001,-001,-001,-001,-001,-001,-001,-001,-001,-001,-001,-001,-001,-001,-001,-001,-001,-001],
	[-001,-001,-001,-001,-001,0256,0257,0258,-001,-001,-001,-001,-001,-001,-001,-001,-001,-001,-001,0044,-001,-001,-001,-001,-001,-001,-001,-001,-001,-001],
	[-001,-001,-001,-001,-001,0264,0265,0266,-001,-001,-001,-001,-001,-001,-001,-001,-001,-001,-001,-001,-001,-001,-001,-001,-001,-001,-001,-001,-001,-001],
	[-001,-001,-001,-001,-001,-001,-001,-001,-001,-001,-001,-001,-001,-001,-001,-001,-001,-001,-001,-001,-001,-001,-001,-001,-001,-001,-001,-001,-001,-001],
	[-001,-001,-001,-001,-001,-001,-001,-001,-001,-001,-001,-001,-001,-001,-001,-001,-001,-001,-001,-001,-001,-001,-001,-001,-001,-001,-001,-001,-001,-001],
	[-001,-001,-001,-001,-001,-001,-001,-001,-001,-001,-001,-001,-001,-001,-001,-001,-001,-001,-001,-001,-001,-001,-001,-001,-001,-001,-001,-001,-001,-001],
	[-001,-001,-001,-001,-001,-001,-001,-001,-001,-001,-001,-001,-001,-001,-001,-001,-001,-001,-001,-001,-001,-001,-001,-001,-001,-001,-001,-001,-001,-001],
	[-001,-001,-001,-001,-001,-001,-001,-001,-001,-001,-001,-001,-001,-001,0044,-001,-001,-001,-001,-001,-001,-001,-001,-001,-001,-001,-001,-001,-001,-001],
	[-001,-001,-001,-001,-001,-001,-001,-001,-001,-001,-001,-001,-001,-001,-001,-001,-001,-001,-001,-001,-001,-001,-001,-001,-001,-001,-001,-001,-001,-001],
	[-001,-001,-001,-001,-001,-001,-001,-001,-001,-001,-001,-001,-001,-001,-001,-001,-001,-001,-001,-001,-001,-001,-001,-001,-001,-001,-001,-001,-001,-001],
	[-001,-001,-001,-001,-001,-001,-001,-001,-001,-001,-001,-001,-001,-001,-001,-001,-001,-001,-001,-001,-001,-001,-001,-001,-001,-001,-001,-001,-001,-001],
	[-001,-001,-001,-001,-001,-001,-001,-001,-001,-001,-001,-001,-001,-001,-001,-001,-001,-001,-001,-001,-001,-001,-001,-001,-001,-001,-001,-001,-001,-001],
	[-001,-001,-001,-001,-001,-001,-001,-001,-001,-001,-001,-001,-001,-001,-001,-001,-001,-001,-001,-001,-001,-001,-001,-001,-001,-001,-001,-001,-001,-001],
	[-001,-001,-001,-001,-001,-001,-001,-001,-001,-001,-001,-001,-001,-001,-001,-001,-001,-001,-001,-001,-001,-001,-001,-001,-001,-001,-001,-001,-001,-001],
	[-001,-001,-001,-001,-001,-001,-001,-001,-001,-001,-001,-001,-001,-001,-001,-001,-001,-001,-001,-001,-001,-001,-001,-001,-001,-001,-001,-001,-001,-001],
	[-001,-001,-001,-001,-001,-001,-001,-001,-001,-001,-001,-001,-001,-001,-001,-001,-001,-001,-001,-001,-001,-001,-001,-001,-001,-001,-001,-001,-001,-001],
	[-001,-001,-001,-001,-001,-001,-001,-001,-001,-001,-001,-001,-001,-001,-001,-001,-001,-001,-001,-001,-001,-001,-001,-001,-001,-001,-001,-001,-001,-001],
	[-001,-001,-001,-001,-001,-001,-001,-001,-001,-001,-001,-001,-001,-001,-001,-001,-001,-001,-001,-001,-001,-001,-001,-001,-001,-001,-001,-001,-001,-001],
	[-001,-001,-001,-001,-001,-001,-001,-001,-001,-001,-001,-001,-001,-001,-001,-001,-001,-001,-001,-001,-001,-001,-001,-001,-001,-001,-001,-001,-001,-001],
	[-001,-001,-001,-001,-001,-001,-001,-001,-001,-001,-001,-001,-001,-001,-001,-001,-001,-001,-001,-001,-001,-001,-001,-001,-001,-001,-001,-001,-001,-001],
	[-001,-001,-001,-001,-001,-001,-001,-001,-001,-001,-001,-001,-001,-001,-001,-001,-001,-001,-001,-001,-001,-001,-001,-001,-001,-001,-001,-001,-001,-001],
	[-001,-001,-001,-001,-001,-001,-001,-001,-001,-001,-001,-001,-001,-001,-001,-001,-001,-001,-001,-001,-001,-001,-001,-001,-001,-001,-001,-001,-001,-001]
	],
	"couche2": [
	[-001,-001,-001,-001,-001,-001,-001,-001,-001,-001,-001,-001,-001,-001,-001,-001,-001,-001,-001,-001,-001,-001,-001,-001,-001,-001,-001,-001,-001,-001],
	[-001,-001,-001,-001,-001,-001,-001,-001,-001,-001,-001,-001,-001,-001,-001,-001,-001,-001,-001,-001,-001,-001,-001,-001,-001,-001,-001,-001,-001,-001],
	[-001,-001,-001,-001,-001,-001,-001,-001,-001,-001,-001,-001,-001,-001,-001,-001,-001,-001,-001,-001,-001,-001,-001,-001,-001,-001,-001,-001,-001,-001],
	[-001,-001,-001,-001,-001,-001,-001,-001,-001,-001,-001,-001,-001,-001,-001,-001,-001,-001,-001,-001,-001,-001,-001,-001,-001,-001,-001,-001,-001,-001],
	[-001,-001,-001,-001,-001,-001,-001,-001,-001,-001,-001,-001,-001,-001,-001,-001,-001,-001,-001,-001,-001,-001,-001,-001,-001,-001,-001,-001,-001,-001],
	[-001,-001,-001,-001,-001,-001,-001,-001,-001,-001,-001,-001,-001,-001,-001,-001,-001,-001,-001,-001,-001,-001,-001,-001,-001,-001,-001,-001,-001,-001],
	[-001,-001,-001,-001,-001,-001,-001,-001,-001,-001,-001,-001,-001,-001,-001,-001,-001,-001,-001,-001,-001,-001,-001,-001,-001,-001,-001,-001,-001,-001],
	[-001,-001,-001,-001,-001,-001,-001,-001,-001,-001,-001,-001,-001,-001,-001,-001,-001,-001,-001,-001,-001,-001,-001,-001,-001,-001,-001,-001,-001,-001],
	[-001,-001,-001,-001,-001,-001,-001,-001,-001,-001,-001,-001,-001,-001,-001,-001,-001,-001,-001,-001,-001,-001,-001,-001,-001,-001,-001,-001,-001,-001],
	[-001,-001,-001,-001,-001,-001,-001,-001,-001,-001,-001,-001,-001,-001,-001,-001,-001,-001,-001,-001,-001,-001,-001,-001,-001,-001,-001,-001,-001,-001],
	[-001,-001,-001,-001,-001,-001,-001,-001,-001,-001,-001,-001,-001,-001,-001,-001,-001,-001,-001,-001,-001,-001,-001,-001,-001,-001,-001,-001,-001,-001],
	[-001,-001,-001,-001,-001,-001,-001,-001,-001,-001,-001,-001,-001,-001,-001,-001,-001,-001,-001,-001,-001,-001,-001,-001,-001,-001,-001,-001,-001,-001],
	[-001,-001,-001,-001,-001,-001,-001,-001,-001,-001,-001,-001,-001,-001,-001,-001,-001,-001,-001,-001,-001,-001,-001,-001,-001,-001,-001,-001,-001,-001],
	[-001,-001,-001,-001,-001,-001,-001,-001,-001,-001,-001,-001,-001,-001,-001,-001,-001,-001,-001,-001,-001,-001,-001,-001,-001,-001,-001,-001,-001,-001],
	[-001,-001,-001,-001,-001,-001,-001,-001,-001,-001,-001,-001,-001,-001,-001,-001,-001,-001,-001,-001,-001,-001,-001,-001,-001,-001,-001,-001,-001,-001],
	[-001,-001,-001,-001,-001,-001,-001,-001,-001,-001,-001,-001,-001,-001,-001,-001,-001,-001,-001,-001,-001,-001,-001,-001,-001,-001,-001,-001,-001,-001],
	[-001,-001,-001,-001,-001,-001,-001,-001,-001,-001,-001,-001,-001,-001,-001,-001,-001,-001,-001,-001,-001,-001,-001,-001,-001,-001,-001,-001,-001,-001],
	[-001,-001,-001,-001,-001,-001,-001,-001,-001,-001,-001,-001,-001,-001,-001,-001,-001,-001,-001,-001,-001,-001,-001,-001,-001,-001,-001,-001,-001,-001],
	[-001,-001,-001,-001,-001,-001,-001,-001,-001,-001,-001,-001,-001,-001,-001,-001,-001,-001,-001,-001,-001,-001,-001,-001,-001,-001,-001,-001,-001,-001],
	[-001,-001,-001,-001,-001,-001,-001,-001,-001,-001,-001,-001,-001,-001,-001,-001,-001,-001,-001,-001,-001,-001,-001,-001,-001,-001,-001,-001,-001,-001],
	[-001,-001,-001,-001,-001,-001,-001,-001,-001,-001,-001,-001,-001,-001,-001,-001,-001,-001,-001,-001,-001,-001,-001,-001,-001,-001,-001,-001,-001,-001],
	[-001,-001,-001,-001,-001,-001,-001,-001,-001,-001,-001,-001,-001,-001,-001,-001,-001,-001,-001,-001,-001,-001,-001,-001,-001,-001,-001,-001,-001,-001],
	[-001,-001,-001,-001,-001,-001,-001,-001,-001,-001,-001,-001,-001,-001,-001,-001,-001,-001,-001,-001,-001,-001,-001,-001,-001,-001,-001,-001,-001,-001],
	[-001,-001,-001,-001,-001,-001,-001,-001,-001,-001,-001,-001,-001,-001,-001,-001,-001,-001,-001,-001,-001,-001,-001,-001,-001,-001,-001,-001,-001,-001],
	[-001,-001,-001,-001,-001,-001,-001,-001,-001,-001,-001,-001,-001,-001,-001,-001,-001,-001,-001,-001,-001,-001,-001,-001,-001,-001,-001,-001,-001,-001],
	[-001,-001,-001,-001,-001,-001,-001,-001,-001,-001,-001,-001,-001,-001,-001,-001,-001,-001,-001,-001,-001,-001,-001,-001,-001,-001,-001,-001,-001,-001],
	[-001,-001,-001,-001,-001,-001,-001,-001,-001,-001,-001,-001,-001,-001,-001,-001,-001,-001,-001,-001,-001,-001,-001,-001,-001,-001,-001,-001,-001,-001],
	[-001,-001,-001,-001,-001,-001,-001,-001,-001,-001,-001,-001,-001,-001,-001,-001,-001,-001,-001,-001,-001,-001,-001,-001,-001,-001,-001,-001,-001,-001],
	[-001,-001,-001,-001,-001,-001,-001,-001,-001,-001,-001,-001,-001,-001,-001,-001,-001,-001,-001,-001,-001,-001,-001,-001,-001,-001,-001,-001,-001,-001],
	[-001,-001,-001,-001,-001,-001,-001,-001,-001,-001,-001,-001,-001,-001,-001,-001,-001,-001,-001,-001,-001,-001,-001,-001,-001,-001,-001,-001,-001,-001]
	],
	"events": [
	{
		"id": 5,
		"nom": "EV005",
		"x": 29,
		"y": 15,
		"pages": [
		{
			"conditions": [
			{
				"name": "ConditionArriveeAuContact"
			}
			],
			"commandes": [
			{
				"nom": "ChangerDeMap",
				"variable": false,
				"numeroNouvelleMap": 334,
				"xDebutHeros": 1,
				"yDebutHeros": 36
			}
			],
			"directionInitiale": 2,
			"vitesse": 8,
			"frequence": 4,
			"animeEnMouvement": true,
			"animeALArret": false,
			"directionFixe": false,
			"traversable": false,
			"auDessusDeTout": false
		}
		]
	},
	{
		"id": 11,
		"nom": "EV011",
		"x": 10,
		"y": 12,
		"pages": [
		{
			"conditions": [
			{
				"name": "ConditionParler"
			}
			],
			"commandes": [
			],
			"directionInitiale": 2,
			"vitesse": 8,
			"frequence": 4,
			"animeEnMouvement": true,
			"animeALArret": false,
			"directionFixe": false,
			"traversable": false,
			"auDessusDeTout": false
		}
		]
	},
	{
		"id": 6,
		"nom": "EV006",
		"x": 0,
		"y": 11,
		"pages": [
		{
			"conditions": [
			{
				"name": "ConditionArriveeAuContact"
			}
			],
			"commandes": [
			{
				"nom": "ChangerDeMap",
				"variable": false,
				"numeroNouvelleMap": 451,
				"xDebutHeros": 28,
				"yDebutHeros": 12
			}
			],
			"directionInitiale": 2,
			"vitesse": 8,
			"frequence": 4,
			"animeEnMouvement": true,
			"animeALArret": false,
			"directionFixe": false,
			"traversable": false,
			"auDessusDeTout": false
		}
		]
	},
	{
		"id": 12,
		"nom": "EV012",
		"x": 28,
		"y": 12,
		"pages": [
		{
			"conditions": [
			],
			"commandes": [
			{
				"nom": "ModifierVariable",
				"numeroVariable": 127,
				"operationAFaire": "rendre egal a",
				"valeurADonner": "2",
				"operationAFaire2": "valeur brute"
			},
			{
				"nom": "ModifierTonDeLEcran",
				"rouge": 127,
				"vert": 127,
				"bleu": 127,
				"gris": 0,
				"dureeTransition": 0
			},
			{
				"nom": "EffacerImage",
				"numero": 2
			},
			{
				"nom": "EffacerImage",
				"numero": 3
			},
			{
				"nom": "SupprimerEvent"
			}
			],
			"directionInitiale": 2,
			"vitesse": 8,
			"frequence": 4,
			"animeEnMouvement": true,
			"animeALArret": false,
			"directionFixe": false,
			"traversable": false,
			"auDessusDeTout": false
		}
		]
	},
	{
		"id": 1,
		"nom": "Clone[341][039]",
		"x": 7,
		"y": 11
	},
	{
		"id": 7,
		"nom": "EV007",
		"x": 0,
		"y": 12,
		"pages": [
		{
			"conditions": [
			{
				"name": "ConditionArriveeAuContact"
			}
			],
			"commandes": [
			{
				"nom": "ChangerDeMap",
				"variable": false,
				"numeroNouvelleMap": 451,
				"xDebutHeros": 28,
				"yDebutHeros": 13
			}
			],
			"directionInitiale": 2,
			"vitesse": 8,
			"frequence": 4,
			"animeEnMouvement": true,
			"animeALArret": false,
			"directionFixe": false,
			"traversable": false,
			"auDessusDeTout": false
		}
		]
	},
	{
		"id": 2,
		"nom": "Pancarte",
		"x": 18,
		"y": 13,
		"pages": [
		{
			"conditions": [
			{
				"name": "ConditionParler"
			}
			],
			"commandes": [
			{
				"nom": "ConditionDirection",
				"idEventConcerne": 0,
				"direction": 3,
				"numero": 0
			},
			{
				"nom": "ModifierInterrupteur",
				"numeroInterrupteur": 12,
				"valeur": true
			},
			{
				"nom": "Message",
				"texte": "> Forêt de l'Ouest"
			},
			{
				"nom": "Deplacement",
				"ignorerLesMouvementsImpossibles": false,
				"repeterLeDeplacement": false,
				"attendreLaFinDuDeplacement": true,
				"mouvements": [
				{
					"nom": "Attendre",
					"nombreDeFrames": 5
				}
				]
			},
			{
				"nom": "ConditionSinon",
				"numero": 0
			},
			{
				"nom": "ConditionFin",
				"numero": 0
			},
			{
				"nom": "ModifierInterrupteur",
				"numeroInterrupteur": 12,
				"valeur": false
			}
			],
			"directionInitiale": 2,
			"vitesse": 8,
			"frequence": 4,
			"animeEnMouvement": false,
			"animeALArret": false,
			"directionFixe": false,
			"traversable": false,
			"auDessusDeTout": false
		}
		]
	},
	{
		"id": 8,
		"nom": "Clone[021][002]",
		"x": 14,
		"y": 9
	},
	{
		"id": 9,
		"nom": "Clone[021][002]",
		"x": 17,
		"y": 8
	},
	{
		"id": 10,
		"nom": "EV010",
		"x": 11,
		"y": 13,
		"pages": [
		{
			"conditions": [
			{
				"name": "ConditionParler"
			}
			],
			"commandes": [
			],
			"directionInitiale": 2,
			"vitesse": 8,
			"frequence": 4,
			"animeEnMouvement": true,
			"animeALArret": false,
			"directionFixe": false,
			"traversable": false,
			"auDessusDeTout": false
		}
		]
	}
	]
}
