{
	"nom": "coin bas droite",
	"tileset": "Sanctuaire de Jishin",
	"largeur": 21,
	"hauteur": 17,
	"bgm": "Donjon 5",
	"bgs": "001-Wind01",
	"couche0": [
	[0002,0002,0002,0002,0002,0002,0140,0141,0108,0109,0161,0108,0109,0142,0143,0002,0002,0002,0002,0002,0002],
	[0002,0002,0002,0002,0002,0002,0148,0149,0116,0117,0160,0116,0117,0150,0151,0002,0002,0002,0002,0002,0002],
	[0002,0002,0002,0002,0002,0002,0110,0111,0161,0160,0160,0160,0161,0132,0133,0002,0002,0002,0002,0002,0002],
	[0002,0002,0002,0002,0002,0002,0118,0119,0161,0160,0160,0160,0161,0124,0125,0002,0002,0002,0002,0002,0002],
	[0140,0141,0108,0109,0108,0109,0146,0147,0161,0161,0161,0161,0161,0132,0133,0002,0002,0002,0002,0002,0002],
	[0148,0149,0116,0117,0116,0117,0154,0155,0161,0161,0161,-007,-007,0124,0125,0002,0002,0002,0002,0002,0002],
	[0110,0111,0161,0161,0161,0161,0161,0161,0161,0161,0161,-007,0161,0132,0133,0002,0002,0002,0002,0002,0002],
	[0118,0119,0160,0160,0161,0161,0161,0161,0161,0161,0161,-007,0161,0124,0125,0002,0002,0002,0002,0002,0002],
	[0161,0160,0160,0160,0161,0161,0161,0161,0161,0161,0161,-007,0161,0132,0133,0002,0002,0002,0002,0002,0002],
	[0110,0111,0160,0160,0161,0161,0161,-007,-007,-007,-007,-007,0161,0124,0125,0002,0002,0002,0002,0002,0002],
	[0110,0111,0161,0161,0161,0161,0161,-007,0161,0161,0161,0161,0161,0132,0133,0002,0002,0002,0002,0002,0002],
	[0156,0157,0126,0127,0126,0127,0126,0127,0126,0127,0126,0127,0126,0158,0159,0002,0002,0002,0002,0002,0002],
	[0164,0165,0134,0135,0134,0135,0134,0135,0134,0135,0134,0135,0134,0166,0167,0002,0002,0002,0002,0002,0002],
	[0002,0002,0002,0002,0002,0002,0002,0002,0002,0002,0002,0002,0002,0002,0002,0002,0002,0002,0002,0002,0002],
	[0002,0002,0002,0002,0002,0002,0002,0002,0002,0002,0002,0002,0002,0002,0002,0002,0002,0002,0002,0002,0002],
	[0002,0002,0002,0002,0002,0002,0002,0002,0002,0002,0002,0002,0002,0002,0002,0002,0002,0002,0002,0002,0002],
	[0002,0002,0002,0002,0002,0002,0002,0002,0002,0002,0002,0002,0002,0002,0002,0002,0002,0002,0002,0002,0002]
	],
	"couche1": [
	[-001,-001,-001,-001,-001,-001,-001,-001,-001,0168,0169,0170,-001,-001,-001,-001,-001,-001,-001,-001,-001],
	[-001,-001,-001,-001,-001,-001,-001,-001,-001,0176,0177,0178,-001,-001,-001,-001,-001,-001,-001,-001,-001],
	[-001,-001,-001,-001,-001,-001,-001,-001,-001,-001,-001,-001,-001,-001,-001,-001,-001,-001,-001,-001,-001],
	[-001,-001,-001,-001,-001,-001,-001,-001,-001,-001,-001,-001,-001,-001,-001,-001,-001,-001,-001,-001,-001],
	[-001,-001,-001,-001,-001,-001,-001,-001,-001,-001,-001,-001,-001,-001,-001,-001,-001,-001,-001,-001,-001],
	[-001,-001,-001,-001,-001,-001,-001,-001,-001,-001,-001,-001,-001,-001,-001,-001,-001,-001,-001,-001,-001],
	[-001,-001,-001,-001,-001,-001,-001,-001,-001,-001,-001,-001,-001,-001,-001,-001,-001,-001,-001,-001,-001],
	[0200,0201,-001,-001,-001,-001,-001,-001,-001,-001,-001,-001,-001,-001,-001,-001,-001,-001,-001,-001,-001],
	[0208,0209,-001,-001,-001,-001,-001,-001,-001,-001,-001,-001,-001,-001,-001,-001,-001,-001,-001,-001,-001],
	[0216,0217,-001,-001,-001,-001,-001,-001,-001,-001,-001,-001,-001,-001,-001,-001,-001,-001,-001,-001,-001],
	[-001,-001,-001,-001,-001,-001,-001,-001,-001,-001,-001,-001,-001,-001,-001,-001,-001,-001,-001,-001,-001],
	[-001,-001,-001,-001,-001,-001,-001,-001,-001,-001,-001,-001,-001,-001,-001,-001,-001,-001,-001,-001,-001],
	[-001,-001,-001,-001,-001,-001,-001,-001,-001,-001,-001,-001,-001,-001,-001,-001,-001,-001,-001,-001,-001],
	[-001,-001,-001,-001,-001,-001,-001,-001,-001,-001,-001,-001,-001,-001,-001,-001,-001,-001,-001,-001,-001],
	[-001,-001,-001,-001,-001,-001,-001,-001,-001,-001,-001,-001,-001,-001,-001,-001,-001,-001,-001,-001,-001],
	[-001,-001,-001,-001,-001,-001,-001,-001,-001,-001,-001,-001,-001,-001,-001,-001,-001,-001,-001,-001,-001],
	[-001,-001,-001,-001,-001,-001,-001,-001,-001,-001,-001,-001,-001,-001,-001,-001,-001,-001,-001,-001,-001]
	],
	"couche2": [
	[-001,-001,-001,-001,-001,-001,-001,-001,-001,-001,-001,-001,-001,-001,-001,-001,-001,-001,-001,-001,-001],
	[-001,-001,-001,-001,-001,-001,-001,-001,-001,-001,-001,-001,-001,-001,-001,-001,-001,-001,-001,-001,-001],
	[-001,-001,-001,-001,-001,-001,-001,-001,-001,-001,-001,-001,-001,-001,-001,-001,-001,-001,-001,-001,-001],
	[-001,-001,-001,-001,-001,-001,-001,-001,-001,-001,-001,-001,-001,-001,-001,-001,-001,-001,-001,-001,-001],
	[-001,-001,-001,-001,-001,-001,-001,-001,-001,-001,-001,-001,-001,-001,-001,-001,-001,-001,-001,-001,-001],
	[-001,-001,-001,-001,-001,-001,-001,-001,-001,-001,-001,-001,-001,-001,-001,-001,-001,-001,-001,-001,-001],
	[-001,-001,-001,-001,-001,-001,-001,-001,-001,-001,-001,-001,-001,-001,-001,-001,-001,-001,-001,-001,-001],
	[-001,-001,-001,-001,-001,-001,-001,-001,-001,-001,-001,-001,-001,-001,-001,-001,-001,-001,-001,-001,-001],
	[-001,-001,-001,-001,-001,-001,-001,-001,-001,-001,-001,-001,-001,-001,-001,-001,-001,-001,-001,-001,-001],
	[-001,-001,-001,-001,-001,-001,-001,-001,-001,-001,-001,-001,-001,-001,-001,-001,-001,-001,-001,-001,-001],
	[-001,-001,-001,-001,-001,-001,-001,-001,-001,-001,-001,-001,-001,-001,-001,-001,-001,-001,-001,-001,-001],
	[-001,-001,-001,-001,-001,-001,-001,-001,-001,-001,-001,-001,-001,-001,-001,-001,-001,-001,-001,-001,-001],
	[-001,-001,-001,-001,-001,-001,-001,-001,-001,-001,-001,-001,-001,-001,-001,-001,-001,-001,-001,-001,-001],
	[-001,-001,-001,-001,-001,-001,-001,-001,-001,-001,-001,-001,-001,-001,-001,-001,-001,-001,-001,-001,-001],
	[-001,-001,-001,-001,-001,-001,-001,-001,-001,-001,-001,-001,-001,-001,-001,-001,-001,-001,-001,-001,-001],
	[-001,-001,-001,-001,-001,-001,-001,-001,-001,-001,-001,-001,-001,-001,-001,-001,-001,-001,-001,-001,-001],
	[-001,-001,-001,-001,-001,-001,-001,-001,-001,-001,-001,-001,-001,-001,-001,-001,-001,-001,-001,-001,-001]
	],
	"events": [
	{
		"id": 1,
		"nom": "EV001",
		"x": 0,
		"y": 8,
		"pages": [
		{
			"conditions": [
			{
				"name": "ConditionArriveeAuContact"
			}
			],
			"commandes": [
			{
				"nom": "ConditionVariable",
				"numeroVariable": 71,
				"inegalite": "==",
				"valeurQuIlEstCenseAvoir": 3,
				"comparerAUneAutreVariable": false,
				"numero": 0
			},
			{
				"nom": "ChangerDeMap",
				"variable": false,
				"numeroNouvelleMap": 470,
				"xDebutHeros": 16,
				"yDebutHeros": 8
			},
			{
				"nom": "ConditionSinon",
				"numero": 0
			},
			{
				"nom": "ConditionVariable",
				"numeroVariable": 72,
				"inegalite": "==",
				"valeurQuIlEstCenseAvoir": 3,
				"comparerAUneAutreVariable": false,
				"numero": 1
			},
			{
				"nom": "ChangerDeMap",
				"variable": false,
				"numeroNouvelleMap": 471,
				"xDebutHeros": 16,
				"yDebutHeros": 8
			},
			{
				"nom": "ConditionSinon",
				"numero": 1
			},
			{
				"nom": "ConditionVariable",
				"numeroVariable": 73,
				"inegalite": "==",
				"valeurQuIlEstCenseAvoir": 3,
				"comparerAUneAutreVariable": false,
				"numero": 2
			},
			{
				"nom": "ChangerDeMap",
				"variable": false,
				"numeroNouvelleMap": 472,
				"xDebutHeros": 16,
				"yDebutHeros": 8
			},
			{
				"nom": "ConditionSinon",
				"numero": 2
			},
			{
				"nom": "ConditionVariable",
				"numeroVariable": 74,
				"inegalite": "==",
				"valeurQuIlEstCenseAvoir": 3,
				"comparerAUneAutreVariable": false,
				"numero": 3
			},
			{
				"nom": "ChangerDeMap",
				"variable": false,
				"numeroNouvelleMap": 473,
				"xDebutHeros": 16,
				"yDebutHeros": 8
			},
			{
				"nom": "ConditionSinon",
				"numero": 3
			},
			{
				"nom": "ChangerDeMap",
				"variable": false,
				"numeroNouvelleMap": 474,
				"xDebutHeros": 16,
				"yDebutHeros": 8
			},
			{
				"nom": "ConditionFin",
				"numero": 3
			},
			{
				"nom": "ConditionFin",
				"numero": 2
			},
			{
				"nom": "ConditionFin",
				"numero": 1
			},
			{
				"nom": "ConditionFin",
				"numero": 0
			}
			],
			"directionInitiale": 2,
			"vitesse": 8,
			"frequence": 4,
			"animeEnMouvement": true,
			"animeALArret": false,
			"directionFixe": false,
			"traversable": false,
			"auDessusDeTout": false
		}
		]
	},
	{
		"id": 2,
		"nom": "EV002",
		"x": 10,
		"y": 0,
		"pages": [
		{
			"conditions": [
			{
				"name": "ConditionArriveeAuContact"
			}
			],
			"commandes": [
			{
				"nom": "ConditionVariable",
				"numeroVariable": 71,
				"inegalite": "==",
				"valeurQuIlEstCenseAvoir": 5,
				"comparerAUneAutreVariable": false,
				"numero": 0
			},
			{
				"nom": "ChangerDeMap",
				"variable": false,
				"numeroNouvelleMap": 470,
				"xDebutHeros": 10,
				"yDebutHeros": 14
			},
			{
				"nom": "ConditionSinon",
				"numero": 0
			},
			{
				"nom": "ConditionVariable",
				"numeroVariable": 72,
				"inegalite": "==",
				"valeurQuIlEstCenseAvoir": 5,
				"comparerAUneAutreVariable": false,
				"numero": 1
			},
			{
				"nom": "ChangerDeMap",
				"variable": false,
				"numeroNouvelleMap": 471,
				"xDebutHeros": 10,
				"yDebutHeros": 14
			},
			{
				"nom": "ConditionSinon",
				"numero": 1
			},
			{
				"nom": "ConditionVariable",
				"numeroVariable": 73,
				"inegalite": "==",
				"valeurQuIlEstCenseAvoir": 5,
				"comparerAUneAutreVariable": false,
				"numero": 2
			},
			{
				"nom": "ChangerDeMap",
				"variable": false,
				"numeroNouvelleMap": 472,
				"xDebutHeros": 10,
				"yDebutHeros": 14
			},
			{
				"nom": "ConditionSinon",
				"numero": 2
			},
			{
				"nom": "ConditionVariable",
				"numeroVariable": 74,
				"inegalite": "==",
				"valeurQuIlEstCenseAvoir": 5,
				"comparerAUneAutreVariable": false,
				"numero": 3
			},
			{
				"nom": "ChangerDeMap",
				"variable": false,
				"numeroNouvelleMap": 473,
				"xDebutHeros": 10,
				"yDebutHeros": 14
			},
			{
				"nom": "ConditionSinon",
				"numero": 3
			},
			{
				"nom": "ChangerDeMap",
				"variable": false,
				"numeroNouvelleMap": 474,
				"xDebutHeros": 10,
				"yDebutHeros": 14
			},
			{
				"nom": "ConditionFin",
				"numero": 3
			},
			{
				"nom": "ConditionFin",
				"numero": 2
			},
			{
				"nom": "ConditionFin",
				"numero": 1
			},
			{
				"nom": "ConditionFin",
				"numero": 0
			}
			],
			"directionInitiale": 2,
			"vitesse": 8,
			"frequence": 4,
			"animeEnMouvement": true,
			"animeALArret": false,
			"directionFixe": false,
			"traversable": false,
			"auDessusDeTout": false
		}
		]
	},
	{
		"id": 3,
		"nom": "Clone[21][54]",
		"x": 11,
		"y": 10
	},
	{
		"id": 4,
		"nom": "Clone[21][54]",
		"x": 12,
		"y": 9
	}
	]
}
