{
	"nom": "Reve 3",
	"tileset": "Reve",
	"largeur": 35,
	"hauteur": 35,
	"musique": {
		"nomFichierSonore": "Enfermement.ogg",
		"volume": 1.00,
		"tempo": 1.00
	},
	"fondSonore": {
		"nomFichierSonore": "001-Wind01.ogg",
		"volume": 0.00,
		"tempo": 1.00
	},
	"couche0": [
	[0007,0007,0007,0007,0007,0007,0007,0007,0007,0007,0007,0007,0007,0007,0007,0007,0007,0007,0007,0007,0007,0007,0007,0007,0007,0007,0007,0007,0007,0007,0007,0007,0007,0007,0007],
	[0007,0007,0007,0007,0007,0007,0007,0007,0007,0007,0007,0007,0007,0007,0007,0007,0007,0007,0007,0007,0007,0007,0007,0007,0007,0007,0007,0007,0007,0007,0007,0007,0007,0007,0007],
	[0007,0007,0007,0007,0007,0007,0007,0007,0007,0007,0007,0007,0007,0007,0007,0007,0007,0007,0007,0007,0007,0007,0007,0007,0007,0007,0007,0007,0007,0007,0007,0007,0007,0007,0007],
	[0007,0007,0007,0007,0007,0007,0007,0007,0007,0007,0007,0007,0007,0007,0007,0007,0007,0007,0007,0007,0007,0007,0007,0007,0007,0007,0007,0007,0007,0007,0007,0007,0007,0007,0007],
	[0007,0007,0007,0007,0007,0007,0007,0007,0007,0007,0007,0007,0007,0007,0007,0007,0007,0007,0007,0007,0007,0007,0007,0007,0007,0007,0007,0007,0007,0007,0007,0007,0007,0007,0007],
	[0007,0007,0007,0007,0007,0007,0007,0007,0007,0007,0007,0007,0007,0007,0007,0007,0007,0007,0007,0007,0007,0007,0007,0007,0007,0007,0007,0007,0007,0007,0007,0007,0007,0007,0007],
	[0007,0007,0007,0007,0007,0007,0007,0007,0007,0007,0007,0007,0007,0007,0007,0007,0007,0007,0007,0007,0007,0007,0007,0007,0007,0007,0007,0007,0007,0007,0007,0007,0007,0007,0007],
	[0007,0007,0007,0007,0007,0007,0007,0007,0007,0007,0007,0007,0007,0007,0007,0007,0007,0007,0007,0007,0007,0007,0007,0007,0007,0007,0007,0007,0007,0007,0007,0007,0007,0007,0007],
	[0007,0007,0007,0007,0007,0007,0007,0007,0007,0007,0007,0007,0007,0007,0007,0007,0007,0007,0007,0007,0007,0007,0007,0007,0007,0007,0007,0007,0007,0007,0007,0007,0007,0007,0007],
	[0007,0007,0007,0007,0007,0007,0007,0007,0007,0007,0007,0007,0007,0007,0007,0007,0007,0007,0007,0007,0007,0007,0007,0007,0007,0007,0007,0007,0007,0007,0007,0007,0007,0007,0007],
	[0007,0007,0007,0007,0007,0007,0007,0007,0007,0007,0007,0007,0007,0007,0007,0007,0007,0007,0007,0007,0007,0007,0007,0007,0007,0007,0007,0007,0007,0007,0007,0007,0007,0007,0007],
	[0007,0007,0007,0007,0007,0007,0007,0007,0007,0007,0007,0007,0007,0007,0007,0007,0007,0007,0007,0007,0007,0007,0007,0007,0007,0007,0007,0007,0007,0007,0007,0007,0007,0007,0007],
	[0007,0007,0007,0007,0007,0007,0007,0007,0007,0007,0007,0007,0007,0007,0007,0007,0007,0007,0007,0007,0007,0007,0007,0007,0007,0007,0007,0007,0007,0007,0007,0007,0007,0007,0007],
	[0007,0007,0007,0007,0007,0007,0007,0007,0007,0007,0007,0007,0007,0007,0007,0007,0007,0007,0007,0007,0007,0007,0007,0007,0007,0007,0007,0007,0007,0007,0007,0007,0007,0007,0007],
	[0007,0007,0007,0007,0007,0007,0007,0007,0007,0007,0007,0007,0007,-008,-008,-008,-008,-008,-008,-008,-008,-008,0007,0007,0007,0007,0007,0007,0007,0007,0007,0007,0007,0007,0007],
	[0007,0007,0007,0007,0007,0007,0007,0007,0007,0007,0007,0007,0007,-008,-008,-008,-008,-008,-008,-008,-008,-008,0007,0007,0007,0007,0007,0007,0007,0007,0007,0007,0007,0007,0007],
	[0007,0007,0007,0007,0007,0007,0007,0007,0007,0007,0007,0007,0007,-008,-008,-008,-008,-008,-008,-008,-008,-008,0007,0007,0007,0007,0007,0007,0007,0007,0007,0007,0007,0007,0007],
	[0007,0007,0007,0007,0007,0007,0007,0007,0007,0007,0007,0007,0007,-008,-008,-008,-008,-008,-008,-008,-008,-008,0007,0007,0007,0007,0007,0007,0007,0007,0007,0007,0007,0007,0007],
	[0007,0007,0007,0007,0007,0007,0007,0007,0007,0007,0007,0007,0007,-008,-008,-008,-008,-008,-008,-008,-008,-008,0007,0007,0007,0007,0007,0007,0007,0007,0007,0007,0007,0007,0007],
	[0007,0007,0007,0007,0007,0007,0007,0007,0007,0007,0007,0007,0007,-008,-008,-008,-008,-008,-008,-008,-008,-008,0007,0007,0007,0007,0007,0007,0007,0007,0007,0007,0007,0007,0007],
	[0007,0007,0007,0007,0007,0007,0007,0007,0007,0007,0007,0007,0007,-008,-008,-008,-008,-008,-008,-008,-008,-008,0007,0007,0007,0007,0007,0007,0007,0007,0007,0007,0007,0007,0007],
	[0007,0007,0007,0007,0007,0007,0007,0007,0007,0007,0007,0007,0007,0007,0007,0007,0007,0007,0007,0007,0007,0007,0007,0007,0007,0007,0007,0007,0007,0007,0007,0007,0007,0007,0007],
	[0007,0007,0007,0007,0007,0007,0007,0007,0007,0007,0007,0007,0007,0007,0007,0007,0007,0007,0007,0007,0007,0007,0007,0007,0007,0007,0007,0007,0007,0007,0007,0007,0007,0007,0007],
	[0007,0007,0007,0007,0007,0007,0007,0007,0007,0007,0007,0007,0007,0007,0007,0007,0007,0007,0007,0007,0007,0007,0007,0007,0007,0007,0007,0007,0007,0007,0007,0007,0007,0007,0007],
	[0007,0007,0007,0007,0007,0007,0007,0007,0007,0007,0007,0007,0007,0007,0007,0007,0007,0007,0007,0007,0007,0007,0007,0007,0007,0007,0007,0007,0007,0007,0007,0007,0007,0007,0007],
	[0007,0007,0007,0007,0007,0007,0007,0007,0007,0007,0007,0007,0007,0007,0007,0007,0007,0007,0007,0007,0007,0007,0007,0007,0007,0007,0007,0007,0007,0007,0007,0007,0007,0007,0007],
	[0007,0007,0007,0007,0007,0007,0007,0007,0007,0007,0007,0007,0007,0007,0007,0007,0007,0007,0007,0007,0007,0007,0007,0007,0007,0007,0007,0007,0007,0007,0007,0007,0007,0007,0007],
	[0007,0007,0007,0007,0007,0007,0007,0007,0007,0007,0007,0007,0007,0007,0007,0007,0007,0007,0007,0007,0007,0007,0007,0007,0007,0007,0007,0007,0007,0007,0007,0007,0007,0007,0007],
	[0007,0007,0007,0007,0007,0007,0007,0007,0007,0007,0007,0007,0007,0007,0007,0007,0007,0007,0007,0007,0007,0007,0007,0007,0007,0007,0007,0007,0007,0007,0007,0007,0007,0007,0007],
	[0007,0007,0007,0007,0007,0007,0007,0007,0007,0007,0007,0007,0007,0007,0007,0007,0007,0007,0007,0007,0007,0007,0007,0007,0007,0007,0007,0007,0007,0007,0007,0007,0007,0007,0007],
	[0007,0007,0007,0007,0007,0007,0007,0007,0007,0007,0007,0007,0007,0007,0007,0007,0007,0007,0007,0007,0007,0007,0007,0007,0007,0007,0007,0007,0007,0007,0007,0007,0007,0007,0007],
	[0007,0007,0007,0007,0007,0007,0007,0007,0007,0007,0007,0007,0007,0007,0007,0007,0007,0007,0007,0007,0007,0007,0007,0007,0007,0007,0007,0007,0007,0007,0007,0007,0007,0007,0007],
	[0007,0007,0007,0007,0007,0007,0007,0007,0007,0007,0007,0007,0007,0007,0007,0007,0007,0007,0007,0007,0007,0007,0007,0007,0007,0007,0007,0007,0007,0007,0007,0007,0007,0007,0007],
	[0007,0007,0007,0007,0007,0007,0007,0007,0007,0007,0007,0007,0007,0007,0007,0007,0007,0007,0007,0007,0007,0007,0007,0007,0007,0007,0007,0007,0007,0007,0007,0007,0007,0007,0007],
	[0007,0007,0007,0007,0007,0007,0007,0007,0007,0007,0007,0007,0007,0007,0007,0007,0007,0007,0007,0007,0007,0007,0007,0007,0007,0007,0007,0007,0007,0007,0007,0007,0007,0007,0007]
	],
	"couche1": [
	[-001,-001,-001,-001,-001,-001,-001,-001,-001,-001,-001,-001,-001,-001,-001,-001,-001,-001,-001,-001,-001,-001,-001,-001,-001,-001,-001,-001,-001,-001,-001,-001,-001,-001,-001],
	[-001,-001,-001,-001,-001,-001,-001,-001,-001,-001,-001,-001,-001,-001,-001,-001,-001,-001,-001,-001,-001,-001,-001,-001,-001,-001,-001,-001,-001,-001,-001,-001,-001,-001,-001],
	[-001,-001,-001,-001,-001,-001,-001,-001,-001,-001,-001,-001,-001,-001,-001,-001,-001,-001,-001,-001,-001,-001,-001,-001,-001,-001,-001,-001,-001,-001,-001,-001,-001,-001,-001],
	[-001,-001,-001,-001,-001,-001,-001,-001,-001,-001,-001,-001,-001,-001,-001,-001,-001,-001,-001,-001,-001,-001,-001,-001,-001,-001,-001,-001,-001,-001,-001,-001,-001,-001,-001],
	[-001,-001,-001,-001,-001,-001,-001,-001,-001,-001,-001,-001,-001,-001,-001,-001,-001,-001,-001,-001,-001,-001,-001,-001,-001,-001,-001,-001,-001,-001,-001,-001,-001,-001,-001],
	[-001,-001,-001,-001,-001,-001,-001,-001,-001,-001,-001,-001,-001,-001,-001,-001,-001,-001,-001,-001,-001,-001,-001,-001,-001,-001,-001,-001,-001,-001,-001,-001,-001,-001,-001],
	[-001,-001,-001,-001,-001,-001,-001,-001,-001,-001,-001,-001,-001,-001,-001,-001,-001,-001,-001,-001,-001,-001,-001,-001,-001,-001,-001,-001,-001,-001,-001,-001,-001,-001,-001],
	[-001,-001,-001,-001,-001,-001,-001,-001,-001,-001,-001,-001,-001,-001,-001,-001,-001,-001,-001,-001,-001,-001,-001,-001,-001,-001,-001,-001,-001,-001,-001,-001,-001,-001,-001],
	[-001,-001,-001,-001,-001,-001,-001,-001,-001,-001,-001,-001,-001,-001,-001,-001,-001,-001,-001,-001,-001,-001,-001,-001,-001,-001,-001,-001,-001,-001,-001,-001,-001,-001,-001],
	[-001,-001,-001,-001,-001,-001,-001,-001,-001,-001,-001,-001,-001,-001,-001,-001,-001,-001,-001,-001,-001,-001,-001,-001,-001,-001,-001,-001,-001,-001,-001,-001,-001,-001,-001],
	[-001,-001,-001,-001,-001,-001,-001,-001,-001,-001,-001,-001,-001,-001,-001,-001,-001,-001,-001,-001,-001,-001,-001,-001,-001,-001,-001,-001,-001,-001,-001,-001,-001,-001,-001],
	[-001,-001,-001,-001,-001,-001,-001,-001,-001,-001,-001,-001,-001,-001,-001,-001,-001,-001,-001,-001,-001,-001,-001,-001,-001,-001,-001,-001,-001,-001,-001,-001,-001,-001,-001],
	[-001,-001,-001,-001,-001,-001,-001,-001,-001,-001,-001,-001,-001,-001,-001,-001,-001,-001,-001,-001,-001,-001,-001,-001,-001,-001,-001,-001,-001,-001,-001,-001,-001,-001,-001],
	[-001,-001,-001,-001,-001,-001,-001,-001,-001,-001,-001,-001,-001,-001,-001,-001,-001,-001,-001,-001,-001,-001,-001,-001,-001,-001,-001,-001,-001,-001,-001,-001,-001,-001,-001],
	[-001,-001,-001,-001,-001,-001,-001,-001,-001,-001,-001,-001,-001,-001,-001,-001,-001,-001,-001,-001,-001,-001,-001,-001,-001,-001,-001,-001,-001,-001,-001,-001,-001,-001,-001],
	[-001,-001,-001,-001,-001,-001,-001,-001,-001,-001,-001,-001,-001,-001,-001,0000,0001,0002,0003,0004,-001,-001,-001,-001,-001,-001,-001,-001,-001,-001,-001,-001,-001,-001,-001],
	[-001,-001,-001,-001,-001,-001,-001,-001,-001,-001,-001,-001,-001,-001,-001,0008,0009,0010,0011,0012,-001,-001,-001,-001,-001,-001,-001,-001,-001,-001,-001,-001,-001,-001,-001],
	[-001,-001,-001,-001,-001,-001,-001,-001,-001,-001,-001,-001,-001,-001,-001,0016,0017,0018,0019,0020,-001,-001,-001,-001,-001,-001,-001,-001,-001,-001,-001,-001,-001,-001,-001],
	[-001,-001,-001,-001,-001,-001,-001,-001,-001,-001,-001,-001,-001,-001,-001,0024,0025,0026,0027,0028,-001,-001,-001,-001,-001,-001,-001,-001,-001,-001,-001,-001,-001,-001,-001],
	[-001,-001,-001,-001,-001,-001,-001,-001,-001,-001,-001,-001,-001,-001,-001,0032,0033,0034,0035,0036,-001,-001,-001,-001,-001,-001,-001,-001,-001,-001,-001,-001,-001,-001,-001],
	[-001,-001,-001,-001,-001,-001,-001,-001,-001,-001,-001,-001,-001,-001,-001,-001,-001,-001,-001,-001,-001,-001,-001,-001,-001,-001,-001,-001,-001,-001,-001,-001,-001,-001,-001],
	[-001,-001,-001,-001,-001,-001,-001,-001,-001,-001,-001,-001,-001,-001,-001,-001,-001,-001,-001,-001,-001,-001,-001,-001,-001,-001,-001,-001,-001,-001,-001,-001,-001,-001,-001],
	[-001,-001,-001,-001,-001,-001,-001,-001,-001,-001,-001,-001,-001,-001,-001,-001,-001,-001,-001,-001,-001,-001,-001,-001,-001,-001,-001,-001,-001,-001,-001,-001,-001,-001,-001],
	[-001,-001,-001,-001,-001,-001,-001,-001,-001,-001,-001,-001,-001,-001,-001,-001,-001,-001,-001,-001,-001,-001,-001,-001,-001,-001,-001,-001,-001,-001,-001,-001,-001,-001,-001],
	[-001,-001,-001,-001,-001,-001,-001,-001,-001,-001,-001,-001,-001,-001,-001,-001,-001,-001,-001,-001,-001,-001,-001,-001,-001,-001,-001,-001,-001,-001,-001,-001,-001,-001,-001],
	[-001,-001,-001,-001,-001,-001,-001,-001,-001,-001,-001,-001,-001,-001,-001,-001,-001,-001,-001,-001,-001,-001,-001,-001,-001,-001,-001,-001,-001,-001,-001,-001,-001,-001,-001],
	[-001,-001,-001,-001,-001,-001,-001,-001,-001,-001,-001,-001,-001,-001,-001,-001,-001,-001,-001,-001,-001,-001,-001,-001,-001,-001,-001,-001,-001,-001,-001,-001,-001,-001,-001],
	[-001,-001,-001,-001,-001,-001,-001,-001,-001,-001,-001,-001,-001,-001,-001,-001,-001,-001,-001,-001,-001,-001,-001,-001,-001,-001,-001,-001,-001,-001,-001,-001,-001,-001,-001],
	[-001,-001,-001,-001,-001,-001,-001,-001,-001,-001,-001,-001,-001,-001,-001,-001,-001,-001,-001,-001,-001,-001,-001,-001,-001,-001,-001,-001,-001,-001,-001,-001,-001,-001,-001],
	[-001,-001,-001,-001,-001,-001,-001,-001,-001,-001,-001,-001,-001,-001,-001,-001,-001,-001,-001,-001,-001,-001,-001,-001,-001,-001,-001,-001,-001,-001,-001,-001,-001,-001,-001],
	[-001,-001,-001,-001,-001,-001,-001,-001,-001,-001,-001,-001,-001,-001,-001,-001,-001,-001,-001,-001,-001,-001,-001,-001,-001,-001,-001,-001,-001,-001,-001,-001,-001,-001,-001],
	[-001,-001,-001,-001,-001,-001,-001,-001,-001,-001,-001,-001,-001,-001,-001,-001,-001,-001,-001,-001,-001,-001,-001,-001,-001,-001,-001,-001,-001,-001,-001,-001,-001,-001,-001],
	[-001,-001,-001,-001,-001,-001,-001,-001,-001,-001,-001,-001,-001,-001,-001,-001,-001,-001,-001,-001,-001,-001,-001,-001,-001,-001,-001,-001,-001,-001,-001,-001,-001,-001,-001],
	[-001,-001,-001,-001,-001,-001,-001,-001,-001,-001,-001,-001,-001,-001,-001,-001,-001,-001,-001,-001,-001,-001,-001,-001,-001,-001,-001,-001,-001,-001,-001,-001,-001,-001,-001],
	[-001,-001,-001,-001,-001,-001,-001,-001,-001,-001,-001,-001,-001,-001,-001,-001,-001,-001,-001,-001,-001,-001,-001,-001,-001,-001,-001,-001,-001,-001,-001,-001,-001,-001,-001]
	],
	"couche2": [
	[-001,-001,-001,-001,-001,-001,-001,-001,-001,-001,-001,-001,-001,-001,-001,-001,-001,-001,-001,-001,-001,-001,-001,-001,-001,-001,-001,-001,-001,-001,-001,-001,-001,-001,-001],
	[-001,-001,-001,-001,-001,-001,-001,-001,-001,-001,-001,-001,-001,-001,-001,-001,-001,-001,-001,-001,-001,-001,-001,-001,-001,-001,-001,-001,-001,-001,-001,-001,-001,-001,-001],
	[-001,-001,-001,-001,-001,-001,-001,-001,-001,-001,-001,-001,-001,-001,-001,-001,-001,-001,-001,-001,-001,-001,-001,-001,-001,-001,-001,-001,-001,-001,-001,-001,-001,-001,-001],
	[-001,-001,-001,-001,-001,-001,-001,-001,-001,-001,-001,-001,-001,-001,-001,-001,-001,-001,-001,-001,-001,-001,-001,-001,-001,-001,-001,-001,-001,-001,-001,-001,-001,-001,-001],
	[-001,-001,-001,-001,-001,-001,-001,-001,-001,-001,-001,-001,-001,-001,-001,-001,-001,-001,-001,-001,-001,-001,-001,-001,-001,-001,-001,-001,-001,-001,-001,-001,-001,-001,-001],
	[-001,-001,-001,-001,-001,-001,-001,-001,-001,-001,-001,-001,-001,-001,-001,-001,-001,-001,-001,-001,-001,-001,-001,-001,-001,-001,-001,-001,-001,-001,-001,-001,-001,-001,-001],
	[-001,-001,-001,-001,-001,-001,-001,-001,-001,-001,-001,-001,-001,-001,-001,-001,-001,-001,-001,-001,-001,-001,-001,-001,-001,-001,-001,-001,-001,-001,-001,-001,-001,-001,-001],
	[-001,-001,-001,-001,-001,-001,-001,-001,-001,-001,-001,-001,-001,-001,-001,-001,-001,-001,-001,-001,-001,-001,-001,-001,-001,-001,-001,-001,-001,-001,-001,-001,-001,-001,-001],
	[-001,-001,-001,-001,-001,-001,-001,-001,-001,-001,-001,-001,-001,-001,-001,-001,-001,-001,-001,-001,-001,-001,-001,-001,-001,-001,-001,-001,-001,-001,-001,-001,-001,-001,-001],
	[-001,-001,-001,-001,-001,-001,-001,-001,-001,-001,-001,-001,-001,-001,-001,-001,-001,-001,-001,-001,-001,-001,-001,-001,-001,-001,-001,-001,-001,-001,-001,-001,-001,-001,-001],
	[-001,-001,-001,-001,-001,-001,-001,-001,-001,-001,-001,-001,-001,-001,-001,-001,-001,-001,-001,-001,-001,-001,-001,-001,-001,-001,-001,-001,-001,-001,-001,-001,-001,-001,-001],
	[-001,-001,-001,-001,-001,-001,-001,-001,-001,-001,-001,-001,-001,-001,-001,-001,-001,-001,-001,-001,-001,-001,-001,-001,-001,-001,-001,-001,-001,-001,-001,-001,-001,-001,-001],
	[-001,-001,-001,-001,-001,-001,-001,-001,-001,-001,-001,-001,-001,-001,-001,-001,-001,-001,-001,-001,-001,-001,-001,-001,-001,-001,-001,-001,-001,-001,-001,-001,-001,-001,-001],
	[-001,-001,-001,-001,-001,-001,-001,-001,-001,-001,-001,-001,-001,-001,-001,-001,-001,-001,-001,-001,-001,-001,-001,-001,-001,-001,-001,-001,-001,-001,-001,-001,-001,-001,-001],
	[-001,-001,-001,-001,-001,-001,-001,-001,-001,-001,-001,-001,-001,-001,-001,-001,-001,-001,-001,-001,-001,-001,-001,-001,-001,-001,-001,-001,-001,-001,-001,-001,-001,-001,-001],
	[-001,-001,-001,-001,-001,-001,-001,-001,-001,-001,-001,-001,-001,-001,-001,-001,-001,-001,-001,-001,-001,-001,-001,-001,-001,-001,-001,-001,-001,-001,-001,-001,-001,-001,-001],
	[-001,-001,-001,-001,-001,-001,-001,-001,-001,-001,-001,-001,-001,-001,-001,-001,-001,-001,-001,-001,-001,-001,-001,-001,-001,-001,-001,-001,-001,-001,-001,-001,-001,-001,-001],
	[-001,-001,-001,-001,-001,-001,-001,-001,-001,-001,-001,-001,-001,-001,-001,-001,-001,-001,-001,-001,-001,-001,-001,-001,-001,-001,-001,-001,-001,-001,-001,-001,-001,-001,-001],
	[-001,-001,-001,-001,-001,-001,-001,-001,-001,-001,-001,-001,-001,-001,-001,-001,-001,-001,-001,-001,-001,-001,-001,-001,-001,-001,-001,-001,-001,-001,-001,-001,-001,-001,-001],
	[-001,-001,-001,-001,-001,-001,-001,-001,-001,-001,-001,-001,-001,-001,-001,-001,-001,-001,-001,-001,-001,-001,-001,-001,-001,-001,-001,-001,-001,-001,-001,-001,-001,-001,-001],
	[-001,-001,-001,-001,-001,-001,-001,-001,-001,-001,-001,-001,-001,-001,-001,-001,-001,-001,-001,-001,-001,-001,-001,-001,-001,-001,-001,-001,-001,-001,-001,-001,-001,-001,-001],
	[-001,-001,-001,-001,-001,-001,-001,-001,-001,-001,-001,-001,-001,-001,-001,-001,-001,-001,-001,-001,-001,-001,-001,-001,-001,-001,-001,-001,-001,-001,-001,-001,-001,-001,-001],
	[-001,-001,-001,-001,-001,-001,-001,-001,-001,-001,-001,-001,-001,-001,-001,-001,-001,-001,-001,-001,-001,-001,-001,-001,-001,-001,-001,-001,-001,-001,-001,-001,-001,-001,-001],
	[-001,-001,-001,-001,-001,-001,-001,-001,-001,-001,-001,-001,-001,-001,-001,-001,-001,-001,-001,-001,-001,-001,-001,-001,-001,-001,-001,-001,-001,-001,-001,-001,-001,-001,-001],
	[-001,-001,-001,-001,-001,-001,-001,-001,-001,-001,-001,-001,-001,-001,-001,-001,-001,-001,-001,-001,-001,-001,-001,-001,-001,-001,-001,-001,-001,-001,-001,-001,-001,-001,-001],
	[-001,-001,-001,-001,-001,-001,-001,-001,-001,-001,-001,-001,-001,-001,-001,-001,-001,-001,-001,-001,-001,-001,-001,-001,-001,-001,-001,-001,-001,-001,-001,-001,-001,-001,-001],
	[-001,-001,-001,-001,-001,-001,-001,-001,-001,-001,-001,-001,-001,-001,-001,-001,-001,-001,-001,-001,-001,-001,-001,-001,-001,-001,-001,-001,-001,-001,-001,-001,-001,-001,-001],
	[-001,-001,-001,-001,-001,-001,-001,-001,-001,-001,-001,-001,-001,-001,-001,-001,-001,-001,-001,-001,-001,-001,-001,-001,-001,-001,-001,-001,-001,-001,-001,-001,-001,-001,-001],
	[-001,-001,-001,-001,-001,-001,-001,-001,-001,-001,-001,-001,-001,-001,-001,-001,-001,-001,-001,-001,-001,-001,-001,-001,-001,-001,-001,-001,-001,-001,-001,-001,-001,-001,-001],
	[-001,-001,-001,-001,-001,-001,-001,-001,-001,-001,-001,-001,-001,-001,-001,-001,-001,-001,-001,-001,-001,-001,-001,-001,-001,-001,-001,-001,-001,-001,-001,-001,-001,-001,-001],
	[-001,-001,-001,-001,-001,-001,-001,-001,-001,-001,-001,-001,-001,-001,-001,-001,-001,-001,-001,-001,-001,-001,-001,-001,-001,-001,-001,-001,-001,-001,-001,-001,-001,-001,-001],
	[-001,-001,-001,-001,-001,-001,-001,-001,-001,-001,-001,-001,-001,-001,-001,-001,-001,-001,-001,-001,-001,-001,-001,-001,-001,-001,-001,-001,-001,-001,-001,-001,-001,-001,-001],
	[-001,-001,-001,-001,-001,-001,-001,-001,-001,-001,-001,-001,-001,-001,-001,-001,-001,-001,-001,-001,-001,-001,-001,-001,-001,-001,-001,-001,-001,-001,-001,-001,-001,-001,-001],
	[-001,-001,-001,-001,-001,-001,-001,-001,-001,-001,-001,-001,-001,-001,-001,-001,-001,-001,-001,-001,-001,-001,-001,-001,-001,-001,-001,-001,-001,-001,-001,-001,-001,-001,-001],
	[-001,-001,-001,-001,-001,-001,-001,-001,-001,-001,-001,-001,-001,-001,-001,-001,-001,-001,-001,-001,-001,-001,-001,-001,-001,-001,-001,-001,-001,-001,-001,-001,-001,-001,-001]
	],
	"events": [
	{
		"id": 1,
		"nom": "bougie",
		"x": 17,
		"y": 17,
		"pages": [
		{
			"conditions": [
			{
				"nom": "Parler"
			}
			],
			"commandes": [
			{
				"nom": "ModifierInterrupteur",
				"numeroInterrupteur": 12,
				"valeur": true
			},
			{
				"nom": "ConditionVariable",
				"numeroVariable": 121,
				"inegalite": "==",
				"valeurQuIlEstCenseAvoir": 0,
				"comparerAUneAutreVariable": false,
				"numero": 0
			},
			{
				"nom": "Message",
				"texte": "Rêve d'enfermement."
			},
			{
				"nom": "ConditionSinon",
				"numero": 0
			},
			{
				"nom": "Message",
				"texte": "A dream of confinement."
			},
			{
				"nom": "ConditionFin",
				"numero": 0
			},
			{
				"nom": "Attendre",
				"nombreDeFrames": 8
			},
			{
				"nom": "ModifierInterrupteur",
				"numeroInterrupteur": 12,
				"valeur": false
			}
			],
			"image": "bougie character",
			"directionInitiale": 2,
			"vitesse": "tres rapide",
			"frequence": "la plus haute",
			"animeEnMouvement": false,
			"animeALArret": true,
			"directionFixe": true,
			"traversable": false,
			"auDessusDeTout": false
		}
		]
	},
	{
		"id": 2,
		"nom": "EV002",
		"x": 17,
		"y": 12,
		"pages": [
		{
			"conditions": [
			],
			"commandes": [
			{
				"nom": "Attendre",
				"nombreDeFrames": 1665
			},
			{
				"nom": "ModifierVariable",
				"numeroVariable": 143,
				"operationAFaire": "rendre egal a",
				"valeurADonner": 10,
				"operationAFaire2": "valeur brute"
			},
			{
				"nom": "ChangerDeMap",
				"variable": false,
				"numeroNouvelleMap": 13,
				"xDebutHeros": 7,
				"yDebutHeros": 19
			}
			],
			"vitesse": "moderee",
			"frequence": "basse",
			"animeEnMouvement": true,
			"animeALArret": false,
			"directionFixe": false,
			"traversable": false,
			"auDessusDeTout": false
		}
		]
	}
	]
}
