{
	"nom": "extremité gauche",
	"tileset": "Sanctuaire de Jishin",
	"largeur": 21,
	"hauteur": 15,
	"musique": {
		"nomFichierSonore": "",
		"volume": 1.00,
		"tempo": 1.00
	},
	"fondSonore": {
		"nomFichierSonore": "",
		"volume": 0.80,
		"tempo": 1.00
	},
	"couche0": [
	[0002,0002,0002,0002,0002,0002,0002,0002,0002,0002,0002,0002,0002,0002,0002,0002,0002,0140,0141,0108,0109],
	[0002,0002,0002,0002,0002,0002,0002,0002,0002,0002,0002,0002,0002,0002,0002,0002,0002,0148,0149,0116,0117],
	[0002,0002,0002,0002,0002,0002,0002,0002,0002,0002,0140,0141,0108,0109,0108,0109,0108,0146,0147,0308,0309],
	[0002,0002,0002,0002,0002,0002,0002,0002,0002,0002,0148,0149,0116,0117,0116,0117,0116,0154,0155,0316,0317],
	[0002,0002,0002,0002,0002,0002,0002,0002,0002,0002,0110,0111,0161,0161,0161,0161,0161,0161,0261,0292,0293],
	[0002,0002,0002,0002,0002,0002,0002,0002,0002,0002,0118,0119,0161,0161,0161,0161,0161,0161,0261,0300,0301],
	[0002,0002,0002,0002,0002,0002,0002,0002,0002,0002,0110,0111,0161,0161,0171,0172,0173,0161,0261,0306,0307],
	[0002,0002,0002,0002,0002,0002,0002,0002,0002,0002,0118,0119,0161,0161,0179,0180,0181,0161,0261,0314,0315],
	[0002,0002,0002,0002,0002,0002,0002,0002,0002,0002,0110,0111,0161,0161,0187,0188,0189,0161,0261,0322,0323],
	[0002,0002,0002,0002,0002,0002,0002,0002,0002,0002,0118,0119,0161,0161,0161,0161,0161,0161,0261,0292,0293],
	[0002,0002,0002,0002,0002,0002,0002,0002,0002,0002,0110,0111,0161,0161,0161,0161,0161,0161,0261,0300,0301],
	[0002,0002,0002,0002,0002,0002,0002,0002,0002,0002,0156,0157,0126,0127,0126,0127,0126,0130,0131,0324,0325],
	[0002,0002,0002,0002,0002,0002,0002,0002,0002,0002,0164,0165,0134,0135,0134,0135,0134,0138,0139,0332,0333],
	[0002,0002,0002,0002,0002,0002,0002,0002,0002,0002,0002,0002,0002,0002,0002,0002,0002,0156,0157,0126,0127],
	[0002,0002,0002,0002,0002,0002,0002,0002,0002,0002,0002,0002,0002,0002,0002,0002,0002,0164,0165,0134,0135]
	],
	"couche1": [
	[-001,-001,-001,-001,-001,-001,-001,-001,-001,-001,-001,-001,-001,-001,-001,-001,-001,-001,-001,-001,-001],
	[-001,-001,-001,-001,-001,-001,-001,-001,-001,-001,-001,-001,-001,-001,-001,-001,-001,-001,-001,-001,-001],
	[-001,-001,-001,-001,-001,-001,-001,-001,-001,-001,-001,-001,-001,-001,-001,-001,-001,-001,-001,-001,-001],
	[-001,-001,-001,-001,-001,-001,-001,-001,-001,-001,-001,-001,-001,-001,-001,-001,-001,-001,0275,-001,-001],
	[-001,-001,-001,-001,-001,-001,-001,-001,-001,-001,-001,-001,-001,-001,-001,-001,-001,-001,0283,-001,-001],
	[-001,-001,-001,-001,-001,-001,-001,-001,-001,-001,-001,-001,-001,-001,-001,-001,-001,-001,-001,-001,-001],
	[-001,-001,-001,-001,-001,-001,-001,-001,-001,-001,-001,-001,-001,-001,-001,-001,-001,-001,-001,-001,-001],
	[-001,-001,-001,-001,-001,-001,-001,-001,-001,-001,-001,-001,-001,-001,-001,-001,-001,-001,-001,-001,-001],
	[-001,-001,-001,-001,-001,-001,-001,-001,-001,-001,-001,-001,-001,-001,-001,-001,-001,-001,-001,-001,-001],
	[-001,-001,-001,-001,-001,-001,-001,-001,-001,-001,-001,-001,-001,-001,-001,-001,-001,-001,0291,-001,-001],
	[-001,-001,-001,-001,-001,-001,-001,-001,-001,-001,-001,-001,-001,-001,-001,-001,-001,-001,0299,-001,-001],
	[-001,-001,-001,-001,-001,-001,-001,-001,-001,-001,-001,-001,-001,-001,-001,-001,-001,-001,-001,-001,-001],
	[-001,-001,-001,-001,-001,-001,-001,-001,-001,-001,-001,-001,-001,-001,-001,-001,-001,-001,-001,-001,-001],
	[-001,-001,-001,-001,-001,-001,-001,-001,-001,-001,-001,-001,-001,-001,-001,-001,-001,-001,-001,-001,-001],
	[-001,-001,-001,-001,-001,-001,-001,-001,-001,-001,-001,-001,-001,-001,-001,-001,-001,-001,-001,-001,-001]
	],
	"couche2": [
	[-001,-001,-001,-001,-001,-001,-001,-001,-001,-001,-001,-001,-001,-001,-001,-001,-001,-001,-001,-001,-001],
	[-001,-001,-001,-001,-001,-001,-001,-001,-001,-001,-001,-001,-001,-001,-001,-001,-001,-001,-001,-001,-001],
	[-001,-001,-001,-001,-001,-001,-001,-001,-001,-001,-001,-001,-001,-001,-001,-001,-001,-001,-001,-001,-001],
	[-001,-001,-001,-001,-001,-001,-001,-001,-001,-001,-001,-001,-001,-001,-001,-001,-001,-001,-001,-001,-001],
	[-001,-001,-001,-001,-001,-001,-001,-001,-001,-001,-001,-001,-001,-001,-001,-001,-001,-001,-001,-001,-001],
	[-001,-001,-001,-001,-001,-001,-001,-001,-001,-001,-001,-001,-001,-001,-001,-001,-001,-001,-001,-001,-001],
	[-001,-001,-001,-001,-001,-001,-001,-001,-001,-001,-001,-001,-001,-001,-001,-001,-001,-001,-001,-001,-001],
	[-001,-001,-001,-001,-001,-001,-001,-001,-001,-001,-001,-001,-001,-001,-001,-001,-001,-001,-001,-001,-001],
	[-001,-001,-001,-001,-001,-001,-001,-001,-001,-001,-001,-001,-001,-001,-001,-001,-001,-001,-001,-001,-001],
	[-001,-001,-001,-001,-001,-001,-001,-001,-001,-001,-001,-001,-001,-001,-001,-001,-001,-001,-001,-001,-001],
	[-001,-001,-001,-001,-001,-001,-001,-001,-001,-001,-001,-001,-001,-001,-001,-001,-001,-001,-001,-001,-001],
	[-001,-001,-001,-001,-001,-001,-001,-001,-001,-001,-001,-001,-001,-001,-001,-001,-001,-001,-001,-001,-001],
	[-001,-001,-001,-001,-001,-001,-001,-001,-001,-001,-001,-001,-001,-001,-001,-001,-001,-001,-001,-001,-001],
	[-001,-001,-001,-001,-001,-001,-001,-001,-001,-001,-001,-001,-001,-001,-001,-001,-001,-001,-001,-001,-001],
	[-001,-001,-001,-001,-001,-001,-001,-001,-001,-001,-001,-001,-001,-001,-001,-001,-001,-001,-001,-001,-001]
	],
	"events": [
	{
		"id": 5,
		"nom": "Clone[341][181]",
		"x": 13,
		"y": 9
	},
	{
		"id": 1,
		"nom": "EV001",
		"x": 20,
		"y": 7,
		"pages": [
		{
			"conditions": [
			{
				"nom": "ArriveeAuContact"
			}
			],
			"commandes": [
			{
				"nom": "ConditionVariable",
				"numeroVariable": 71,
				"inegalite": "==",
				"valeurQuIlEstCenseAvoir": 4,
				"comparerAUneAutreVariable": false,
				"numero": 0
			},
			{
				"nom": "ChangerDeMap",
				"variable": false,
				"numeroNouvelleMap": 470,
				"xDebutHeros": 4,
				"yDebutHeros": 7
			},
			{
				"nom": "ConditionSinon",
				"numero": 0
			},
			{
				"nom": "ConditionVariable",
				"numeroVariable": 72,
				"inegalite": "==",
				"valeurQuIlEstCenseAvoir": 4,
				"comparerAUneAutreVariable": false,
				"numero": 1
			},
			{
				"nom": "ChangerDeMap",
				"variable": false,
				"numeroNouvelleMap": 471,
				"xDebutHeros": 4,
				"yDebutHeros": 7
			},
			{
				"nom": "ConditionSinon",
				"numero": 1
			},
			{
				"nom": "ConditionVariable",
				"numeroVariable": 73,
				"inegalite": "==",
				"valeurQuIlEstCenseAvoir": 4,
				"comparerAUneAutreVariable": false,
				"numero": 2
			},
			{
				"nom": "ChangerDeMap",
				"variable": false,
				"numeroNouvelleMap": 472,
				"xDebutHeros": 4,
				"yDebutHeros": 7
			},
			{
				"nom": "ConditionSinon",
				"numero": 2
			},
			{
				"nom": "ConditionVariable",
				"numeroVariable": 74,
				"inegalite": "==",
				"valeurQuIlEstCenseAvoir": 4,
				"comparerAUneAutreVariable": false,
				"numero": 3
			},
			{
				"nom": "ChangerDeMap",
				"variable": false,
				"numeroNouvelleMap": 473,
				"xDebutHeros": 4,
				"yDebutHeros": 7
			},
			{
				"nom": "ConditionSinon",
				"numero": 3
			},
			{
				"nom": "ChangerDeMap",
				"variable": false,
				"numeroNouvelleMap": 474,
				"xDebutHeros": 4,
				"yDebutHeros": 7
			},
			{
				"nom": "ConditionFin",
				"numero": 3
			},
			{
				"nom": "ConditionFin",
				"numero": 2
			},
			{
				"nom": "ConditionFin",
				"numero": 1
			},
			{
				"nom": "ConditionFin",
				"numero": 0
			}
			],
			"vitesse": "moderee",
			"frequence": "basse",
			"animeEnMouvement": true,
			"animeALArret": false,
			"directionFixe": false,
			"traversable": false,
			"auDessusDeTout": false
		}
		]
	},
	{
		"id": 2,
		"nom": "Clone[341][181]",
		"x": 13,
		"y": 4
	},
	{
		"id": 3,
		"nom": "Clone[341][181]",
		"x": 12,
		"y": 4
	},
	{
		"id": 4,
		"nom": "Clone[341][181]",
		"x": 12,
		"y": 5
	}
	]
}
