{
	"nom": "extremité droite",
	"tileset": "Sanctuaire de Jishin",
	"largeur": 20,
	"hauteur": 15,
	"bgm": "",
	"bgs": "",
	"couche0": [
	[0002,0002,0002,0002,0002,0002,0002,0002,0002,0002,0002,0002,0002,0002,0002,0002,0002,0002,0002,0002],
	[0002,0002,0002,0002,0002,0002,0002,0002,0002,0002,0002,0002,0002,0002,0002,0002,0002,0002,0002,0002],
	[0002,0002,0002,0002,0002,0140,0141,0108,0109,0108,0109,0108,0109,0108,0142,0143,0002,0002,0002,0002],
	[0002,0002,0002,0002,0002,0148,0149,0116,0117,0116,0117,0116,0117,0116,0150,0151,0002,0002,0002,0002],
	[0002,0002,0002,0140,0141,0146,0147,0161,0161,0161,0161,0161,0161,0161,0124,0125,0002,0002,0002,0002],
	[0002,0002,0002,0148,0149,0154,0155,0161,0161,0161,0161,0161,0161,0161,0132,0133,0002,0002,0002,0002],
	[0002,0002,0002,0161,0161,0161,0161,0161,0161,0171,0172,0173,0161,0161,0124,0125,0002,0002,0002,0002],
	[0002,0002,0002,0161,0161,0161,0161,0161,0161,0179,0180,0181,0161,0161,0132,0133,0002,0002,0002,0002],
	[0002,0002,0002,0161,0161,0161,0161,0161,0161,0187,0188,0189,0161,0161,0124,0125,0002,0002,0002,0002],
	[0002,0002,0002,0156,0157,0130,0131,0161,0161,0161,0161,0161,0161,0161,0132,0133,0002,0002,0002,0002],
	[0002,0002,0002,0164,0165,0138,0139,0161,0161,0161,0161,0161,0161,0161,0124,0125,0002,0002,0002,0002],
	[0002,0002,0002,0002,0002,0156,0157,0126,0127,0126,0127,0126,0127,0126,0158,0159,0002,0002,0002,0002],
	[0002,0002,0002,0002,0002,0164,0165,0134,0135,0134,0135,0134,0135,0134,0166,0167,0002,0002,0002,0002],
	[0002,0002,0002,0002,0002,0002,0002,0002,0002,0002,0002,0002,0002,0002,0002,0002,0002,0002,0002,0002],
	[0002,0002,0002,0002,0002,0002,0002,0002,0002,0002,0002,0002,0002,0002,0002,0002,0002,0002,0002,0002]
	],
	"couche1": [
	[-001,-001,-001,-001,-001,-001,-001,-001,-001,-001,-001,-001,-001,-001,-001,-001,-001,-001,-001,-001],
	[-001,-001,-001,-001,-001,-001,-001,-001,-001,-001,-001,-001,-001,-001,-001,-001,-001,-001,-001,-001],
	[-001,-001,-001,-001,-001,-001,-001,-001,-001,-001,-001,-001,-001,-001,-001,-001,-001,-001,-001,-001],
	[-001,-001,-001,-001,-001,-001,-001,-001,-001,-001,-001,-001,-001,-001,-001,-001,-001,-001,-001,-001],
	[-001,-001,-001,-001,-001,-001,-001,-001,-001,-001,-001,-001,-001,-001,-001,-001,-001,-001,-001,-001],
	[-001,-001,-001,-001,-001,-001,-001,-001,-001,-001,-001,-001,-001,-001,-001,-001,-001,-001,-001,-001],
	[-001,-001,-001,0200,0201,-001,-001,-001,-001,-001,-001,-001,-001,-001,-001,-001,-001,-001,-001,-001],
	[-001,-001,-001,0208,0209,-001,-001,-001,-001,-001,-001,-001,-001,-001,-001,-001,-001,-001,-001,-001],
	[-001,-001,-001,0216,0217,-001,-001,-001,-001,-001,-001,-001,-001,-001,-001,-001,-001,-001,-001,-001],
	[-001,-001,-001,-001,-001,-001,-001,-001,-001,-001,-001,-001,-001,-001,-001,-001,-001,-001,-001,-001],
	[-001,-001,-001,-001,-001,-001,-001,-001,-001,-001,-001,-001,-001,-001,-001,-001,-001,-001,-001,-001],
	[-001,-001,-001,-001,-001,-001,-001,-001,-001,-001,-001,-001,-001,-001,-001,-001,-001,-001,-001,-001],
	[-001,-001,-001,-001,-001,-001,-001,-001,-001,-001,-001,-001,-001,-001,-001,-001,-001,-001,-001,-001],
	[-001,-001,-001,-001,-001,-001,-001,-001,-001,-001,-001,-001,-001,-001,-001,-001,-001,-001,-001,-001],
	[-001,-001,-001,-001,-001,-001,-001,-001,-001,-001,-001,-001,-001,-001,-001,-001,-001,-001,-001,-001]
	],
	"couche2": [
	[-001,-001,-001,-001,-001,-001,-001,-001,-001,-001,-001,-001,-001,-001,-001,-001,-001,-001,-001,-001],
	[-001,-001,-001,-001,-001,-001,-001,-001,-001,-001,-001,-001,-001,-001,-001,-001,-001,-001,-001,-001],
	[-001,-001,-001,-001,-001,-001,-001,-001,-001,-001,-001,-001,-001,-001,-001,-001,-001,-001,-001,-001],
	[-001,-001,-001,-001,-001,-001,-001,-001,-001,-001,-001,-001,-001,-001,-001,-001,-001,-001,-001,-001],
	[-001,-001,-001,-001,-001,-001,-001,-001,-001,-001,-001,-001,-001,-001,-001,-001,-001,-001,-001,-001],
	[-001,-001,-001,-001,-001,-001,-001,-001,-001,-001,-001,-001,-001,-001,-001,-001,-001,-001,-001,-001],
	[-001,-001,-001,-001,-001,-001,-001,-001,-001,-001,-001,-001,-001,-001,-001,-001,-001,-001,-001,-001],
	[-001,-001,-001,-001,-001,-001,-001,-001,-001,-001,-001,-001,-001,-001,-001,-001,-001,-001,-001,-001],
	[-001,-001,-001,-001,-001,-001,-001,-001,-001,-001,-001,-001,-001,-001,-001,-001,-001,-001,-001,-001],
	[-001,-001,-001,-001,-001,-001,-001,-001,-001,-001,-001,-001,-001,-001,-001,-001,-001,-001,-001,-001],
	[-001,-001,-001,-001,-001,-001,-001,-001,-001,-001,-001,-001,-001,-001,-001,-001,-001,-001,-001,-001],
	[-001,-001,-001,-001,-001,-001,-001,-001,-001,-001,-001,-001,-001,-001,-001,-001,-001,-001,-001,-001],
	[-001,-001,-001,-001,-001,-001,-001,-001,-001,-001,-001,-001,-001,-001,-001,-001,-001,-001,-001,-001],
	[-001,-001,-001,-001,-001,-001,-001,-001,-001,-001,-001,-001,-001,-001,-001,-001,-001,-001,-001,-001],
	[-001,-001,-001,-001,-001,-001,-001,-001,-001,-001,-001,-001,-001,-001,-001,-001,-001,-001,-001,-001]
	],
	"events": [
	{
		"id": 1,
		"nom": "EV001",
		"x": 3,
		"y": 7,
		"pages": [
		{
			"conditions": [
			{
				"nom": "ArriveeAuContact"
			}
			],
			"commandes": [
			{
				"nom": "ConditionVariable",
				"numeroVariable": 71,
				"inegalite": "==",
				"valeurQuIlEstCenseAvoir": 5,
				"comparerAUneAutreVariable": false,
				"numero": 0
			},
			{
				"nom": "ChangerDeMap",
				"variable": false,
				"numeroNouvelleMap": 470,
				"xDebutHeros": 16,
				"yDebutHeros": 8
			},
			{
				"nom": "ConditionSinon",
				"numero": 0
			},
			{
				"nom": "ConditionVariable",
				"numeroVariable": 72,
				"inegalite": "==",
				"valeurQuIlEstCenseAvoir": 5,
				"comparerAUneAutreVariable": false,
				"numero": 1
			},
			{
				"nom": "ChangerDeMap",
				"variable": false,
				"numeroNouvelleMap": 471,
				"xDebutHeros": 16,
				"yDebutHeros": 8
			},
			{
				"nom": "ConditionSinon",
				"numero": 1
			},
			{
				"nom": "ConditionVariable",
				"numeroVariable": 73,
				"inegalite": "==",
				"valeurQuIlEstCenseAvoir": 5,
				"comparerAUneAutreVariable": false,
				"numero": 2
			},
			{
				"nom": "ChangerDeMap",
				"variable": false,
				"numeroNouvelleMap": 472,
				"xDebutHeros": 16,
				"yDebutHeros": 8
			},
			{
				"nom": "ConditionSinon",
				"numero": 2
			},
			{
				"nom": "ConditionVariable",
				"numeroVariable": 74,
				"inegalite": "==",
				"valeurQuIlEstCenseAvoir": 5,
				"comparerAUneAutreVariable": false,
				"numero": 3
			},
			{
				"nom": "ChangerDeMap",
				"variable": false,
				"numeroNouvelleMap": 473,
				"xDebutHeros": 16,
				"yDebutHeros": 8
			},
			{
				"nom": "ConditionSinon",
				"numero": 3
			},
			{
				"nom": "ChangerDeMap",
				"variable": false,
				"numeroNouvelleMap": 474,
				"xDebutHeros": 16,
				"yDebutHeros": 8
			},
			{
				"nom": "ConditionFin",
				"numero": 3
			},
			{
				"nom": "ConditionFin",
				"numero": 2
			},
			{
				"nom": "ConditionFin",
				"numero": 1
			},
			{
				"nom": "ConditionFin",
				"numero": 0
			}
			],
			"vitesse": 8,
			"frequence": 8,
			"animeEnMouvement": true,
			"animeALArret": false,
			"directionFixe": false,
			"traversable": false,
			"auDessusDeTout": false
		}
		]
	}
	]
}
