{
	"nom": "extremité bas",
	"tileset": "Sanctuaire de Jishin",
	"largeur": 21,
	"hauteur": 20,
	"musique": {
		"nomFichierSonore": "",
		"volume": 1.00,
		"tempo": 1.00
	},
	"fondSonore": {
		"nomFichierSonore": "",
		"volume": 0.80,
		"tempo": 1.00
	},
	"couche0": [
	[0162,0162,0162,0162,0162,0162,0162,0162,0162,0162,0162,0162,0162,0162,0162,0162,0162,0162,0162,0162,0162],
	[0162,0162,0162,0162,0162,0162,0162,0162,0162,0162,0162,0162,0162,0162,0162,0162,0162,0162,0162,0162,0162],
	[0162,0162,0162,0162,0162,0162,0162,0162,0162,0162,0162,0162,0162,0162,0162,0162,0162,0162,0162,0162,0162],
	[0162,0162,0162,0162,0162,0162,0162,0140,0141,0161,0161,0161,0142,0143,0162,0162,0162,0162,0162,0162,0162],
	[0162,0162,0162,0162,0162,0162,0162,0148,0149,0161,0161,0161,0150,0151,0162,0162,0162,0162,0162,0162,0162],
	[0162,0162,0162,0162,0162,0140,0141,0146,0147,0161,0161,0161,0144,0145,0142,0143,0162,0162,0162,0162,0162],
	[0162,0162,0162,0162,0162,0148,0149,0154,0155,0161,0161,0161,0152,0153,0150,0151,0162,0162,0162,0162,0162],
	[0162,0162,0162,0162,0162,0110,0111,0161,0161,0161,0161,0161,0161,0161,0124,0125,0162,0162,0162,0162,0162],
	[0162,0162,0162,0162,0162,0118,0119,0161,0161,0161,0161,0161,0161,0161,0132,0133,0162,0162,0162,0162,0162],
	[0162,0162,0162,0162,0162,0110,0111,0161,0161,0171,0172,0173,0161,0161,0124,0125,0162,0162,0162,0162,0162],
	[0162,0162,0162,0162,0162,0118,0119,0161,0161,0179,0180,0181,0161,0161,0132,0133,0162,0162,0162,0162,0162],
	[0162,0162,0162,0162,0162,0110,0111,0161,0161,0187,0188,0189,0161,0161,0124,0125,0162,0162,0162,0162,0162],
	[0162,0162,0162,0162,0162,0118,0119,0161,0161,0161,0161,0161,0161,0161,0132,0133,0162,0162,0162,0162,0162],
	[0162,0162,0162,0162,0162,0110,0111,0161,0161,0161,0161,0161,0161,0161,0124,0125,0162,0162,0162,0162,0162],
	[0162,0162,0162,0162,0162,0156,0157,0126,0127,0126,0127,0126,0127,0126,0158,0159,0162,0162,0162,0162,0162],
	[0162,0162,0162,0162,0162,0164,0165,0134,0135,0134,0135,0134,0135,0134,0166,0167,0162,0162,0162,0162,0162],
	[0162,0162,0162,0162,0162,0162,0162,0162,0162,0162,0162,0162,0162,0162,0162,0162,0162,0162,0162,0162,0162],
	[0162,0162,0162,0162,0162,0162,0162,0162,0162,0162,0162,0162,0162,0162,0162,0162,0162,0162,0162,0162,0162],
	[0162,0162,0162,0162,0162,0162,0162,0162,0162,0162,0162,0162,0162,0162,0162,0162,0162,0162,0162,0162,0162],
	[0162,0162,0162,0162,0162,0162,0162,0162,0162,0162,0162,0162,0162,0162,0162,0162,0162,0162,0162,0162,0162]
	],
	"couche1": [
	[-001,-001,-001,-001,-001,-001,-001,-001,-001,-001,-001,-001,-001,-001,-001,-001,-001,-001,-001,-001,-001],
	[-001,-001,-001,-001,-001,-001,-001,-001,-001,-001,-001,-001,-001,-001,-001,-001,-001,-001,-001,-001,-001],
	[-001,-001,-001,-001,-001,-001,-001,-001,-001,0232,0232,0232,-001,-001,-001,-001,-001,-001,-001,-001,-001],
	[-001,-001,-001,-001,-001,-001,-001,-001,-001,0168,0169,0170,-001,-001,-001,-001,-001,-001,-001,-001,-001],
	[-001,-001,-001,-001,-001,-001,-001,-001,-001,0176,0177,0178,-001,-001,-001,-001,-001,-001,-001,-001,-001],
	[-001,-001,-001,-001,-001,-001,-001,-001,-001,-001,-001,-001,-001,-001,-001,-001,-001,-001,-001,-001,-001],
	[-001,-001,-001,-001,-001,-001,-001,-001,-001,-001,-001,-001,-001,-001,-001,-001,-001,-001,-001,-001,-001],
	[-001,-001,-001,-001,-001,-001,-001,-001,-001,-001,-001,-001,-001,-001,-001,-001,-001,-001,-001,-001,-001],
	[-001,-001,-001,-001,-001,-001,-001,-001,-001,-001,-001,-001,-001,-001,-001,-001,-001,-001,-001,-001,-001],
	[-001,-001,-001,-001,-001,-001,-001,-001,-001,-001,-001,-001,-001,-001,-001,-001,-001,-001,-001,-001,-001],
	[-001,-001,-001,-001,-001,-001,-001,-001,-001,-001,-001,-001,-001,-001,-001,-001,-001,-001,-001,-001,-001],
	[-001,-001,-001,-001,-001,-001,-001,-001,-001,-001,-001,-001,-001,-001,-001,-001,-001,-001,-001,-001,-001],
	[-001,-001,-001,-001,-001,-001,-001,-001,-001,-001,-001,-001,-001,-001,-001,-001,-001,-001,-001,-001,-001],
	[-001,-001,-001,-001,-001,-001,-001,-001,-001,-001,-001,-001,-001,-001,-001,-001,-001,-001,-001,-001,-001],
	[-001,-001,-001,-001,-001,-001,-001,-001,-001,-001,-001,-001,-001,-001,-001,-001,-001,-001,-001,-001,-001],
	[-001,-001,-001,-001,-001,-001,-001,-001,-001,-001,-001,-001,-001,-001,-001,-001,-001,-001,-001,-001,-001],
	[-001,-001,-001,-001,-001,-001,-001,-001,-001,-001,-001,-001,-001,-001,-001,-001,-001,-001,-001,-001,-001],
	[-001,-001,-001,-001,-001,-001,-001,-001,-001,-001,-001,-001,-001,-001,-001,-001,-001,-001,-001,-001,-001],
	[-001,-001,-001,-001,-001,-001,-001,-001,-001,-001,-001,-001,-001,-001,-001,-001,-001,-001,-001,-001,-001],
	[-001,-001,-001,-001,-001,-001,-001,-001,-001,-001,-001,-001,-001,-001,-001,-001,-001,-001,-001,-001,-001]
	],
	"couche2": [
	[-001,-001,-001,-001,-001,-001,-001,-001,-001,-001,-001,-001,-001,-001,-001,-001,-001,-001,-001,-001,-001],
	[-001,-001,-001,-001,-001,-001,-001,-001,-001,-001,-001,-001,-001,-001,-001,-001,-001,-001,-001,-001,-001],
	[-001,-001,-001,-001,-001,-001,-001,-001,-001,-001,-001,-001,-001,-001,-001,-001,-001,-001,-001,-001,-001],
	[-001,-001,-001,-001,-001,-001,-001,-001,-001,-001,-001,-001,-001,-001,-001,-001,-001,-001,-001,-001,-001],
	[-001,-001,-001,-001,-001,-001,-001,-001,-001,-001,-001,-001,-001,-001,-001,-001,-001,-001,-001,-001,-001],
	[-001,-001,-001,-001,-001,-001,-001,-001,-001,-001,-001,-001,-001,-001,-001,-001,-001,-001,-001,-001,-001],
	[-001,-001,-001,-001,-001,-001,-001,-001,-001,-001,-001,-001,-001,-001,-001,-001,-001,-001,-001,-001,-001],
	[-001,-001,-001,-001,-001,-001,-001,-001,-001,-001,-001,-001,-001,-001,-001,-001,-001,-001,-001,-001,-001],
	[-001,-001,-001,-001,-001,-001,-001,-001,-001,-001,-001,-001,-001,-001,-001,-001,-001,-001,-001,-001,-001],
	[-001,-001,-001,-001,-001,-001,-001,-001,-001,-001,-001,-001,-001,-001,-001,-001,-001,-001,-001,-001,-001],
	[-001,-001,-001,-001,-001,-001,-001,-001,-001,-001,-001,-001,-001,-001,-001,-001,-001,-001,-001,-001,-001],
	[-001,-001,-001,-001,-001,-001,-001,-001,-001,-001,-001,-001,-001,-001,-001,-001,-001,-001,-001,-001,-001],
	[-001,-001,-001,-001,-001,-001,-001,-001,-001,-001,-001,-001,-001,-001,-001,-001,-001,-001,-001,-001,-001],
	[-001,-001,-001,-001,-001,-001,-001,-001,-001,-001,-001,-001,-001,-001,-001,-001,-001,-001,-001,-001,-001],
	[-001,-001,-001,-001,-001,-001,-001,-001,-001,-001,-001,-001,-001,-001,-001,-001,-001,-001,-001,-001,-001],
	[-001,-001,-001,-001,-001,-001,-001,-001,-001,-001,-001,-001,-001,-001,-001,-001,-001,-001,-001,-001,-001],
	[-001,-001,-001,-001,-001,-001,-001,-001,-001,-001,-001,-001,-001,-001,-001,-001,-001,-001,-001,-001,-001],
	[-001,-001,-001,-001,-001,-001,-001,-001,-001,-001,-001,-001,-001,-001,-001,-001,-001,-001,-001,-001,-001],
	[-001,-001,-001,-001,-001,-001,-001,-001,-001,-001,-001,-001,-001,-001,-001,-001,-001,-001,-001,-001,-001],
	[-001,-001,-001,-001,-001,-001,-001,-001,-001,-001,-001,-001,-001,-001,-001,-001,-001,-001,-001,-001,-001]
	],
	"events": [
	{
		"id": 1,
		"nom": "EV001",
		"x": 10,
		"y": 3,
		"pages": [
		{
			"conditions": [
			{
				"nom": "ArriveeAuContact"
			}
			],
			"commandes": [
			{
				"nom": "ConditionVariable",
				"numeroVariable": 71,
				"inegalite": "==",
				"valeurQuIlEstCenseAvoir": 3,
				"comparerAUneAutreVariable": false,
				"numero": 0
			},
			{
				"nom": "ChangerDeMap",
				"variable": false,
				"numeroNouvelleMap": 470,
				"xDebutHeros": 10,
				"yDebutHeros": 14
			},
			{
				"nom": "ConditionSinon",
				"numero": 0
			},
			{
				"nom": "ConditionVariable",
				"numeroVariable": 72,
				"inegalite": "==",
				"valeurQuIlEstCenseAvoir": 3,
				"comparerAUneAutreVariable": false,
				"numero": 1
			},
			{
				"nom": "ChangerDeMap",
				"variable": false,
				"numeroNouvelleMap": 471,
				"xDebutHeros": 10,
				"yDebutHeros": 14
			},
			{
				"nom": "ConditionSinon",
				"numero": 1
			},
			{
				"nom": "ConditionVariable",
				"numeroVariable": 73,
				"inegalite": "==",
				"valeurQuIlEstCenseAvoir": 3,
				"comparerAUneAutreVariable": false,
				"numero": 2
			},
			{
				"nom": "ChangerDeMap",
				"variable": false,
				"numeroNouvelleMap": 472,
				"xDebutHeros": 10,
				"yDebutHeros": 14
			},
			{
				"nom": "ConditionSinon",
				"numero": 2
			},
			{
				"nom": "ConditionVariable",
				"numeroVariable": 74,
				"inegalite": "==",
				"valeurQuIlEstCenseAvoir": 3,
				"comparerAUneAutreVariable": false,
				"numero": 3
			},
			{
				"nom": "ChangerDeMap",
				"variable": false,
				"numeroNouvelleMap": 473,
				"xDebutHeros": 10,
				"yDebutHeros": 14
			},
			{
				"nom": "ConditionSinon",
				"numero": 3
			},
			{
				"nom": "ChangerDeMap",
				"variable": false,
				"numeroNouvelleMap": 474,
				"xDebutHeros": 10,
				"yDebutHeros": 14
			},
			{
				"nom": "ConditionFin",
				"numero": 3
			},
			{
				"nom": "ConditionFin",
				"numero": 2
			},
			{
				"nom": "ConditionFin",
				"numero": 1
			},
			{
				"nom": "ConditionFin",
				"numero": 0
			}
			],
			"vitesse": 8,
			"frequence": 8,
			"animeEnMouvement": true,
			"animeALArret": false,
			"directionFixe": false,
			"traversable": false,
			"auDessusDeTout": false
		}
		]
	}
	]
}
