{
	"nom": "extremité haut",
	"tileset": "Sanctuaire de Jishin",
	"largeur": 21,
	"hauteur": 15,
	"couche0": [
	[0162,0162,0162,0162,0162,0162,0162,0162,0162,0162,0162,0162,0162,0162,0162,0162,0162,0162,0162,0162,0162],
	[0162,0162,0162,0162,0162,0162,0162,0162,0162,0162,0162,0162,0162,0162,0162,0162,0162,0162,0162,0162,0162],
	[0162,0162,0162,0162,0162,0162,0162,0162,0162,0162,0162,0162,0162,0162,0162,0162,0162,0162,0162,0162,0162],
	[0162,0162,0162,0162,0162,0162,0162,0162,0162,0162,0162,0162,0162,0162,0162,0162,0162,0162,0162,0162,0162],
	[0162,0162,0162,0162,0162,0140,0141,0108,0109,0108,0109,0108,0109,0108,0142,0143,0162,0162,0162,0162,0162],
	[0162,0162,0162,0162,0162,0148,0149,0116,0117,0116,0117,0116,0117,0116,0150,0151,0162,0162,0162,0162,0162],
	[0162,0162,0162,0162,0162,0110,0111,0161,0161,0161,0161,0161,0161,0161,0124,0125,0162,0162,0162,0162,0162],
	[0162,0162,0162,0162,0162,0118,0119,0161,0161,0161,0161,0161,0161,0161,0132,0133,0162,0162,0162,0162,0162],
	[0162,0162,0162,0162,0162,0110,0111,0161,0161,0171,0172,0173,0161,0161,0124,0125,0162,0162,0162,0162,0162],
	[0162,0162,0162,0162,0162,0118,0119,0161,0161,0179,0180,0181,0161,0161,0132,0133,0162,0162,0162,0162,0162],
	[0162,0162,0162,0162,0162,0110,0111,0161,0161,0187,0188,0189,0161,0161,0124,0125,0162,0162,0162,0162,0162],
	[0140,0141,0109,0108,0109,0146,0147,0161,0161,0161,0161,0161,0161,0161,0144,0145,0108,0109,0108,0142,0143],
	[0148,0149,0117,0116,0117,0154,0155,0268,0268,0268,0268,0268,0268,0268,0152,0153,0116,0117,0116,0150,0151],
	[0110,0111,0308,0309,0294,0295,0294,0295,0294,0288,0289,0290,0294,0295,0294,0295,0294,0310,0311,0124,0125],
	[0118,0119,0316,0317,0302,0303,0302,0303,0302,0296,0297,0298,0302,0303,0302,0303,0302,0318,0319,0132,0133]
	],
	"couche1": [
	[-001,-001,-001,-001,-001,-001,-001,-001,-001,-001,-001,-001,-001,-001,-001,-001,-001,-001,-001,-001,-001],
	[-001,-001,-001,-001,-001,-001,-001,-001,-001,-001,-001,-001,-001,-001,-001,-001,-001,-001,-001,-001,-001],
	[-001,-001,-001,-001,-001,-001,-001,-001,-001,-001,-001,-001,-001,-001,-001,-001,-001,-001,-001,-001,-001],
	[-001,-001,-001,-001,-001,-001,-001,-001,-001,-001,-001,-001,-001,-001,-001,-001,-001,-001,-001,-001,-001],
	[-001,-001,-001,-001,-001,-001,-001,-001,-001,-001,-001,-001,-001,-001,-001,-001,-001,-001,-001,-001,-001],
	[-001,-001,-001,-001,-001,-001,-001,-001,-001,-001,-001,-001,-001,-001,-001,-001,-001,-001,-001,-001,-001],
	[-001,-001,-001,-001,-001,-001,-001,-001,-001,-001,-001,-001,-001,-001,-001,-001,-001,-001,-001,-001,-001],
	[-001,-001,-001,-001,-001,-001,-001,-001,-001,-001,-001,-001,-001,-001,-001,-001,-001,-001,-001,-001,-001],
	[-001,-001,-001,-001,-001,-001,-001,-001,-001,-001,-001,-001,-001,-001,-001,-001,-001,-001,-001,-001,-001],
	[-001,-001,-001,-001,-001,-001,-001,-001,-001,-001,-001,-001,-001,-001,-001,-001,-001,-001,-001,-001,-001],
	[-001,-001,-001,-001,-001,-001,-001,-001,-001,-001,-001,-001,-001,-001,-001,-001,-001,-001,-001,-001,-001],
	[-001,-001,-001,-001,-001,-001,-001,0291,-001,-001,-001,-001,-001,0275,-001,-001,-001,-001,-001,-001,-001],
	[-001,-001,-001,-001,-001,-001,-001,0299,-001,-001,-001,-001,-001,0283,-001,-001,-001,-001,-001,-001,-001],
	[-001,-001,-001,-001,-001,-001,-001,-001,-001,-001,-001,-001,-001,-001,-001,-001,-001,-001,-001,-001,-001],
	[-001,-001,-001,-001,-001,-001,-001,-001,-001,-001,-001,-001,-001,-001,-001,-001,-001,-001,-001,-001,-001]
	],
	"couche2": [
	[-001,-001,-001,-001,-001,-001,-001,-001,-001,-001,-001,-001,-001,-001,-001,-001,-001,-001,-001,-001,-001],
	[-001,-001,-001,-001,-001,-001,-001,-001,-001,-001,-001,-001,-001,-001,-001,-001,-001,-001,-001,-001,-001],
	[-001,-001,-001,-001,-001,-001,-001,-001,-001,-001,-001,-001,-001,-001,-001,-001,-001,-001,-001,-001,-001],
	[-001,-001,-001,-001,-001,-001,-001,-001,-001,-001,-001,-001,-001,-001,-001,-001,-001,-001,-001,-001,-001],
	[-001,-001,-001,-001,-001,-001,-001,-001,-001,-001,-001,-001,-001,-001,-001,-001,-001,-001,-001,-001,-001],
	[-001,-001,-001,-001,-001,-001,-001,-001,-001,-001,-001,-001,-001,-001,-001,-001,-001,-001,-001,-001,-001],
	[-001,-001,-001,-001,-001,-001,-001,-001,-001,-001,-001,-001,-001,-001,-001,-001,-001,-001,-001,-001,-001],
	[-001,-001,-001,-001,-001,-001,-001,-001,-001,-001,-001,-001,-001,-001,-001,-001,-001,-001,-001,-001,-001],
	[-001,-001,-001,-001,-001,-001,-001,-001,-001,-001,-001,-001,-001,-001,-001,-001,-001,-001,-001,-001,-001],
	[-001,-001,-001,-001,-001,-001,-001,-001,-001,-001,-001,-001,-001,-001,-001,-001,-001,-001,-001,-001,-001],
	[-001,-001,-001,-001,-001,-001,-001,-001,-001,-001,-001,-001,-001,-001,-001,-001,-001,-001,-001,-001,-001],
	[-001,-001,-001,-001,-001,-001,-001,-001,-001,-001,-001,-001,-001,-001,-001,-001,-001,-001,-001,-001,-001],
	[-001,-001,-001,-001,-001,-001,-001,-001,-001,-001,-001,-001,-001,-001,-001,-001,-001,-001,-001,-001,-001],
	[-001,-001,-001,-001,-001,-001,-001,-001,-001,-001,-001,-001,-001,-001,-001,-001,-001,-001,-001,-001,-001],
	[-001,-001,-001,-001,-001,-001,-001,-001,-001,-001,-001,-001,-001,-001,-001,-001,-001,-001,-001,-001,-001]
	],
	"events": [
	{
		"id": 5,
		"nom": "Clone[341][181]",
		"x": 8,
		"y": 6
	},
	{
		"id": 6,
		"nom": "Clone[341][181]",
		"x": 7,
		"y": 8
	},
	{
		"id": 1,
		"nom": "EV001",
		"x": 10,
		"y": 14,
		"pages": [
		{
			"conditions": [
			{
				"nom": "ArriveeAuContact"
			}
			],
			"commandes": [
			{
				"nom": "ConditionVariable",
				"numeroVariable": 71,
				"inegalite": "==",
				"valeurQuIlEstCenseAvoir": 1,
				"comparerAUneAutreVariable": false,
				"numero": 0
			},
			{
				"nom": "ChangerDeMap",
				"variable": false,
				"numeroNouvelleMap": 470,
				"xDebutHeros": 10,
				"yDebutHeros": 1
			},
			{
				"nom": "ConditionSinon",
				"numero": 0
			},
			{
				"nom": "ConditionVariable",
				"numeroVariable": 72,
				"inegalite": "==",
				"valeurQuIlEstCenseAvoir": 1,
				"comparerAUneAutreVariable": false,
				"numero": 1
			},
			{
				"nom": "ChangerDeMap",
				"variable": false,
				"numeroNouvelleMap": 471,
				"xDebutHeros": 10,
				"yDebutHeros": 1
			},
			{
				"nom": "ConditionSinon",
				"numero": 1
			},
			{
				"nom": "ConditionVariable",
				"numeroVariable": 73,
				"inegalite": "==",
				"valeurQuIlEstCenseAvoir": 1,
				"comparerAUneAutreVariable": false,
				"numero": 2
			},
			{
				"nom": "ChangerDeMap",
				"variable": false,
				"numeroNouvelleMap": 472,
				"xDebutHeros": 10,
				"yDebutHeros": 1
			},
			{
				"nom": "ConditionSinon",
				"numero": 2
			},
			{
				"nom": "ConditionVariable",
				"numeroVariable": 74,
				"inegalite": "==",
				"valeurQuIlEstCenseAvoir": 1,
				"comparerAUneAutreVariable": false,
				"numero": 3
			},
			{
				"nom": "ChangerDeMap",
				"variable": false,
				"numeroNouvelleMap": 473,
				"xDebutHeros": 10,
				"yDebutHeros": 1
			},
			{
				"nom": "ConditionSinon",
				"numero": 3
			},
			{
				"nom": "ChangerDeMap",
				"variable": false,
				"numeroNouvelleMap": 474,
				"xDebutHeros": 10,
				"yDebutHeros": 1
			},
			{
				"nom": "ConditionFin",
				"numero": 3
			},
			{
				"nom": "ConditionFin",
				"numero": 2
			},
			{
				"nom": "ConditionFin",
				"numero": 1
			},
			{
				"nom": "ConditionFin",
				"numero": 0
			}
			],
			"vitesse": "moderee",
			"frequence": "basse",
			"animeEnMouvement": true,
			"animeALArret": false,
			"directionFixe": false,
			"traversable": false,
			"auDessusDeTout": false
		}
		]
	},
	{
		"id": 2,
		"nom": "Clone[341][181]",
		"x": 13,
		"y": 6
	},
	{
		"id": 3,
		"nom": "Clone[341][181]",
		"x": 13,
		"y": 7
	},
	{
		"id": 4,
		"nom": "Clone[341][181]",
		"x": 12,
		"y": 6
	}
	]
}
