{
	"nom": "Salle 8 (vide)",
	"tileset": "Sanctuaire de Jishin",
	"largeur": 25,
	"hauteur": 22,
	"musique": {
		"nomFichierSonore": "",
		"volume": 1.00,
		"tempo": 1.00
	},
	"fondSonore": {
		"nomFichierSonore": "",
		"volume": 0.80,
		"tempo": 1.00
	},
	"couche0": [
	[-001,-001,-001,-001,-001,-001,-001,-001,-001,-001,-001,-001,-001,-001,-001,-001,-001,-001,-001,-001,-001,-001,-001,-001,-001],
	[-001,-001,-001,-001,-001,-001,-001,-001,-001,-001,-001,-001,-001,-001,-001,-001,-001,-001,-001,-001,-001,-001,-001,-001,-001],
	[-001,-001,-001,-001,0140,0141,0108,0197,0198,0199,0108,0109,0108,0109,0108,0109,0108,0109,0108,0142,0143,-001,-001,-001,-001],
	[-001,-001,-001,-001,0148,0149,0116,0205,0206,0207,0116,0117,0116,0117,0116,0117,0116,0117,0116,0150,0151,-001,-001,-001,-001],
	[-001,-001,-001,-001,0110,0111,0161,0161,0160,0160,0161,0161,0161,0161,0161,0160,0160,0161,0161,0124,0125,-001,-001,-001,-001],
	[-001,-001,-001,-001,0118,0119,0161,0161,0160,0160,0161,0161,0161,0161,0161,0160,0160,0161,0161,0132,0133,-001,-001,-001,-001],
	[-001,-001,-001,-001,0110,0111,0161,0161,0161,0161,0160,0161,0161,0161,0160,0161,0161,0161,0161,0230,0231,-001,-001,-001,-001],
	[-001,-001,-001,-001,0118,0119,0161,0161,0161,0161,0161,0160,0160,0160,0161,0161,0161,0161,0161,0238,0239,-001,-001,-001,-001],
	[-001,-001,-001,-001,0110,0111,0161,0161,0161,0161,0160,0160,0160,0160,0160,0161,0161,0161,0161,0246,0247,-001,-001,-001,-001],
	[-001,-001,-001,-001,0118,0119,0161,0161,0161,0160,0160,0160,0160,0160,0160,0160,0161,0161,0161,0132,0133,-001,-001,-001,-001],
	[-001,-001,-001,-001,0110,0111,0161,0161,0160,0161,0161,0161,0160,0161,0161,0161,0160,0161,0161,0124,0125,-001,-001,-001,-001],
	[-001,-001,-001,-001,0118,0119,0161,0161,0160,0161,0161,0161,0160,0161,0160,0160,0160,0161,0161,0132,0133,-001,-001,-001,-001],
	[-001,-001,-001,-001,0110,0111,0161,0161,0160,0160,0160,0161,0160,0161,0160,0160,0160,0161,0161,0124,0125,-001,-001,-001,-001],
	[-001,-001,-001,-001,0118,0119,0161,0161,0160,0160,0160,0161,0160,0161,0161,0161,0160,0161,0161,0132,0133,-001,-001,-001,-001],
	[-001,-001,-001,-001,0110,0111,0161,0161,0160,0161,0161,0161,0160,0160,0161,0161,0160,0161,0161,0124,0125,-001,-001,-001,-001],
	[-001,-001,-001,-001,0118,0119,0161,0161,0161,0160,0161,0161,0160,0160,0161,0160,0161,0161,0161,0132,0133,-001,-001,-001,-001],
	[-001,-001,-001,-001,0110,0111,0161,0161,0161,0161,0160,0160,0160,0160,0160,0161,0161,0161,0161,0124,0125,-001,-001,-001,-001],
	[-001,-001,-001,-001,0156,0157,0126,0127,0126,0127,0126,0127,0126,0127,0126,0127,0126,0127,0126,0158,0159,-001,-001,-001,-001],
	[-001,-001,-001,-001,0164,0165,0134,0135,0134,0135,0134,0135,0134,0135,0134,0135,0134,0135,0134,0166,0167,-001,-001,-001,-001],
	[-001,-001,-001,-001,-001,-001,-001,-001,-001,-001,-001,-001,-001,-001,-001,-001,-001,-001,-001,-001,-001,-001,-001,-001,-001],
	[-001,-001,-001,-001,-001,-001,-001,-001,-001,-001,-001,-001,-001,-001,-001,-001,-001,-001,-001,-001,-001,-001,-001,-001,-001],
	[-001,-001,-001,-001,-001,-001,-001,-001,-001,-001,-001,-001,-001,-001,-001,-001,-001,-001,-001,-001,-001,-001,-001,-001,-001]
	],
	"couche1": [
	[-001,-001,-001,-001,-001,-001,-001,-001,-001,-001,-001,-001,-001,-001,-001,-001,-001,-001,-001,-001,-001,-001,-001,-001,-001],
	[-001,-001,-001,-001,-001,-001,-001,0232,0232,0232,-001,-001,-001,-001,-001,-001,-001,-001,-001,-001,-001,-001,-001,-001,-001],
	[-001,-001,-001,-001,-001,-001,-001,-001,-001,-001,-001,-001,-001,-001,-001,-001,-001,-001,-001,-001,-001,-001,-001,-001,-001],
	[-001,-001,-001,-001,-001,-001,-001,-001,-001,-001,-001,-001,-001,-001,-001,-001,-001,-001,-001,-001,-001,-001,-001,-001,-001],
	[-001,-001,-001,-001,-001,-001,-001,-001,-001,-001,-001,-001,-001,-001,-001,-001,-001,-001,-001,-001,-001,-001,-001,-001,-001],
	[-001,-001,-001,-001,-001,-001,-001,-001,-001,-001,-001,-001,-001,-001,-001,-001,-001,-001,-001,-001,-001,-001,-001,-001,-001],
	[-001,-001,-001,-001,-001,-001,-001,-001,-001,-001,-001,-001,-001,-001,-001,-001,-001,-001,-001,-001,-001,-001,-001,-001,-001],
	[-001,-001,-001,-001,-001,-001,-001,-001,-001,-001,-001,-001,-001,-001,-001,-001,-001,-001,-001,-001,-001,-001,-001,-001,-001],
	[-001,-001,-001,-001,-001,-001,-001,-001,-001,-001,-001,-001,-001,-001,-001,-001,-001,-001,-001,-001,-001,-001,-001,-001,-001],
	[-001,-001,-001,-001,-001,-001,-001,-001,-001,-001,-001,-001,-001,-001,-001,-001,-001,-001,-001,-001,-001,-001,-001,-001,-001],
	[-001,-001,-001,-001,-001,-001,-001,-001,-001,-001,-001,-001,-001,-001,-001,-001,-001,-001,-001,-001,-001,-001,-001,-001,-001],
	[-001,-001,-001,-001,-001,-001,-001,-001,-001,-001,-001,-001,-001,-001,-001,-001,-001,-001,-001,-001,-001,-001,-001,-001,-001],
	[-001,-001,-001,-001,-001,-001,-001,-001,-001,-001,-001,-001,-001,-001,-001,-001,-001,-001,-001,-001,-001,-001,-001,-001,-001],
	[-001,-001,-001,-001,-001,-001,-001,-001,-001,-001,-001,-001,-001,-001,-001,-001,-001,-001,-001,-001,-001,-001,-001,-001,-001],
	[-001,-001,-001,-001,-001,-001,-001,-001,-001,-001,-001,-001,-001,-001,-001,-001,-001,-001,-001,-001,-001,-001,-001,-001,-001],
	[-001,-001,-001,-001,-001,-001,-001,-001,-001,-001,-001,-001,-001,-001,-001,-001,-001,-001,-001,-001,-001,-001,-001,-001,-001],
	[-001,-001,-001,-001,-001,-001,-001,-001,-001,-001,-001,-001,-001,-001,-001,-001,-001,-001,-001,-001,-001,-001,-001,-001,-001],
	[-001,-001,-001,-001,-001,-001,-001,-001,-001,-001,-001,-001,-001,-001,-001,-001,-001,-001,-001,-001,-001,-001,-001,-001,-001],
	[-001,-001,-001,-001,-001,-001,-001,-001,-001,-001,-001,-001,-001,-001,-001,-001,-001,-001,-001,-001,-001,-001,-001,-001,-001],
	[-001,-001,-001,-001,-001,-001,-001,-001,-001,-001,-001,-001,-001,-001,-001,-001,-001,-001,-001,-001,-001,-001,-001,-001,-001],
	[-001,-001,-001,-001,-001,-001,-001,-001,-001,-001,-001,-001,-001,-001,-001,-001,-001,-001,-001,-001,-001,-001,-001,-001,-001],
	[-001,-001,-001,-001,-001,-001,-001,-001,-001,-001,-001,-001,-001,-001,-001,-001,-001,-001,-001,-001,-001,-001,-001,-001,-001]
	],
	"couche2": [
	[-001,-001,-001,-001,-001,-001,-001,-001,-001,-001,-001,-001,-001,-001,-001,-001,-001,-001,-001,-001,-001,-001,-001,-001,-001],
	[-001,-001,-001,-001,-001,-001,-001,-001,-001,-001,-001,-001,-001,-001,-001,-001,-001,-001,-001,-001,-001,-001,-001,-001,-001],
	[-001,-001,-001,-001,-001,-001,-001,-001,-001,-001,-001,-001,-001,-001,-001,-001,-001,-001,-001,-001,-001,-001,-001,-001,-001],
	[-001,-001,-001,-001,-001,-001,-001,-001,-001,-001,-001,-001,-001,-001,-001,-001,-001,-001,-001,-001,-001,-001,-001,-001,-001],
	[-001,-001,-001,-001,-001,-001,-001,-001,-001,-001,-001,-001,-001,-001,-001,-001,-001,-001,-001,-001,-001,-001,-001,-001,-001],
	[-001,-001,-001,-001,-001,-001,-001,-001,-001,-001,-001,-001,-001,-001,-001,-001,-001,-001,-001,-001,-001,-001,-001,-001,-001],
	[-001,-001,-001,-001,-001,-001,-001,-001,-001,-001,-001,-001,-001,-001,-001,-001,-001,-001,-001,-001,-001,-001,-001,-001,-001],
	[-001,-001,-001,-001,-001,-001,-001,-001,-001,-001,-001,-001,-001,-001,-001,-001,-001,-001,-001,-001,-001,-001,-001,-001,-001],
	[-001,-001,-001,-001,-001,-001,-001,-001,-001,-001,-001,-001,-001,-001,-001,-001,-001,-001,-001,-001,-001,-001,-001,-001,-001],
	[-001,-001,-001,-001,-001,-001,-001,-001,-001,-001,-001,-001,-001,-001,-001,-001,-001,-001,-001,-001,-001,-001,-001,-001,-001],
	[-001,-001,-001,-001,-001,-001,-001,-001,-001,-001,-001,-001,-001,-001,-001,-001,-001,-001,-001,-001,-001,-001,-001,-001,-001],
	[-001,-001,-001,-001,-001,-001,-001,-001,-001,-001,-001,-001,-001,-001,-001,-001,-001,-001,-001,-001,-001,-001,-001,-001,-001],
	[-001,-001,-001,-001,-001,-001,-001,-001,-001,-001,-001,-001,-001,-001,-001,-001,-001,-001,-001,-001,-001,-001,-001,-001,-001],
	[-001,-001,-001,-001,-001,-001,-001,-001,-001,-001,-001,-001,-001,-001,-001,-001,-001,-001,-001,-001,-001,-001,-001,-001,-001],
	[-001,-001,-001,-001,-001,-001,-001,-001,-001,-001,-001,-001,-001,-001,-001,-001,-001,-001,-001,-001,-001,-001,-001,-001,-001],
	[-001,-001,-001,-001,-001,-001,-001,-001,-001,-001,-001,-001,-001,-001,-001,-001,-001,-001,-001,-001,-001,-001,-001,-001,-001],
	[-001,-001,-001,-001,-001,-001,-001,-001,-001,-001,-001,-001,-001,-001,-001,-001,-001,-001,-001,-001,-001,-001,-001,-001,-001],
	[-001,-001,-001,-001,-001,-001,-001,-001,-001,-001,-001,-001,-001,-001,-001,-001,-001,-001,-001,-001,-001,-001,-001,-001,-001],
	[-001,-001,-001,-001,-001,-001,-001,-001,-001,-001,-001,-001,-001,-001,-001,-001,-001,-001,-001,-001,-001,-001,-001,-001,-001],
	[-001,-001,-001,-001,-001,-001,-001,-001,-001,-001,-001,-001,-001,-001,-001,-001,-001,-001,-001,-001,-001,-001,-001,-001,-001],
	[-001,-001,-001,-001,-001,-001,-001,-001,-001,-001,-001,-001,-001,-001,-001,-001,-001,-001,-001,-001,-001,-001,-001,-001,-001],
	[-001,-001,-001,-001,-001,-001,-001,-001,-001,-001,-001,-001,-001,-001,-001,-001,-001,-001,-001,-001,-001,-001,-001,-001,-001]
	],
	"events": [
	{
		"id": 5,
		"nom": "Clone[21][54]",
		"x": 18,
		"y": 12
	},
	{
		"id": 6,
		"nom": "Clone[21][54]",
		"x": 13,
		"y": 16
	},
	{
		"id": 1,
		"nom": "EV001",
		"x": 20,
		"y": 7,
		"pages": [
		{
			"conditions": [
			{
				"nom": "ArriveeAuContact"
			}
			],
			"commandes": [
			{
				"nom": "ChangerDeMap",
				"variable": false,
				"numeroNouvelleMap": 485,
				"xDebutHeros": 5,
				"yDebutHeros": 7
			}
			],
			"vitesse": 8,
			"frequence": 8,
			"animeEnMouvement": true,
			"animeALArret": false,
			"directionFixe": false,
			"traversable": false,
			"auDessusDeTout": false
		}
		]
	},
	{
		"id": 7,
		"nom": "Clone[21][54]",
		"x": 6,
		"y": 14
	},
	{
		"id": 2,
		"nom": "EV002",
		"x": 8,
		"y": 2,
		"pages": [
		{
			"conditions": [
			{
				"nom": "ArriveeAuContact"
			}
			],
			"commandes": [
			{
				"nom": "ChangerDeMap",
				"variable": false,
				"numeroNouvelleMap": 495,
				"xDebutHeros": 8,
				"yDebutHeros": 16
			}
			],
			"vitesse": 8,
			"frequence": 8,
			"animeEnMouvement": true,
			"animeALArret": false,
			"directionFixe": false,
			"traversable": false,
			"auDessusDeTout": false
		}
		]
	},
	{
		"id": 3,
		"nom": "Mur (32)",
		"x": 19,
		"y": 7,
		"pages": [
		{
			"conditions": [
			],
			"commandes": [
			{
				"nom": "ConditionArmeEquipee",
				"idArme": 2,
				"numero": 0
			},
			{
				"nom": "ConditionScript",
				"script": "$game_player.target_in_da_zone?(@event_id,0)",
				"numero": 1
			},
			{
				"nom": "ConditionTouche",
				"touche": "ACTION",
				"numero": 2
			},
			{
				"nom": "Attendre",
				"nombreDeFrames": 1
			},
			{
				"nom": "ConditionTouche",
				"touche": "ACTION",
				"numero": 3
			},
			{
				"nom": "TremblementDeTerre",
				"intensite": 5,
				"vitesse": 9,
				"nombreDeFrames": 20
			},
			{
				"nom": "JouerEffetSonore",
				"nomFichierSonore": "129-Earth01.ogg",
				"volume": 1.00,
				"tempo": 1.00
			},
			{
				"nom": "Deplacement",
				"ignorerLesMouvementsImpossibles": false,
				"repeterLeDeplacement": false,
				"attendreLaFinDuDeplacement": false,
				"mouvements": [
				{
					"nom": "RendreTraversable",
					"traversable": true
				},
				{
					"nom": "ModifierApparence",
					"image": "mur casse character",
					"direction": 1,
					"animation": 0,
					"teinte": 0
				}
				]
			},
			{
				"nom": "JouerAnimation",
				"idAnimation": 37
			},
			{
				"nom": "Attendre",
				"nombreDeFrames": 10
			},
			{
				"nom": "JouerEffetMusical",
				"nomFichierSonore": "Fanfare (paquerette).mp3",
				"volume": 1.00,
				"tempo": 1.00
			},
			{
				"nom": "ModifierInterrupteurLocal",
				"numeroInterrupteurLocal": 0,
				"valeurADonner": true
			},
			{
				"nom": "ConditionFin",
				"numero": 3
			},
			{
				"nom": "ConditionFin",
				"numero": 2
			},
			{
				"nom": "ConditionFin",
				"numero": 1
			},
			{
				"nom": "ConditionFin",
				"numero": 0
			},
			{
				"nom": "Attendre",
				"nombreDeFrames": 1
			}
			],
			"image": "mur character",
			"directionInitiale": 1,
			"vitesse": 8,
			"frequence": 8,
			"animeEnMouvement": false,
			"animeALArret": false,
			"directionFixe": true,
			"traversable": false,
			"auDessusDeTout": false
		},
		{
			"conditions": [
			{
				"nom": "Parler"
			},
			{
				"nom": "InterrupteurLocal",
				"numeroMap": 496,
				"numeroEvent": 3,
				"numeroInterrupteurLocal": 0,
				"valeurQuIlEstCenseAvoir": true
			}
			],
			"commandes": [
			],
			"image": "mur casse character",
			"directionInitiale": 1,
			"vitesse": 8,
			"frequence": 8,
			"animeEnMouvement": false,
			"animeALArret": false,
			"directionFixe": true,
			"traversable": true,
			"auDessusDeTout": true
		}
		]
	},
	{
		"id": 4,
		"nom": "mur",
		"x": 8,
		"y": 3,
		"pages": [
		{
			"conditions": [
			{
				"nom": "Parler"
			}
			],
			"commandes": [
			],
			"image": "mur casse character",
			"vitesse": 8,
			"frequence": 8,
			"animeEnMouvement": false,
			"animeALArret": false,
			"directionFixe": true,
			"traversable": true,
			"auDessusDeTout": true
		}
		]
	}
	]
}
