{
	"nom": "Chemins glacés",
	"tileset": "Zone Enneigée",
	"largeur": 41,
	"hauteur": 40,
	"musique": {
		"nomFichierSonore": "",
		"volume": 1.00,
		"tempo": 1.00
	},
	"fondSonore": {
		"nomFichierSonore": "",
		"volume": 0.80,
		"tempo": 1.00
	},
	"couche0": [
	[0168,0168,0168,0168,0168,0168,0168,0168,0168,0168,0168,0168,0168,0168,0168,0168,0168,0168,0184,0000,0188,0168,0168,0168,0168,0168,0168,0168,0168,0168,0168,0168,0168,0168,0168,0168,0168,0168,0168,0168,0168],
	[0168,0168,0168,0168,0168,0168,0168,0168,0168,0168,0168,0168,0168,0168,0168,0168,0168,0168,0184,0000,0188,0168,0168,0168,0168,0168,0168,0168,0168,0168,0168,0168,0168,0168,0168,0168,0168,0168,0168,0168,0168],
	[0168,0168,0168,0168,0168,0168,0168,0168,0168,0168,0168,0168,0168,0168,0168,0168,0168,0168,0184,0000,0188,0168,0168,0168,0168,0168,0168,0168,0168,0168,0168,0168,0168,0168,0168,0168,0168,0168,0168,0168,0168],
	[0168,0168,0168,0168,0168,0168,0168,0168,0168,0168,0168,0168,0168,0168,0168,0168,0168,0168,0184,0000,0188,0168,0168,0168,0168,0168,0168,0168,0168,0168,0168,0168,0168,0168,0168,0168,0168,0168,0168,0168,0168],
	[0168,0168,0168,0168,0168,0168,0168,0168,0168,0168,0168,0168,0168,0168,0168,0168,0168,0168,0184,0000,0188,0168,0168,0168,0168,0168,0168,0168,0168,0168,0168,0168,0168,0168,0168,0168,0168,0168,0168,0168,0168],
	[0168,0168,0168,0168,0168,0168,0168,0168,0168,0168,0168,0168,0168,0168,0168,0168,0168,0169,0177,0000,0179,0180,0168,0168,0168,0168,0168,0168,0168,0168,0168,0168,0168,0168,0168,0168,0168,0168,0168,0168,0168],
	[0168,0168,0168,0168,0168,0168,0168,0168,0168,0168,0168,0168,0168,0168,0168,0168,0168,0184,0009,0011,0013,0188,0168,0168,0169,0170,0170,0170,0180,0168,0168,0168,0168,0168,0168,0168,0168,0168,0168,0168,0168],
	[0168,0168,0168,0168,0168,0168,0168,0168,0168,0168,0169,0170,0170,0170,0180,0168,0168,0184,0024,0000,0038,0188,0168,0168,0184,0009,0012,0013,0188,0168,0168,0168,0168,0168,0168,0168,0168,0168,0168,0168,0168],
	[0168,0168,0168,0168,0168,0168,0169,0170,0170,0170,0177,0189,0190,0000,0179,0170,0170,0177,0024,0000,0038,0179,0170,0170,0177,0032,0000,0030,0188,0168,0168,0168,0168,0168,0168,0168,0168,0168,0168,0168,0168],
	[0168,0168,0168,0168,0168,0168,0184,0000,0000,0000,0000,0000,0000,0000,0009,0011,0011,0011,0017,0000,0021,0011,0011,0011,0011,0017,0000,0030,0188,0168,0169,0170,0170,0170,0170,0170,0180,0168,0168,0168,0168],
	[0168,0168,0168,0168,0168,0168,0184,0000,0195,0202,0202,0193,0009,0011,0017,0000,-008,-008,-008,-008,0000,-008,-008,-008,-008,0008,0000,0030,0188,0168,0184,0009,0010,0003,0012,0013,0188,0168,0168,0168,0168],
	[0168,0168,0168,0168,0168,0168,0184,0000,0188,0168,0168,0184,0024,0000,-008,-008,-008,-008,-008,-008,-008,-008,-008,-008,-008,-008,0000,0030,0188,0168,0184,0032,0000,0000,0000,0038,0188,0168,0168,0168,0168],
	[0168,0168,0168,0168,0168,0168,0184,0000,0188,0168,0168,0184,0024,0008,-008,-008,-008,-008,-008,-008,-008,-008,-008,0008,-008,-008,0000,0030,0188,0168,0184,0032,0000,0000,0000,0038,0188,0168,0168,0168,0168],
	[0168,0168,0168,0168,0168,0168,0184,0000,0188,0168,0168,0184,0024,-008,-008,-008,-008,-008,-008,-008,-008,-008,-008,-008,-008,-008,-008,0030,0188,0168,0184,0032,0000,0000,0000,0038,0188,0168,0168,0168,0168],
	[0168,0168,0168,0168,0168,0169,0177,0000,0179,0180,0168,0184,0024,-008,0008,0052,-008,-008,-008,-008,-008,-008,-008,-008,-008,-008,-008,0030,0188,0168,0184,0057,0058,0059,0060,0061,0188,0168,0168,0168,0168],
	[0168,0168,0168,0168,0168,0184,0009,0011,0013,0188,0168,0184,0024,-008,-008,-008,-008,-008,-008,0000,-008,-008,-008,-008,-008,-008,-008,0030,0188,0168,0201,0202,0202,0202,0202,0202,0196,0168,0168,0168,0168],
	[0168,0168,0168,0168,0168,0184,0024,0000,0038,0188,0168,0184,0024,-008,-008,-008,-008,-008,-008,-008,-008,0052,0008,-008,-008,-008,-008,0030,0179,0180,0168,0168,0168,0168,0168,0168,0168,0168,0168,0168,0168],
	[0168,0168,0168,0168,0168,0184,0032,0000,0038,0188,0168,0184,0024,0008,-008,-008,-008,-008,-008,-008,-008,-008,-008,0008,-008,-008,-008,0021,0022,0188,0168,0168,0168,0168,0168,0168,0168,0168,0168,0168,0168],
	[0168,0168,0168,0168,0168,0184,0032,0000,0038,0188,0168,0184,0057,0059,0059,0059,0059,0059,0049,-008,0053,0059,0059,0059,0059,0049,0000,0000,0030,0179,0180,0168,0168,0168,0168,0168,0168,0168,0168,0168,0168],
	[0168,0168,0168,0168,0168,0184,0032,0000,0038,0188,0168,0201,0202,0202,0202,0202,0202,0193,0032,-008,0038,0195,0202,0202,0193,0032,0000,0000,0021,0022,0188,0168,0168,0168,0168,0168,0168,0168,0168,0168,0168],
	[0168,0168,0168,0168,0168,0184,0032,0000,0038,0188,0168,0168,0168,0168,0168,0168,0168,0184,0032,-008,0038,0188,0168,0168,0184,0032,0000,0000,0000,0030,0188,0168,0168,0168,0168,0168,0168,0168,0168,0168,0168],
	[0168,0168,0168,0168,0168,0184,0032,0000,0038,0188,0168,0168,0168,0168,0168,0168,0168,0184,0032,-008,0038,0188,0168,0168,0184,0032,0000,0000,0000,0030,0188,0168,0168,0168,0168,0168,0168,0168,0168,0168,0168],
	[0168,0168,0168,0168,0168,0184,0032,0000,0038,0188,0168,0168,0168,0168,0168,0168,0168,0184,0032,-008,0038,0188,0168,0168,0184,0057,0049,0000,0053,0054,0188,0168,0168,0168,0168,0168,0168,0168,0168,0168,0168],
	[0168,0168,0168,0168,0168,0184,0032,-008,0038,0188,0168,0168,0168,0168,0168,0168,0168,0184,0032,-008,0038,0188,0168,0168,0201,0193,0032,0000,0038,0195,0196,0168,0168,0168,0168,0168,0168,0168,0168,0168,0168],
	[0168,0168,0168,0168,0168,0184,0032,-008,0038,0188,0168,0168,0168,0168,0168,0168,0168,0184,0032,-008,0038,0188,0168,0168,0168,0184,0032,0000,0038,0179,0170,0170,0171,0168,0168,0168,0168,0168,0168,0168,0168],
	[0168,0168,0168,0168,0168,0184,0032,-008,0038,0179,0170,0170,0170,0180,0168,0168,0168,0184,0032,-008,0038,0188,0168,0168,0168,0184,0032,0000,0021,0011,0011,0022,0188,0172,0168,0168,0168,0168,0168,0168,0168],
	[0168,0168,0168,0168,0169,0177,0032,-008,0038,0000,0000,0000,0052,0188,0168,0168,0168,0184,0032,-008,0038,0188,0168,0168,0168,0184,0032,-008,-008,-008,-008,0038,0179,0170,0180,0168,0168,0168,0168,0168,0168],
	[0168,0168,0168,0168,0184,0009,0017,-008,0021,0011,0022,0000,0000,0188,0168,0168,0169,0177,0032,-008,0038,0179,0180,0168,0168,0184,0032,0008,-008,-008,-008,0021,0012,0022,0188,0168,0168,0168,0168,0168,0168],
	[0168,0168,0168,0168,0184,0032,0000,-008,-008,0000,0038,0000,0000,0188,0168,0168,0184,0009,0017,-008,0021,0022,0188,0168,0168,0184,0032,-008,-008,-008,-008,-008,-008,0038,0188,0168,0168,0168,0168,0168,0168],
	[0168,0168,0168,0168,0184,0032,-008,-008,-008,-008,0038,0000,0000,0179,0170,0170,0177,0032,-008,-008,-008,0038,0179,0170,0170,0177,0032,-008,-008,0008,-008,-008,-008,0038,0188,0168,0168,0168,0168,0168,0168],
	[0168,0168,0168,0168,0184,0032,-008,-008,-008,-008,0021,0011,0018,0011,0011,0011,0011,0017,-008,0000,-008,0021,0011,0011,0011,0011,0017,-008,0000,-008,-008,0000,-008,0038,0188,0168,0168,0168,0168,0168,0168],
	[0168,0168,0168,0168,0184,0032,0000,-008,-008,-008,-008,-008,-008,-008,-008,-008,-008,-008,-008,0000,-008,-008,-008,-008,-008,-008,-008,-008,-008,-008,-008,-008,0000,0038,0188,0168,0168,0168,0168,0168,0168],
	[0168,0168,0168,0168,0184,0032,0000,0000,0000,0053,0059,0059,0059,0059,0059,0059,0059,0049,-008,-008,-008,0053,0059,0059,0059,0059,0049,-008,0008,-008,-008,-008,0000,0038,0188,0168,0168,0168,0168,0168,0168],
	[0168,0168,0168,0168,0184,0057,0059,0059,0059,0061,0195,0202,0202,0202,0202,0202,0193,0032,0000,0000,0000,0038,0195,0202,0202,0193,0057,0059,0059,0059,0059,0059,0059,0054,0188,0168,0168,0168,0168,0168,0168],
	[0168,0168,0168,0168,0201,0202,0202,0202,0202,0202,0203,0168,0168,0168,0168,0168,0184,0057,0049,0000,0053,0061,0188,0168,0168,0201,0202,0202,0202,0202,0202,0202,0202,0202,0196,0168,0168,0168,0168,0168,0168],
	[0168,0168,0168,0168,0168,0168,0168,0168,0168,0168,0168,0168,0168,0168,0168,0168,0192,0193,0032,0000,0038,0195,0203,0168,0168,0168,0168,0168,0168,0168,0168,0168,0168,0168,0168,0168,0168,0168,0168,0168,0168],
	[0168,0168,0168,0168,0168,0168,0168,0168,0168,0168,0168,0168,0168,0168,0168,0168,0168,0184,0032,0000,0038,0188,0168,0168,0168,0168,0168,0168,0168,0168,0168,0168,0168,0168,0168,0168,0168,0168,0168,0168,0168],
	[0168,0168,0168,0168,0168,0168,0168,0168,0168,0168,0168,0168,0168,0168,0168,0168,0168,0184,0032,0000,0038,0188,0168,0168,0168,0168,0168,0168,0168,0168,0168,0168,0168,0168,0168,0168,0168,0168,0168,0168,0168],
	[0168,0168,0168,0168,0168,0168,0168,0168,0168,0168,0168,0168,0168,0168,0168,0168,0168,0184,0032,0000,0038,0188,0168,0168,0168,0168,0168,0168,0168,0168,0168,0168,0168,0168,0168,0168,0168,0168,0168,0168,0168],
	[0168,0168,0168,0168,0168,0168,0168,0168,0168,0168,0168,0168,0168,0168,0168,0168,0168,0184,0032,0000,0038,0188,0168,0168,0168,0168,0168,0168,0168,0168,0168,0168,0168,0168,0168,0168,0168,0168,0168,0168,0168]
	],
	"couche1": [
	[-001,-001,-001,-001,-001,-001,-001,-001,-001,-001,-001,-001,-001,-001,-001,-001,-001,-001,-001,-001,-001,-001,-001,-001,-001,-001,-001,-001,-001,-001,-001,-001,-001,-001,-001,-001,-001,-001,-001,-001,-001],
	[-001,-001,-001,-001,-001,-001,-001,-001,-001,-001,-001,-001,-001,-001,-001,-001,-001,-001,-001,-001,-001,-001,-001,-001,-001,-001,-001,-001,-001,-001,-001,-001,-001,-001,-001,-001,-001,-001,-001,-001,-001],
	[-001,-001,-001,-001,-001,-001,-001,-001,-001,-001,-001,-001,-001,-001,-001,-001,-001,-001,-001,-001,-001,-001,-001,-001,-001,-001,-001,-001,-001,-001,-001,-001,-001,-001,-001,-001,-001,-001,-001,-001,-001],
	[-001,-001,-001,-001,-001,-001,-001,-001,-001,-001,-001,-001,-001,-001,-001,-001,-001,-001,-001,-001,-001,-001,-001,-001,-001,-001,-001,-001,-001,-001,-001,-001,-001,-001,-001,-001,-001,-001,-001,-001,-001],
	[-001,-001,-001,-001,-001,-001,-001,-001,-001,-001,-001,-001,-001,-001,-001,-001,-001,-001,-001,-001,-001,-001,-001,-001,-001,-001,-001,-001,-001,-001,-001,-001,-001,-001,-001,-001,-001,-001,-001,-001,-001],
	[-001,-001,-001,-001,-001,-001,-001,-001,-001,-001,-001,-001,-001,-001,-001,-001,-001,-001,-001,-001,-001,-001,-001,-001,-001,-001,-001,-001,-001,-001,-001,-001,-001,-001,-001,-001,-001,-001,-001,-001,-001],
	[-001,-001,-001,-001,-001,-001,-001,-001,-001,-001,-001,-001,-001,-001,-001,-001,-001,-001,-001,-005,-001,-001,-001,-001,-001,-001,-001,-001,-001,-001,-001,-001,-001,-001,-001,-001,-001,-001,-001,-001,-001],
	[-001,-001,-001,-001,-001,-001,-001,-001,-001,-001,-001,0181,0182,0123,-001,-001,-001,-001,-001,-001,-001,-001,-001,-001,-001,-001,-001,-001,-001,-001,-001,-001,-001,-001,-001,-001,-001,-001,-001,-001,-001],
	[-001,-001,-001,-001,-001,-001,-001,-001,-001,-001,-001,-001,-001,0131,-001,-001,-001,-001,-001,-001,-001,-001,-001,-001,-001,-001,-001,-001,-001,-001,-001,-001,-001,-001,-001,-001,-001,-001,-001,-001,-001],
	[-001,-001,-001,-001,-001,-001,-001,-001,-001,-001,0139,-001,-001,-001,-001,-001,-001,-001,-001,-001,-001,-001,-001,-001,-001,-001,-001,-001,-001,-001,-001,-001,-001,-001,-001,-001,-001,-001,-001,-001,-001],
	[-001,-001,-001,-001,-001,-001,-001,-001,-001,-001,-001,-001,-001,-005,-001,-001,-001,-001,-001,-001,-001,-001,-001,-001,-001,-001,-001,-001,-001,-001,-001,-001,-001,0004,0123,-001,-001,-001,-001,-001,-001],
	[-001,-001,-001,-001,-001,-001,-001,-001,-001,-001,-001,-001,-001,-001,-001,-001,-001,-001,-001,-001,-001,-001,-001,-001,-001,-001,0197,0198,-001,-001,-001,-001,0139,-001,0131,-001,-001,-001,-001,-001,-001],
	[-001,-001,-001,-001,-001,-001,-001,-001,-001,-001,-001,-001,-001,-001,-001,-001,-001,-001,-001,-001,-001,-001,-001,-001,-001,-001,0205,0206,-001,-001,-001,-001,0123,-001,-001,-001,-001,-001,-001,-001,-001],
	[-001,-001,-001,-001,-001,-001,-001,-001,-001,-001,-001,-001,-001,-001,-001,0044,-001,-001,-001,-001,-001,-001,-001,-001,-001,-001,-001,-001,-001,-001,-001,-001,0131,0139,-001,-001,-001,-001,-001,-001,-001],
	[-001,-001,-001,-001,-001,-001,-001,-001,-001,-001,-001,-001,-001,-001,-001,-001,-001,-001,-001,-001,-001,-001,-001,-001,-001,-001,-001,-001,-001,-001,-001,-001,-001,-001,-001,-001,-001,-001,-001,-001,-001],
	[-001,-001,-001,-001,-001,-001,-001,-005,-001,-001,-001,-001,-001,-001,-001,-001,-001,-001,-001,-001,-001,0044,-001,-001,-001,-001,-001,-001,-001,-001,-001,-001,-001,-001,-001,-001,-001,-001,-001,-001,-001],
	[-001,-001,-001,-001,-001,-001,-001,-001,-001,-001,-001,-001,-001,-001,-001,-001,-001,-001,-001,-001,-001,-001,-001,-001,-001,-001,-001,-001,-001,-001,-001,-001,-001,-001,-001,-001,-001,-001,-001,-001,-001],
	[-001,-001,-001,-001,-001,-001,-001,-001,-001,-001,-001,-001,-001,-001,-001,-001,-001,-001,-001,-001,-001,-001,-001,-001,-001,-001,-001,0123,-001,-001,-001,-001,-001,-001,-001,-001,-001,-001,-001,-001,-001],
	[-001,-001,-001,-001,-001,-001,-001,-001,-001,-001,-001,-001,-001,-001,-001,-001,-001,-001,-001,-001,-001,-001,-001,-001,-001,-001,-001,0131,-001,-001,-001,-001,-001,-001,-001,-001,-001,-001,-001,-001,-001],
	[-001,-001,-001,-001,-001,-001,-001,-001,-001,-001,-001,-001,-001,-001,-001,-001,-001,-001,-001,-001,-001,-001,-001,-001,-001,-001,0139,-001,0124,-001,-001,-001,-001,-001,-001,-001,-001,-001,-001,-001,-001],
	[-001,-001,-001,-001,-001,-001,-001,-001,-001,-001,-001,-001,-001,-001,-001,-001,-001,-001,-001,-001,-001,-001,-001,-001,-001,-001,-001,-001,0132,-001,-001,-001,-001,-001,-001,-001,-001,-001,-001,-001,-001],
	[-001,-001,-001,-001,-001,-001,-001,-001,-001,-001,-001,-001,-001,-001,-001,-001,-001,-001,-001,-001,-001,-001,-001,-001,-001,-001,-001,-001,-001,-001,-001,-001,-001,-001,-001,-001,-001,-001,-001,-001,-001],
	[-001,-001,-001,-001,-001,-001,-001,-001,-001,-001,-001,-001,-001,-001,-001,-001,-001,-001,-001,-001,-001,-001,-001,-001,-001,-001,-001,-001,-001,-001,-001,-001,-001,-001,-001,-001,-001,-001,-001,-001,-001],
	[-001,-001,-001,-001,-001,-001,-001,-001,-001,-001,-001,-001,-001,-001,-001,-001,-001,-001,-001,-001,-001,-001,-001,-001,-001,-001,-001,-001,-001,-001,-001,-001,-001,-001,-001,-001,-001,-001,-001,-001,-001],
	[-001,-001,-001,-001,-001,-001,-001,-001,-001,-001,-001,-001,-001,-001,-001,-001,-001,-001,-001,-001,-001,-001,-001,-001,-001,-001,-001,-001,-001,-001,-001,-001,-001,-001,-001,-001,-001,-001,-001,-001,-001],
	[-001,-001,-001,-001,-001,-001,-001,-001,-001,-001,-001,-001,0044,-001,-001,-001,-001,-001,-001,-001,-001,-001,-001,-001,-001,-001,-001,-001,-001,-001,-001,-001,-001,-001,-001,-001,-001,-001,-001,-001,-001],
	[-001,-001,-001,-001,-001,-001,-001,-001,-001,-001,-001,-001,-001,-001,-001,-001,-001,-001,-001,-001,-001,-001,-001,-001,-001,-001,-001,-001,-001,-001,-001,-001,-001,-001,-001,-001,-001,-001,-001,-001,-001],
	[-001,-001,-001,-001,-001,-001,-001,-001,-001,-005,-001,-001,-001,-001,-001,-001,-001,-001,-001,-001,-001,-001,-001,-001,-001,-001,-001,-001,-001,-001,-001,-001,-001,-001,-001,-001,-001,-001,-001,-001,-001],
	[-001,-001,-001,-001,-001,-001,-001,-001,-001,-001,-001,-001,-001,-001,-001,-001,-001,-001,-001,-001,-001,-001,-001,-001,-001,-001,-001,-001,-001,-001,-001,-001,-001,-001,-001,-001,-001,-001,-001,-001,-001],
	[-001,-001,-001,-001,-001,-001,-001,-001,-001,-001,-001,-001,-001,-001,-001,-001,-001,-001,-001,0197,0198,-001,-001,-001,-001,-001,-001,-001,-001,-001,-001,-001,-001,-001,-001,-001,-001,-001,-001,-001,-001],
	[-001,-001,-001,-001,-001,-001,-001,-001,-001,-001,-001,-001,-001,-001,-001,-001,-001,-001,-001,0205,0206,-001,-001,-001,-001,-001,-001,-001,-001,-001,-001,-001,-001,-001,-001,-001,-001,-001,-001,-001,-001],
	[-001,-001,-001,-001,-001,-001,-001,-001,-001,-001,-001,-001,-001,-001,-001,-001,-001,-001,-001,-001,-001,-001,-001,-001,-001,-001,-001,-001,-001,-001,-001,-001,-001,-001,-001,-001,-001,-001,-001,-001,-001],
	[-001,-001,-001,-001,-001,-001,-001,-001,-001,-001,-001,-001,0050,-001,-001,-001,-001,-001,-001,-001,-001,-001,-001,-001,-001,-001,-001,-001,-001,-001,-001,-001,-001,-001,-001,-001,-001,-001,-001,-001,-001],
	[-001,-001,-001,-001,-001,-001,-001,-001,-001,-001,-001,-001,-001,-001,-001,-001,-001,-001,-001,-001,-001,-001,-001,-001,-001,-001,-001,-001,-001,-001,-001,-001,-001,-001,-001,-001,-001,-001,-001,-001,-001],
	[-001,-001,-001,-001,-001,-001,-001,-001,-001,-001,-001,-001,-001,-001,-001,-001,-001,-001,-001,-001,-001,-001,-001,-001,-001,-001,-001,-001,-001,-001,-001,-001,-001,-001,-001,-001,-001,-001,-001,-001,-001],
	[-001,-001,-001,-001,-001,-001,-001,-001,-001,-001,-001,-001,-001,-001,-001,-001,-001,-001,-001,-001,-001,-001,-001,-001,-001,-001,-001,-001,-001,-001,-001,-001,-001,-001,-001,-001,-001,-001,-001,-001,-001],
	[-001,-001,-001,-001,-001,-001,-001,-001,-001,-001,-001,-001,-001,-001,-001,-001,-001,-001,-001,-001,-001,-001,-001,-001,-001,-001,-001,-001,-001,-001,-001,-001,-001,-001,-001,-001,-001,-001,-001,-001,-001],
	[-001,-001,-001,-001,-001,-001,-001,-001,-001,-001,-001,-001,-001,-001,-001,-001,-001,-001,-001,-001,-001,-001,-001,-001,-001,-001,-001,-001,-001,-001,-001,-001,-001,-001,-001,-001,-001,-001,-001,-001,-001],
	[-001,-001,-001,-001,-001,-001,-001,-001,-001,-001,-001,-001,-001,-001,-001,-001,-001,-001,-001,-001,-001,-001,-001,-001,-001,-001,-001,-001,-001,-001,-001,-001,-001,-001,-001,-001,-001,-001,-001,-001,-001],
	[-001,-001,-001,-001,-001,-001,-001,-001,-001,-001,-001,-001,-001,-001,-001,-001,-001,-001,-001,-001,-001,-001,-001,-001,-001,-001,-001,-001,-001,-001,-001,-001,-001,-001,-001,-001,-001,-001,-001,-001,-001]
	],
	"couche2": [
	[-001,-001,-001,-001,-001,-001,-001,-001,-001,-001,-001,-001,-001,-001,-001,-001,-001,-001,-001,-001,-001,-001,-001,-001,-001,-001,-001,-001,-001,-001,-001,-001,-001,-001,-001,-001,-001,-001,-001,-001,-001],
	[-001,-001,-001,-001,-001,-001,-001,-001,-001,-001,-001,-001,-001,-001,-001,-001,-001,-001,-001,-001,-001,-001,-001,-001,-001,-001,-001,-001,-001,-001,-001,-001,-001,-001,-001,-001,-001,-001,-001,-001,-001],
	[-001,-001,-001,-001,-001,-001,-001,-001,-001,-001,-001,-001,-001,-001,-001,-001,-001,-001,-001,-001,-001,-001,-001,-001,-001,-001,-001,-001,-001,-001,-001,-001,-001,-001,-001,-001,-001,-001,-001,-001,-001],
	[-001,-001,-001,-001,-001,-001,-001,-001,-001,-001,-001,-001,-001,-001,-001,-001,-001,-001,-001,-001,-001,-001,-001,-001,-001,-001,-001,-001,-001,-001,-001,-001,-001,-001,-001,-001,-001,-001,-001,-001,-001],
	[-001,-001,-001,-001,-001,-001,-001,-001,-001,-001,-001,-001,-001,-001,-001,-001,-001,-001,-001,-001,-001,-001,-001,-001,-001,-001,-001,-001,-001,-001,-001,-001,-001,-001,-001,-001,-001,-001,-001,-001,-001],
	[-001,-001,-001,-001,-001,-001,-001,-001,-001,-001,-001,-001,-001,-001,-001,-001,-001,-001,-001,-001,-001,-001,-001,-001,-001,-001,-001,-001,-001,-001,-001,-001,-001,-001,-001,-001,-001,-001,-001,-001,-001],
	[-001,-001,-001,-001,-001,-001,-001,-001,-001,-001,-001,-001,-001,-001,-001,-001,-001,-001,-001,-001,-001,-001,-001,-001,-001,-001,-001,-001,-001,-001,-001,-001,-001,-001,-001,-001,-001,-001,-001,-001,-001],
	[-001,-001,-001,-001,-001,-001,-001,-001,-001,-001,-001,-001,-001,-001,-001,-001,-001,-001,-001,-001,-001,-001,-001,-001,-001,-001,-001,-001,-001,-001,-001,-001,-001,-001,-001,-001,-001,-001,-001,-001,-001],
	[-001,-001,-001,-001,-001,-001,-001,-001,-001,-001,-001,-001,-001,-001,-001,-001,-001,-001,-001,-001,-001,-001,-001,-001,-001,-001,-001,-001,-001,-001,-001,-001,-001,-001,-001,-001,-001,-001,-001,-001,-001],
	[-001,-001,-001,-001,-001,-001,-001,-001,-001,-001,-001,-001,-001,-001,-001,-001,-001,-001,-001,-001,-001,-001,-001,-001,-001,-001,-001,-001,-001,-001,-001,-001,-001,-001,-001,-001,-001,-001,-001,-001,-001],
	[-001,-001,-001,-001,-001,-001,-001,-001,-001,-001,-001,-001,-001,-001,-001,-001,-001,-001,-001,-001,-001,-001,-001,-001,-001,-001,-001,-001,-001,-001,-001,-001,-001,-001,-001,-001,-001,-001,-001,-001,-001],
	[-001,-001,-001,-001,-001,-001,-001,-001,-001,-001,-001,-001,-001,-001,-001,-001,-001,-001,-001,-001,-001,-001,-001,-001,-001,-001,-001,-001,-001,-001,-001,-001,-001,-001,-001,-001,-001,-001,-001,-001,-001],
	[-001,-001,-001,-001,-001,-001,-001,-001,-001,-001,-001,-001,-001,-001,-001,-001,-001,-001,-001,-001,-001,-001,-001,-001,-001,-001,-001,-001,-001,-001,-001,-001,-001,-001,-001,-001,-001,-001,-001,-001,-001],
	[-001,-001,-001,-001,-001,-001,-001,-001,-001,-001,-001,-001,-001,-001,-001,-001,-001,-001,-001,-001,-001,-001,-001,-001,-001,-001,-001,-001,-001,-001,-001,-001,-001,-001,-001,-001,-001,-001,-001,-001,-001],
	[-001,-001,-001,-001,-001,-001,-001,-001,-001,-001,-001,-001,-001,-001,-001,-001,-001,-001,-001,-001,-001,-001,-001,-001,-001,-001,-001,-001,-001,-001,-001,-001,-001,-001,-001,-001,-001,-001,-001,-001,-001],
	[-001,-001,-001,-001,-001,-001,-001,-001,-001,-001,-001,-001,-001,-001,-001,-001,-001,-001,-001,-001,-001,-001,-001,-001,-001,-001,-001,-001,-001,-001,-001,-001,-001,-001,-001,-001,-001,-001,-001,-001,-001],
	[-001,-001,-001,-001,-001,-001,-001,-001,-001,-001,-001,-001,-001,-001,-001,-001,-001,-001,-001,-001,-001,-001,-001,-001,-001,-001,-001,-001,-001,-001,-001,-001,-001,-001,-001,-001,-001,-001,-001,-001,-001],
	[-001,-001,-001,-001,-001,-001,-001,-001,-001,-001,-001,-001,-001,-001,-001,-001,-001,-001,-001,-001,-001,-001,-001,-001,-001,-001,-001,-001,-001,-001,-001,-001,-001,-001,-001,-001,-001,-001,-001,-001,-001],
	[-001,-001,-001,-001,-001,-001,-001,-001,-001,-001,-001,-001,-001,-001,-001,-001,-001,-001,-001,-001,-001,-001,-001,-001,-001,-001,-001,-001,-001,-001,-001,-001,-001,-001,-001,-001,-001,-001,-001,-001,-001],
	[-001,-001,-001,-001,-001,-001,-001,-001,-001,-001,-001,-001,-001,-001,-001,-001,-001,-001,-001,-001,-001,-001,-001,-001,-001,-001,-001,-001,-001,-001,-001,-001,-001,-001,-001,-001,-001,-001,-001,-001,-001],
	[-001,-001,-001,-001,-001,-001,-001,-001,-001,-001,-001,-001,-001,-001,-001,-001,-001,-001,-001,-001,-001,-001,-001,-001,-001,-001,-001,-001,-001,-001,-001,-001,-001,-001,-001,-001,-001,-001,-001,-001,-001],
	[-001,-001,-001,-001,-001,-001,-001,-001,-001,-001,-001,-001,-001,-001,-001,-001,-001,-001,-001,-001,-001,-001,-001,-001,-001,-001,-001,-001,-001,-001,-001,-001,-001,-001,-001,-001,-001,-001,-001,-001,-001],
	[-001,-001,-001,-001,-001,-001,-001,-001,-001,-001,-001,-001,-001,-001,-001,-001,-001,-001,-001,-001,-001,-001,-001,-001,-001,-001,-001,-001,-001,-001,-001,-001,-001,-001,-001,-001,-001,-001,-001,-001,-001],
	[-001,-001,-001,-001,-001,-001,-001,-001,-001,-001,-001,-001,-001,-001,-001,-001,-001,-001,-001,-001,-001,-001,-001,-001,-001,-001,-001,-001,-001,-001,-001,-001,-001,-001,-001,-001,-001,-001,-001,-001,-001],
	[-001,-001,-001,-001,-001,-001,-001,-001,-001,-001,-001,-001,-001,-001,-001,-001,-001,-001,-001,-001,-001,-001,-001,-001,-001,-001,-001,-001,-001,-001,-001,-001,-001,-001,-001,-001,-001,-001,-001,-001,-001],
	[-001,-001,-001,-001,-001,-001,-001,-001,-001,-001,-001,-001,-001,-001,-001,-001,-001,-001,-001,-001,-001,-001,-001,-001,-001,-001,-001,-001,-001,-001,-001,-001,-001,-001,-001,-001,-001,-001,-001,-001,-001],
	[-001,-001,-001,-001,-001,-001,-001,-001,-001,-001,-001,-001,-001,-001,-001,-001,-001,-001,-001,-001,-001,-001,-001,-001,-001,-001,-001,-001,-001,-001,-001,-001,-001,-001,-001,-001,-001,-001,-001,-001,-001],
	[-001,-001,-001,-001,-001,-001,-001,-001,-001,-001,-001,-001,-001,-001,-001,-001,-001,-001,-001,-001,-001,-001,-001,-001,-001,-001,-001,-001,-001,-001,-001,-001,-001,-001,-001,-001,-001,-001,-001,-001,-001],
	[-001,-001,-001,-001,-001,-001,-001,-001,-001,-001,-001,-001,-001,-001,-001,-001,-001,-001,-001,-001,-001,-001,-001,-001,-001,-001,-001,-001,-001,-001,-001,-001,-001,-001,-001,-001,-001,-001,-001,-001,-001],
	[-001,-001,-001,-001,-001,-001,-001,-001,-001,-001,-001,-001,-001,-001,-001,-001,-001,-001,-001,-001,-001,-001,-001,-001,-001,-001,-001,-001,-001,-001,-001,-001,-001,-001,-001,-001,-001,-001,-001,-001,-001],
	[-001,-001,-001,-001,-001,-001,-001,-001,-001,-001,-001,-001,-001,-001,-001,-001,-001,-001,-001,-001,-001,-001,-001,-001,-001,-001,-001,-001,-001,-001,-001,-001,-001,-001,-001,-001,-001,-001,-001,-001,-001],
	[-001,-001,-001,-001,-001,-001,-001,-001,-001,-001,-001,-001,-001,-001,-001,-001,-001,-001,-001,-001,-001,-001,-001,-001,-001,-001,-001,-001,-001,-001,-001,-001,-001,-001,-001,-001,-001,-001,-001,-001,-001],
	[-001,-001,-001,-001,-001,-001,-001,-001,-001,-001,-001,-001,-001,-001,-001,-001,-001,-001,-001,-001,-001,-001,-001,-001,-001,-001,-001,-001,-001,-001,-001,-001,-001,-001,-001,-001,-001,-001,-001,-001,-001],
	[-001,-001,-001,-001,-001,-001,-001,-001,-001,-001,-001,-001,-001,-001,-001,-001,-001,-001,-001,-001,-001,-001,-001,-001,-001,-001,-001,-001,-001,-001,-001,-001,-001,-001,-001,-001,-001,-001,-001,-001,-001],
	[-001,-001,-001,-001,-001,-001,-001,-001,-001,-001,-001,-001,-001,-001,-001,-001,-001,-001,-001,-001,-001,-001,-001,-001,-001,-001,-001,-001,-001,-001,-001,-001,-001,-001,-001,-001,-001,-001,-001,-001,-001],
	[-001,-001,-001,-001,-001,-001,-001,-001,-001,-001,-001,-001,-001,-001,-001,-001,-001,-001,-001,-001,-001,-001,-001,-001,-001,-001,-001,-001,-001,-001,-001,-001,-001,-001,-001,-001,-001,-001,-001,-001,-001],
	[-001,-001,-001,-001,-001,-001,-001,-001,-001,-001,-001,-001,-001,-001,-001,-001,-001,-001,-001,-001,-001,-001,-001,-001,-001,-001,-001,-001,-001,-001,-001,-001,-001,-001,-001,-001,-001,-001,-001,-001,-001],
	[-001,-001,-001,-001,-001,-001,-001,-001,-001,-001,-001,-001,-001,-001,-001,-001,-001,-001,-001,-001,-001,-001,-001,-001,-001,-001,-001,-001,-001,-001,-001,-001,-001,-001,-001,-001,-001,-001,-001,-001,-001],
	[-001,-001,-001,-001,-001,-001,-001,-001,-001,-001,-001,-001,-001,-001,-001,-001,-001,-001,-001,-001,-001,-001,-001,-001,-001,-001,-001,-001,-001,-001,-001,-001,-001,-001,-001,-001,-001,-001,-001,-001,-001],
	[-001,-001,-001,-001,-001,-001,-001,-001,-001,-001,-001,-001,-001,-001,-001,-001,-001,-001,-001,-001,-001,-001,-001,-001,-001,-001,-001,-001,-001,-001,-001,-001,-001,-001,-001,-001,-001,-001,-001,-001,-001]
	],
	"events": [
	{
		"id": 165,
		"nom": "EV165",
		"x": 19,
		"y": 0,
		"pages": [
		{
			"conditions": [
			{
				"nom": "ArriveeAuContact"
			}
			],
			"commandes": [
			{
				"nom": "ChangerDeMap",
				"variable": false,
				"numeroNouvelleMap": 520,
				"xDebutHeros": 13,
				"yDebutHeros": 23
			}
			],
			"vitesse": "moderee",
			"frequence": "basse",
			"animeEnMouvement": true,
			"animeALArret": false,
			"directionFixe": false,
			"traversable": false,
			"auDessusDeTout": false
		}
		]
	},
	{
		"id": 166,
		"nom": "EV166",
		"x": 33,
		"y": 10,
		"pages": [
		{
			"conditions": [
			{
				"nom": "ArriveeAuContact"
			}
			],
			"commandes": [
			{
				"nom": "ChangerDeMap",
				"variable": false,
				"numeroNouvelleMap": 520,
				"xDebutHeros": 34,
				"yDebutHeros": 21
			}
			],
			"vitesse": "moderee",
			"frequence": "basse",
			"animeEnMouvement": true,
			"animeALArret": false,
			"directionFixe": false,
			"traversable": false,
			"auDessusDeTout": false
		}
		]
	},
	{
		"id": 1,
		"nom": "EV001",
		"x": 19,
		"y": 39,
		"pages": [
		{
			"conditions": [
			{
				"nom": "ArriveeAuContact"
			}
			],
			"commandes": [
			{
				"nom": "ChangerDeMap",
				"variable": false,
				"numeroNouvelleMap": 647,
				"xDebutHeros": 18,
				"yDebutHeros": 1
			}
			],
			"vitesse": "moderee",
			"frequence": "basse",
			"animeEnMouvement": true,
			"animeALArret": false,
			"directionFixe": false,
			"traversable": false,
			"auDessusDeTout": false
		}
		]
	},
	{
		"id": 2,
		"nom": "Clone[341][006]",
		"x": 26,
		"y": 8
	},
	{
		"id": 168,
		"nom": "EV168",
		"x": 12,
		"y": 25,
		"pages": [
		{
			"conditions": [
			{
				"nom": "Parler"
			}
			],
			"commandes": [
			],
			"image": 44,
			"vitesse": "moderee",
			"frequence": "basse",
			"animeEnMouvement": false,
			"animeALArret": false,
			"directionFixe": true,
			"traversable": true,
			"auDessusDeTout": true
		}
		]
	},
	{
		"id": 3,
		"nom": "activer le verglas",
		"x": 20,
		"y": 38,
		"pages": [
		{
			"conditions": [
			],
			"commandes": [
			{
				"nom": "ModifierMeteo",
				"type": "neige",
				"intensite": 9
			},
			{
				"nom": "ModifierInterrupteur",
				"numeroInterrupteur": 36,
				"valeur": true
			},
			{
				"nom": "AppelerPageCommune",
				"numeroPageCommune": 55
			},
			{
				"nom": "SupprimerEvent"
			}
			],
			"vitesse": "tres rapide",
			"frequence": "la plus haute",
			"animeEnMouvement": false,
			"animeALArret": false,
			"directionFixe": false,
			"traversable": true,
			"auDessusDeTout": false
		}
		]
	},
	{
		"id": 4,
		"nom": "Clone[341][006]",
		"x": 33,
		"y": 12
	}
	]
}
