{
	"nom": "Chemins glacés",
	"tileset": "Zone Enneigée",
	"largeur": 41,
	"hauteur": 40,
	"couche0": [
	[0168,0168,0168,0168,0168,0168,0168,0168,0168,0168,0168,0168,0168,0168,0168,0168,0168,0168,0168,0168,0168,0168,0168,0168,0168,0168,0168,0168,0168,0168,0168,0168,0168,0168,0168,0168,0168,0168,0168,0168,0168],
	[0168,0168,0168,0168,0168,0168,0168,0168,0168,0168,0168,0168,0168,0168,0168,0168,0168,0168,0168,0168,0168,0168,0168,0168,0168,0168,0168,0168,0168,0168,0168,0168,0168,0168,0168,0168,0168,0168,0168,0168,0168],
	[0168,0168,0168,0168,0168,0168,0168,0168,0168,0168,0168,0168,0168,0168,0168,0168,0168,0168,0168,0168,0168,0168,0168,0168,0168,0168,0168,0168,0168,0168,0168,0168,0168,0168,0168,0168,0168,0168,0168,0168,0168],
	[0168,0168,0168,0168,0168,0168,0168,0168,0168,0168,0168,0168,0168,0168,0168,0168,0168,0168,0168,0168,0168,0168,0168,0168,0168,0168,0168,0168,0168,0168,0168,0168,0168,0168,0168,0168,0168,0168,0168,0168,0168],
	[0168,0168,0168,0168,0168,0168,0168,0168,0168,0168,0168,0168,0168,0168,0168,0168,0168,0168,0168,0168,0168,0168,0168,0168,0168,0168,0168,0168,0168,0168,0168,0168,0168,0168,0168,0168,0168,0168,0168,0168,0168],
	[0168,0168,0168,0168,0168,0168,0168,0168,0168,0168,0168,0168,0168,0168,0168,0168,0168,0169,0170,0170,0170,0180,0168,0168,0168,0168,0168,0168,0168,0168,0168,0168,0168,0168,0168,0168,0168,0168,0168,0168,0168],
	[0168,0168,0168,0168,0168,0168,0168,0168,0168,0169,0170,0170,0170,0170,0170,0180,0168,0184,0009,0003,0013,0188,0168,0168,0169,0170,0170,0170,0180,0168,0168,0168,0168,0168,0168,0168,0168,0168,0168,0168,0168],
	[0168,0168,0168,0168,0168,0168,0169,0170,0170,0177,0009,0011,0011,0011,0013,0188,0168,0184,0024,0000,0038,0188,0168,0168,0184,0009,0012,0013,0188,0168,0168,0168,0168,0168,0168,0168,0168,0168,0168,0168,0168],
	[0168,0168,0168,0168,0168,0168,0184,0009,0011,0011,0017,0189,0190,0000,0038,0179,0170,0177,0024,0000,0038,0179,0170,0170,0177,0032,0000,0030,0188,0168,0168,0168,0168,0168,0168,0168,0168,0168,0168,0168,0168],
	[0168,0168,0168,0168,0168,0168,0184,0032,0000,0000,0000,0001,0002,0000,0021,0011,0011,0011,0017,0000,0021,0011,0011,0011,0011,0017,0000,0030,0188,0168,0168,0168,0168,0168,0168,0168,0168,0168,0168,0168,0168],
	[0168,0168,0168,0168,0168,0168,0184,0032,0000,0053,0059,0059,0049,0000,0008,0000,-008,-008,-008,-008,0000,-008,-008,-008,-008,0008,0000,0030,0188,0168,0168,0168,0168,0168,0168,0168,0168,0168,0168,0168,0168],
	[0168,0168,0168,0168,0168,0168,0184,0032,0000,0038,0053,0049,0024,0000,-008,-008,-008,-008,-008,-008,-008,-008,-008,-008,-008,-008,0000,0030,0188,0168,0168,0168,0168,0168,0168,0168,0168,0168,0168,0168,0168],
	[0168,0168,0168,0168,0168,0168,0184,0032,0000,0038,0038,0024,0024,0008,-008,-008,-008,-008,-008,-008,-008,-008,-008,0008,-008,-008,0000,0030,0188,0168,0168,0168,0168,0168,0168,0168,0168,0168,0168,0168,0168],
	[0168,0168,0168,0168,0168,0168,0184,0032,0000,0038,0038,0024,0024,-008,-008,-008,-008,-008,-008,-008,-008,-008,-008,-008,-008,-008,-008,0030,0188,0168,0168,0168,0168,0168,0168,0168,0168,0168,0168,0168,0168],
	[0168,0168,0168,0168,0168,0168,0184,0032,0000,0038,0038,0024,0024,-008,0008,0052,-008,-008,-008,-008,-008,-008,-008,-008,-008,-008,-008,0030,0188,0168,0168,0168,0168,0168,0168,0168,0168,0168,0168,0168,0168],
	[0168,0168,0168,0168,0168,0169,0177,0024,0000,0038,0038,0024,0024,-008,-008,-008,-008,-008,-008,0000,-008,-008,-008,-008,-008,-008,-008,0030,0188,0168,0168,0168,0168,0168,0168,0168,0168,0168,0168,0168,0168],
	[0168,0168,0168,0168,0168,0184,0009,0017,0000,0038,0038,0024,0024,-008,-008,-008,-008,-008,-008,-008,-008,0052,0008,-008,-008,-008,-008,0030,0179,0180,0168,0168,0168,0168,0168,0168,0168,0168,0168,0168,0168],
	[0168,0168,0168,0168,0168,0184,0032,0000,0000,0038,0038,0024,0024,0008,-008,-008,-008,-008,-008,-008,-008,-008,-008,0008,-008,-008,-008,0021,0022,0188,0168,0168,0168,0168,0168,0168,0168,0168,0168,0168,0168],
	[0168,0168,0168,0168,0168,0184,0032,0000,0053,0054,0038,0024,0057,0059,0059,0059,0059,0059,0049,-008,0053,0059,0059,0059,0059,0049,0000,0000,0030,0179,0180,0168,0168,0168,0168,0168,0168,0168,0168,0168,0168],
	[0168,0168,0168,0168,0168,0184,0032,0000,0038,0053,0054,0057,0059,0059,0059,0059,0059,0049,0032,-008,0038,0195,0202,0202,0193,0032,0000,0000,0021,0022,0188,0168,0168,0168,0168,0168,0168,0168,0168,0168,0168],
	[0168,0168,0168,0168,0168,0184,0032,0000,0038,0038,0195,0202,0202,0202,0202,0202,0193,0032,0032,-008,0038,0188,0168,0168,0184,0032,0000,0000,0000,0030,0188,0168,0168,0168,0168,0168,0168,0168,0168,0168,0168],
	[0168,0168,0168,0168,0168,0184,0032,0000,0038,0038,0188,0168,0168,0168,0168,0168,0184,0032,0032,-008,0038,0188,0168,0168,0184,0032,0000,0000,0000,0030,0188,0168,0168,0168,0168,0168,0168,0168,0168,0168,0168],
	[0168,0168,0168,0168,0168,0184,0032,0000,0038,0038,0188,0168,0168,0168,0168,0168,0184,0032,0032,-008,0038,0188,0168,0168,0184,0057,0049,0000,0053,0054,0188,0168,0168,0168,0168,0168,0168,0168,0168,0168,0168],
	[0168,0168,0168,0168,0168,0184,0032,-008,0038,0038,0188,0168,0168,0168,0168,0168,0184,0032,0032,-008,0038,0188,0168,0168,0201,0193,0032,0000,0038,0195,0196,0168,0168,0168,0168,0168,0168,0168,0168,0168,0168],
	[0168,0168,0168,0168,0168,0184,0032,-008,0038,0038,0179,0170,0170,0170,0180,0168,0184,0032,0032,-008,0038,0188,0168,0168,0168,0184,0032,0000,0038,0179,0170,0170,0171,0168,0168,0168,0168,0168,0168,0168,0168],
	[0168,0168,0168,0168,0168,0184,0032,-008,0038,0021,0011,0011,0011,0022,0188,0168,0184,0032,0032,-008,0038,0188,0168,0168,0168,0184,0032,0000,0021,0011,0011,0022,0188,0172,0168,0168,0168,0168,0168,0168,0168],
	[0168,0168,0168,0168,0169,0177,0032,-008,0038,0000,0000,0000,0052,0038,0188,0169,0177,0032,0032,-008,0038,0188,0168,0168,0168,0184,0032,-008,-008,-008,-008,0038,0179,0170,0180,0168,0168,0168,0168,0168,0168],
	[0168,0168,0168,0168,0184,0009,0017,-008,0021,0011,0022,0000,0000,0038,0188,0184,0009,0017,0032,-008,0038,0179,0180,0168,0168,0184,0032,0008,-008,-008,-008,0021,0012,0022,0188,0168,0168,0168,0168,0168,0168],
	[0168,0168,0168,0168,0184,0032,0000,-008,-008,0000,0038,0000,0000,0038,0179,0177,0032,0009,0017,-008,0021,0022,0188,0168,0168,0184,0032,-008,-008,-008,-008,-008,-008,0038,0188,0168,0168,0168,0168,0168,0168],
	[0168,0168,0168,0168,0184,0032,-008,-008,-008,-008,0038,0000,0000,0021,0011,0011,0017,0032,-008,-008,-008,0038,0179,0170,0170,0177,0032,-008,-008,0008,-008,-008,-008,0038,0188,0168,0168,0168,0168,0168,0168],
	[0168,0168,0168,0168,0184,0032,-008,-008,-008,-008,0021,0011,0018,0011,0011,0011,0011,0017,-008,0000,-008,0021,0011,0011,0011,0011,0017,-008,0000,-008,-008,0000,-008,0038,0188,0168,0168,0168,0168,0168,0168],
	[0168,0168,0168,0168,0184,0032,0000,-008,-008,-008,-008,-008,-008,-008,-008,-008,-008,-008,-008,0000,-008,-008,-008,-008,-008,-008,-008,-008,-008,-008,-008,-008,0000,0038,0188,0168,0168,0168,0168,0168,0168],
	[0168,0168,0168,0168,0184,0032,0000,0000,0000,0053,0059,0059,0059,0059,0059,0059,0059,0049,-008,-008,-008,0053,0059,0059,0059,0059,0049,-008,0008,-008,-008,-008,0000,0038,0188,0168,0168,0168,0168,0168,0168],
	[0168,0168,0168,0168,0184,0057,0059,0059,0059,0061,0195,0202,0202,0202,0202,0202,0193,0032,0000,0000,0000,0038,0195,0202,0202,0193,0057,0059,0059,0059,0059,0059,0059,0054,0188,0168,0168,0168,0168,0168,0168],
	[0168,0168,0168,0168,0201,0202,0202,0202,0202,0202,0203,0168,0168,0168,0168,0168,0184,0057,0049,0000,0053,0061,0188,0168,0168,0201,0202,0202,0202,0202,0202,0202,0202,0202,0196,0168,0168,0168,0168,0168,0168],
	[0168,0168,0168,0168,0168,0168,0168,0168,0168,0168,0168,0168,0168,0168,0168,0168,0192,0193,0032,0000,0038,0195,0203,0168,0168,0168,0168,0168,0168,0168,0168,0168,0168,0168,0168,0168,0168,0168,0168,0168,0168],
	[0168,0168,0168,0168,0168,0168,0168,0168,0168,0168,0168,0168,0168,0168,0168,0168,0168,0184,0032,0000,0038,0188,0168,0168,0168,0168,0168,0168,0168,0168,0168,0168,0168,0168,0168,0168,0168,0168,0168,0168,0168],
	[0168,0168,0168,0168,0168,0168,0168,0168,0168,0168,0168,0168,0168,0168,0168,0168,0168,0184,0032,0000,0038,0188,0168,0168,0168,0168,0168,0168,0168,0168,0168,0168,0168,0168,0168,0168,0168,0168,0168,0168,0168],
	[0168,0168,0168,0168,0168,0168,0168,0168,0168,0168,0168,0168,0168,0168,0168,0168,0168,0184,0032,0000,0038,0188,0168,0168,0168,0168,0168,0168,0168,0168,0168,0168,0168,0168,0168,0168,0168,0168,0168,0168,0168],
	[0168,0168,0168,0168,0168,0168,0168,0168,0168,0168,0168,0168,0168,0168,0168,0168,0168,0184,0032,0000,0038,0188,0168,0168,0168,0168,0168,0168,0168,0168,0168,0168,0168,0168,0168,0168,0168,0168,0168,0168,0168]
	],
	"couche1": [
	[-001,-001,-001,-001,-001,-001,-001,-001,-001,-001,-001,-001,-001,-001,-001,-001,-001,-001,-001,-001,-001,-001,-001,-001,-001,-001,-001,-001,-001,-001,-001,-001,-001,-001,-001,-001,-001,-001,-001,-001,-001],
	[-001,-001,-001,-001,-001,-001,-001,-001,-001,-001,-001,-001,-001,-001,-001,-001,-001,-001,-001,-001,-001,-001,-001,-001,-001,-001,-001,-001,-001,-001,-001,-001,-001,-001,-001,-001,-001,-001,-001,-001,-001],
	[-001,-001,-001,-001,-001,-001,-001,-001,-001,-001,-001,-001,-001,-001,-001,-001,-001,-001,-001,-001,-001,-001,-001,-001,-001,-001,-001,-001,-001,-001,-001,-001,-001,-001,-001,-001,-001,-001,-001,-001,-001],
	[-001,-001,-001,-001,-001,-001,-001,-001,-001,-001,-001,-001,-001,-001,-001,-001,-001,-001,-001,-001,-001,-001,-001,-001,-001,-001,-001,-001,-001,-001,-001,-001,-001,-001,-001,-001,-001,-001,-001,-001,-001],
	[-001,-001,-001,-001,-001,-001,-001,-001,-001,-001,-001,-001,-001,-001,-001,-001,-001,-001,-001,-001,-001,-001,-001,-001,-001,-001,-001,-001,-001,-001,-001,-001,-001,-001,-001,-001,-001,-001,-001,-001,-001],
	[-001,-001,-001,-001,-001,-001,-001,-001,-001,-001,-001,-001,-001,-001,-001,-001,-001,-001,-001,-001,-001,-001,-001,-001,-001,-001,-001,-001,-001,-001,-001,-001,-001,-001,-001,-001,-001,-001,-001,-001,-001],
	[-001,-001,-001,-001,-001,-001,-001,-001,-001,-001,-001,-001,-001,-001,-001,-001,-001,-001,-001,0004,-001,-001,-001,-001,-001,-001,-001,-001,-001,-001,-001,-001,-001,-001,-001,-001,-001,-001,-001,-001,-001],
	[-001,-001,-001,-001,-001,-001,-001,-001,-001,-001,-001,0181,0182,0123,-001,-001,-001,-001,-001,-001,-001,-001,-001,-001,-001,-001,-001,-001,-001,-001,-001,-001,-001,-001,-001,-001,-001,-001,-001,-001,-001],
	[-001,-001,-001,-001,-001,-001,-001,-001,0123,-001,-001,-001,-001,0131,-001,-001,-001,-001,-001,-001,-001,-001,-001,-001,-001,-001,-001,-001,-001,-001,-001,-001,-001,-001,-001,-001,-001,-001,-001,-001,-001],
	[-001,-001,-001,-001,-001,-001,-001,-001,0131,-001,0139,-001,-001,-001,-001,-001,-001,-001,-001,-001,-001,-001,-001,-001,-001,-001,-001,-001,-001,-001,-001,-001,-001,-001,-001,-001,-001,-001,-001,-001,-001],
	[-001,-001,-001,-001,-001,-001,-001,-001,-001,-001,-001,-001,-001,-001,-001,-001,-001,-001,-001,-001,-001,-001,-001,-001,-001,-001,-001,-001,-001,-001,-001,-001,-001,-001,-001,-001,-001,-001,-001,-001,-001],
	[-001,-001,-001,-001,-001,-001,-001,-001,-001,-001,-001,-001,-001,-001,-001,-001,-001,-001,-001,-001,-001,-001,-001,-001,-001,-001,0197,0198,-001,-001,-001,-001,-001,-001,-001,-001,-001,-001,-001,-001,-001],
	[-001,-001,-001,-001,-001,-001,-001,-001,-001,-001,-001,-001,-001,-001,-001,-001,-001,-001,-001,-001,-001,-001,-001,-001,-001,-001,0205,0206,-001,-001,-001,-001,-001,-001,-001,-001,-001,-001,-001,-001,-001],
	[-001,-001,-001,-001,-001,-001,-001,-001,-001,-001,-001,-001,-001,-001,-001,0044,-001,-001,-001,-001,-001,-001,-001,-001,-001,-001,-001,-001,-001,-001,-001,-001,-001,-001,-001,-001,-001,-001,-001,-001,-001],
	[-001,-001,-001,-001,-001,-001,-001,-001,-001,-001,-001,-001,-001,-001,-001,-001,-001,-001,-001,-001,-001,-001,-001,-001,-001,-001,-001,-001,-001,-001,-001,-001,-001,-001,-001,-001,-001,-001,-001,-001,-001],
	[-001,-001,-001,-001,-001,-001,-001,-001,-001,-001,-001,-001,-001,-001,-001,-001,-001,-001,-001,-001,-001,0044,-001,-001,-001,-001,-001,-001,-001,-001,-001,-001,-001,-001,-001,-001,-001,-001,-001,-001,-001],
	[-001,-001,-001,-001,-001,-001,-001,-001,-001,-001,-001,-001,-001,-001,-001,-001,-001,-001,-001,-001,-001,-001,-001,-001,-001,-001,-001,-001,-001,-001,-001,-001,-001,-001,-001,-001,-001,-001,-001,-001,-001],
	[-001,-001,-001,-001,-001,-001,-001,-001,-001,-001,-001,-001,-001,-001,-001,-001,-001,-001,-001,-001,-001,-001,-001,-001,-001,-001,-001,0123,-001,-001,-001,-001,-001,-001,-001,-001,-001,-001,-001,-001,-001],
	[-001,-001,-001,-001,-001,-001,-001,-001,-001,-001,-001,-001,-001,-001,-001,-001,-001,-001,-001,-001,-001,-001,-001,-001,-001,-001,-001,0131,-001,-001,-001,-001,-001,-001,-001,-001,-001,-001,-001,-001,-001],
	[-001,-001,-001,-001,-001,-001,-001,-001,-001,-001,-001,-001,-001,-001,-001,-001,-001,-001,-001,-001,-001,-001,-001,-001,-001,-001,0139,-001,0124,-001,-001,-001,-001,-001,-001,-001,-001,-001,-001,-001,-001],
	[-001,-001,-001,-001,-001,-001,-001,-001,-001,-001,-001,-001,-001,-001,-001,-001,-001,-001,-001,-001,-001,-001,-001,-001,-001,-001,-001,-001,0132,-001,-001,-001,-001,-001,-001,-001,-001,-001,-001,-001,-001],
	[-001,-001,-001,-001,-001,-001,-001,-001,-001,-001,-001,-001,-001,-001,-001,-001,-001,-001,-001,-001,-001,-001,-001,-001,-001,-001,-001,-001,-001,-001,-001,-001,-001,-001,-001,-001,-001,-001,-001,-001,-001],
	[-001,-001,-001,-001,-001,-001,-001,-001,-001,-001,-001,-001,-001,-001,-001,-001,-001,-001,-001,-001,-001,-001,-001,-001,-001,-001,-001,-001,-001,-001,-001,-001,-001,-001,-001,-001,-001,-001,-001,-001,-001],
	[-001,-001,-001,-001,-001,-001,-001,-001,-001,-001,-001,-001,-001,-001,-001,-001,-001,-001,-001,-001,-001,-001,-001,-001,-001,-001,-001,-001,-001,-001,-001,-001,-001,-001,-001,-001,-001,-001,-001,-001,-001],
	[-001,-001,-001,-001,-001,-001,-001,-001,-001,-001,-001,-001,-001,-001,-001,-001,-001,-001,-001,-001,-001,-001,-001,-001,-001,-001,-001,-001,-001,-001,-001,-001,-001,-001,-001,-001,-001,-001,-001,-001,-001],
	[-001,-001,-001,-001,-001,-001,-001,-001,-001,-001,-001,-001,0044,-001,-001,-001,-001,-001,-001,-001,-001,-001,-001,-001,-001,-001,-001,-001,-001,-001,-001,-001,-001,-001,-001,-001,-001,-001,-001,-001,-001],
	[-001,-001,-001,-001,-001,-001,-001,-001,-001,-001,-001,-001,-001,-001,-001,-001,-001,-001,-001,-001,-001,-001,-001,-001,-001,-001,-001,-001,-001,-001,-001,-001,-001,-001,-001,-001,-001,-001,-001,-001,-001],
	[-001,-001,-001,-001,-001,-001,-001,-001,-001,-005,-001,-001,-001,-001,-001,-001,-001,-001,-001,-001,-001,-001,-001,-001,-001,-001,-001,-001,-001,-001,-001,-001,-001,-001,-001,-001,-001,-001,-001,-001,-001],
	[-001,-001,-001,-001,-001,-001,-001,-001,-001,-001,-001,-001,-001,-001,-001,-001,-001,-001,-001,-001,-001,-001,-001,-001,-001,-001,-001,-001,-001,-001,-001,-001,-001,-001,-001,-001,-001,-001,-001,-001,-001],
	[-001,-001,-001,-001,-001,-001,-001,-001,-001,-001,-001,-001,-001,-001,-001,-001,-001,-001,-001,0197,0198,-001,-001,-001,-001,-001,-001,-001,-001,-001,-001,-001,-001,-001,-001,-001,-001,-001,-001,-001,-001],
	[-001,-001,-001,-001,-001,-001,-001,-001,-001,-001,-001,-001,-001,-001,-001,-001,-001,-001,-001,0205,0206,-001,-001,-001,-001,-001,-001,-001,-001,-001,-001,-001,-001,-001,-001,-001,-001,-001,-001,-001,-001],
	[-001,-001,-001,-001,-001,-001,-001,-001,-001,-001,-001,-001,-001,-001,-001,-001,-001,-001,-001,-001,-001,-001,-001,-001,-001,-001,-001,-001,-001,-001,-001,-001,-001,-001,-001,-001,-001,-001,-001,-001,-001],
	[-001,-001,-001,-001,-001,-001,-001,-001,-001,-001,-001,-001,-001,-001,-001,-001,-001,-001,-001,-001,-001,-001,-001,-001,-001,-001,-001,-001,-001,-001,-001,-001,-001,-001,-001,-001,-001,-001,-001,-001,-001],
	[-001,-001,-001,-001,-001,-001,-001,-001,-001,-001,-001,-001,-001,-001,-001,-001,-001,-001,-001,-001,-001,-001,-001,-001,-001,-001,-001,-001,-001,-001,-001,-001,-001,-001,-001,-001,-001,-001,-001,-001,-001],
	[-001,-001,-001,-001,-001,-001,-001,-001,-001,-001,-001,-001,-001,-001,-001,-001,-001,-001,-001,-001,-001,-001,-001,-001,-001,-001,-001,-001,-001,-001,-001,-001,-001,-001,-001,-001,-001,-001,-001,-001,-001],
	[-001,-001,-001,-001,-001,-001,-001,-001,-001,-001,-001,-001,-001,-001,-001,-001,-001,-001,-001,-001,-001,-001,-001,-001,-001,-001,-001,-001,-001,-001,-001,-001,-001,-001,-001,-001,-001,-001,-001,-001,-001],
	[-001,-001,-001,-001,-001,-001,-001,-001,-001,-001,-001,-001,-001,-001,-001,-001,-001,-001,-001,-001,-001,-001,-001,-001,-001,-001,-001,-001,-001,-001,-001,-001,-001,-001,-001,-001,-001,-001,-001,-001,-001],
	[-001,-001,-001,-001,-001,-001,-001,-001,-001,-001,-001,-001,-001,-001,-001,-001,-001,-001,-001,-001,-001,-001,-001,-001,-001,-001,-001,-001,-001,-001,-001,-001,-001,-001,-001,-001,-001,-001,-001,-001,-001],
	[-001,-001,-001,-001,-001,-001,-001,-001,-001,-001,-001,-001,-001,-001,-001,-001,-001,-001,-001,-001,-001,-001,-001,-001,-001,-001,-001,-001,-001,-001,-001,-001,-001,-001,-001,-001,-001,-001,-001,-001,-001],
	[-001,-001,-001,-001,-001,-001,-001,-001,-001,-001,-001,-001,-001,-001,-001,-001,-001,-001,-001,-001,-001,-001,-001,-001,-001,-001,-001,-001,-001,-001,-001,-001,-001,-001,-001,-001,-001,-001,-001,-001,-001]
	],
	"couche2": [
	[-001,-001,-001,-001,-001,-001,-001,-001,-001,-001,-001,-001,-001,-001,-001,-001,-001,-001,-001,-001,-001,-001,-001,-001,-001,-001,-001,-001,-001,-001,-001,-001,-001,-001,-001,-001,-001,-001,-001,-001,-001],
	[-001,-001,-001,-001,-001,-001,-001,-001,-001,-001,-001,-001,-001,-001,-001,-001,-001,-001,-001,-001,-001,-001,-001,-001,-001,-001,-001,-001,-001,-001,-001,-001,-001,-001,-001,-001,-001,-001,-001,-001,-001],
	[-001,-001,-001,-001,-001,-001,-001,-001,-001,-001,-001,-001,-001,-001,-001,-001,-001,-001,-001,-001,-001,-001,-001,-001,-001,-001,-001,-001,-001,-001,-001,-001,-001,-001,-001,-001,-001,-001,-001,-001,-001],
	[-001,-001,-001,-001,-001,-001,-001,-001,-001,-001,-001,-001,-001,-001,-001,-001,-001,-001,-001,-001,-001,-001,-001,-001,-001,-001,-001,-001,-001,-001,-001,-001,-001,-001,-001,-001,-001,-001,-001,-001,-001],
	[-001,-001,-001,-001,-001,-001,-001,-001,-001,-001,-001,-001,-001,-001,-001,-001,-001,-001,-001,-001,-001,-001,-001,-001,-001,-001,-001,-001,-001,-001,-001,-001,-001,-001,-001,-001,-001,-001,-001,-001,-001],
	[-001,-001,-001,-001,-001,-001,-001,-001,-001,-001,-001,-001,-001,-001,-001,-001,-001,-001,-001,-001,-001,-001,-001,-001,-001,-001,-001,-001,-001,-001,-001,-001,-001,-001,-001,-001,-001,-001,-001,-001,-001],
	[-001,-001,-001,-001,-001,-001,-001,-001,-001,-001,-001,-001,-001,-001,-001,-001,-001,-001,-001,-001,-001,-001,-001,-001,-001,-001,-001,-001,-001,-001,-001,-001,-001,-001,-001,-001,-001,-001,-001,-001,-001],
	[-001,-001,-001,-001,-001,-001,-001,-001,-001,-001,-001,-001,-001,-001,-001,-001,-001,-001,-001,-001,-001,-001,-001,-001,-001,-001,-001,-001,-001,-001,-001,-001,-001,-001,-001,-001,-001,-001,-001,-001,-001],
	[-001,-001,-001,-001,-001,-001,-001,-001,-001,-001,-001,-001,-001,-001,-001,-001,-001,-001,-001,-001,-001,-001,-001,-001,-001,-001,-001,-001,-001,-001,-001,-001,-001,-001,-001,-001,-001,-001,-001,-001,-001],
	[-001,-001,-001,-001,-001,-001,-001,-001,-001,-001,-001,-001,-001,-001,-001,-001,-001,-001,-001,-001,-001,-001,-001,-001,-001,-001,-001,-001,-001,-001,-001,-001,-001,-001,-001,-001,-001,-001,-001,-001,-001],
	[-001,-001,-001,-001,-001,-001,-001,-001,-001,-001,-001,-001,-001,-001,-001,-001,-001,-001,-001,-001,-001,-001,-001,-001,-001,-001,-001,-001,-001,-001,-001,-001,-001,-001,-001,-001,-001,-001,-001,-001,-001],
	[-001,-001,-001,-001,-001,-001,-001,-001,-001,-001,-001,-001,-001,-001,-001,-001,-001,-001,-001,-001,-001,-001,-001,-001,-001,-001,-001,-001,-001,-001,-001,-001,-001,-001,-001,-001,-001,-001,-001,-001,-001],
	[-001,-001,-001,-001,-001,-001,-001,-001,-001,-001,-001,-001,-001,-001,-001,-001,-001,-001,-001,-001,-001,-001,-001,-001,-001,-001,-001,-001,-001,-001,-001,-001,-001,-001,-001,-001,-001,-001,-001,-001,-001],
	[-001,-001,-001,-001,-001,-001,-001,-001,-001,-001,-001,-001,-001,-001,-001,-001,-001,-001,-001,-001,-001,-001,-001,-001,-001,-001,-001,-001,-001,-001,-001,-001,-001,-001,-001,-001,-001,-001,-001,-001,-001],
	[-001,-001,-001,-001,-001,-001,-001,-001,-001,-001,-001,-001,-001,-001,-001,-001,-001,-001,-001,-001,-001,-001,-001,-001,-001,-001,-001,-001,-001,-001,-001,-001,-001,-001,-001,-001,-001,-001,-001,-001,-001],
	[-001,-001,-001,-001,-001,-001,-001,-001,-001,-001,-001,-001,-001,-001,-001,-001,-001,-001,-001,-001,-001,-001,-001,-001,-001,-001,-001,-001,-001,-001,-001,-001,-001,-001,-001,-001,-001,-001,-001,-001,-001],
	[-001,-001,-001,-001,-001,-001,-001,-001,-001,-001,-001,-001,-001,-001,-001,-001,-001,-001,-001,-001,-001,-001,-001,-001,-001,-001,-001,-001,-001,-001,-001,-001,-001,-001,-001,-001,-001,-001,-001,-001,-001],
	[-001,-001,-001,-001,-001,-001,-001,-001,-001,-001,-001,-001,-001,-001,-001,-001,-001,-001,-001,-001,-001,-001,-001,-001,-001,-001,-001,-001,-001,-001,-001,-001,-001,-001,-001,-001,-001,-001,-001,-001,-001],
	[-001,-001,-001,-001,-001,-001,-001,-001,-001,-001,-001,-001,-001,-001,-001,-001,-001,-001,-001,-001,-001,-001,-001,-001,-001,-001,-001,-001,-001,-001,-001,-001,-001,-001,-001,-001,-001,-001,-001,-001,-001],
	[-001,-001,-001,-001,-001,-001,-001,-001,-001,-001,-001,-001,-001,-001,-001,-001,-001,-001,-001,-001,-001,-001,-001,-001,-001,-001,-001,-001,-001,-001,-001,-001,-001,-001,-001,-001,-001,-001,-001,-001,-001],
	[-001,-001,-001,-001,-001,-001,-001,-001,-001,-001,-001,-001,-001,-001,-001,-001,-001,-001,-001,-001,-001,-001,-001,-001,-001,-001,-001,-001,-001,-001,-001,-001,-001,-001,-001,-001,-001,-001,-001,-001,-001],
	[-001,-001,-001,-001,-001,-001,-001,-001,-001,-001,-001,-001,-001,-001,-001,-001,-001,-001,-001,-001,-001,-001,-001,-001,-001,-001,-001,-001,-001,-001,-001,-001,-001,-001,-001,-001,-001,-001,-001,-001,-001],
	[-001,-001,-001,-001,-001,-001,-001,-001,-001,-001,-001,-001,-001,-001,-001,-001,-001,-001,-001,-001,-001,-001,-001,-001,-001,-001,-001,-001,-001,-001,-001,-001,-001,-001,-001,-001,-001,-001,-001,-001,-001],
	[-001,-001,-001,-001,-001,-001,-001,-001,-001,-001,-001,-001,-001,-001,-001,-001,-001,-001,-001,-001,-001,-001,-001,-001,-001,-001,-001,-001,-001,-001,-001,-001,-001,-001,-001,-001,-001,-001,-001,-001,-001],
	[-001,-001,-001,-001,-001,-001,-001,-001,-001,-001,-001,-001,-001,-001,-001,-001,-001,-001,-001,-001,-001,-001,-001,-001,-001,-001,-001,-001,-001,-001,-001,-001,-001,-001,-001,-001,-001,-001,-001,-001,-001],
	[-001,-001,-001,-001,-001,-001,-001,-001,-001,-001,-001,-001,-001,-001,-001,-001,-001,-001,-001,-001,-001,-001,-001,-001,-001,-001,-001,-001,-001,-001,-001,-001,-001,-001,-001,-001,-001,-001,-001,-001,-001],
	[-001,-001,-001,-001,-001,-001,-001,-001,-001,-001,-001,-001,-001,-001,-001,-001,-001,-001,-001,-001,-001,-001,-001,-001,-001,-001,-001,-001,-001,-001,-001,-001,-001,-001,-001,-001,-001,-001,-001,-001,-001],
	[-001,-001,-001,-001,-001,-001,-001,-001,-001,-001,-001,-001,-001,-001,-001,-001,-001,-001,-001,-001,-001,-001,-001,-001,-001,-001,-001,-001,-001,-001,-001,-001,-001,-001,-001,-001,-001,-001,-001,-001,-001],
	[-001,-001,-001,-001,-001,-001,-001,-001,-001,-001,-001,-001,-001,-001,-001,-001,-001,-001,-001,-001,-001,-001,-001,-001,-001,-001,-001,-001,-001,-001,-001,-001,-001,-001,-001,-001,-001,-001,-001,-001,-001],
	[-001,-001,-001,-001,-001,-001,-001,-001,-001,-001,-001,-001,-001,-001,-001,-001,-001,-001,-001,-001,-001,-001,-001,-001,-001,-001,-001,-001,-001,-001,-001,-001,-001,-001,-001,-001,-001,-001,-001,-001,-001],
	[-001,-001,-001,-001,-001,-001,-001,-001,-001,-001,-001,-001,-001,-001,-001,-001,-001,-001,-001,-001,-001,-001,-001,-001,-001,-001,-001,-001,-001,-001,-001,-001,-001,-001,-001,-001,-001,-001,-001,-001,-001],
	[-001,-001,-001,-001,-001,-001,-001,-001,-001,-001,-001,-001,-001,-001,-001,-001,-001,-001,-001,-001,-001,-001,-001,-001,-001,-001,-001,-001,-001,-001,-001,-001,-001,-001,-001,-001,-001,-001,-001,-001,-001],
	[-001,-001,-001,-001,-001,-001,-001,-001,-001,-001,-001,-001,-001,-001,-001,-001,-001,-001,-001,-001,-001,-001,-001,-001,-001,-001,-001,-001,-001,-001,-001,-001,-001,-001,-001,-001,-001,-001,-001,-001,-001],
	[-001,-001,-001,-001,-001,-001,-001,-001,-001,-001,-001,-001,-001,-001,-001,-001,-001,-001,-001,-001,-001,-001,-001,-001,-001,-001,-001,-001,-001,-001,-001,-001,-001,-001,-001,-001,-001,-001,-001,-001,-001],
	[-001,-001,-001,-001,-001,-001,-001,-001,-001,-001,-001,-001,-001,-001,-001,-001,-001,-001,-001,-001,-001,-001,-001,-001,-001,-001,-001,-001,-001,-001,-001,-001,-001,-001,-001,-001,-001,-001,-001,-001,-001],
	[-001,-001,-001,-001,-001,-001,-001,-001,-001,-001,-001,-001,-001,-001,-001,-001,-001,-001,-001,-001,-001,-001,-001,-001,-001,-001,-001,-001,-001,-001,-001,-001,-001,-001,-001,-001,-001,-001,-001,-001,-001],
	[-001,-001,-001,-001,-001,-001,-001,-001,-001,-001,-001,-001,-001,-001,-001,-001,-001,-001,-001,-001,-001,-001,-001,-001,-001,-001,-001,-001,-001,-001,-001,-001,-001,-001,-001,-001,-001,-001,-001,-001,-001],
	[-001,-001,-001,-001,-001,-001,-001,-001,-001,-001,-001,-001,-001,-001,-001,-001,-001,-001,-001,-001,-001,-001,-001,-001,-001,-001,-001,-001,-001,-001,-001,-001,-001,-001,-001,-001,-001,-001,-001,-001,-001],
	[-001,-001,-001,-001,-001,-001,-001,-001,-001,-001,-001,-001,-001,-001,-001,-001,-001,-001,-001,-001,-001,-001,-001,-001,-001,-001,-001,-001,-001,-001,-001,-001,-001,-001,-001,-001,-001,-001,-001,-001,-001],
	[-001,-001,-001,-001,-001,-001,-001,-001,-001,-001,-001,-001,-001,-001,-001,-001,-001,-001,-001,-001,-001,-001,-001,-001,-001,-001,-001,-001,-001,-001,-001,-001,-001,-001,-001,-001,-001,-001,-001,-001,-001]
	],
	"events": [
	{
		"id": 5,
		"nom": "Clone[582][53]",
		"x": 14,
		"y": 14
	},
	{
		"id": 165,
		"nom": "EV165",
		"x": 19,
		"y": 6,
		"pages": [
		{
			"conditions": [
			{
				"nom": "ArriveeAuContact"
			}
			],
			"commandes": [
			{
				"nom": "ChangerDeMap",
				"variable": false,
				"numeroNouvelleMap": 655,
				"xDebutHeros": 15,
				"yDebutHeros": 11
			}
			],
			"vitesse": "moderee",
			"frequence": "basse",
			"animeEnMouvement": true,
			"animeALArret": false,
			"directionFixe": false,
			"traversable": false,
			"auDessusDeTout": false
		}
		]
	},
	{
		"id": 1,
		"nom": "EV001",
		"x": 19,
		"y": 39,
		"pages": [
		{
			"conditions": [
			{
				"nom": "ArriveeAuContact"
			}
			],
			"commandes": [
			{
				"nom": "ChangerDeMap",
				"variable": false,
				"numeroNouvelleMap": 647,
				"xDebutHeros": 18,
				"yDebutHeros": 1
			}
			],
			"vitesse": "moderee",
			"frequence": "basse",
			"animeEnMouvement": true,
			"animeALArret": false,
			"directionFixe": false,
			"traversable": false,
			"auDessusDeTout": false
		}
		]
	},
	{
		"id": 2,
		"nom": "Clone[341][006]",
		"x": 26,
		"y": 8
	},
	{
		"id": 3,
		"nom": "activer le verglas",
		"x": 20,
		"y": 38,
		"pages": [
		{
			"conditions": [
			],
			"commandes": [
			{
				"nom": "ModifierMeteo",
				"type": "neige",
				"intensite": 9
			},
			{
				"nom": "ModifierInterrupteur",
				"numeroInterrupteur": 36,
				"valeur": true
			},
			{
				"nom": "AppelerPageCommune",
				"numeroPageCommune": 55
			},
			{
				"nom": "SupprimerEvent"
			}
			],
			"vitesse": "tres rapide",
			"frequence": "la plus haute",
			"animeEnMouvement": false,
			"animeALArret": false,
			"directionFixe": false,
			"traversable": true,
			"auDessusDeTout": false
		}
		]
	}
	]
}
