{
	"nom": "Salle 13 (ballons)",
	"tileset": "Sanctuaire de Jishin",
	"largeur": 25,
	"hauteur": 20,
	"musique": {
		"nomFichierSonore": "",
		"volume": 1.00,
		"tempo": 1.00
	},
	"fondSonore": {
		"nomFichierSonore": "",
		"volume": 0.80,
		"tempo": 1.00
	},
	"couche0": [
	[-001,-001,-001,-001,-001,-001,-001,-001,-001,-001,-001,-001,-001,-001,-001,-001,-001,-001,-001,-001,-001,-001,-001,-001,-001],
	[-001,-001,-001,-001,-001,-001,-001,-001,-001,-001,-001,-001,-001,-001,-001,-001,-001,-001,-001,-001,-001,-001,-001,-001,-001],
	[-001,-001,-001,-001,-001,0140,0141,0108,0109,0108,0109,0108,0161,0108,0109,0108,0109,0108,0142,0143,-001,-001,-001,-001,-001],
	[-001,-001,-001,-001,-001,0148,0149,0116,0117,0116,0117,0116,0161,0116,0117,0116,0117,0116,0150,0151,-001,-001,-001,-001,-001],
	[-001,-001,-001,-001,-001,0110,0111,0234,0234,0234,0234,0161,0161,0161,0161,0161,0161,0161,0124,0125,-001,-001,-001,-001,-001],
	[-001,-001,-001,-001,-001,0118,0119,0002,0002,0002,0002,0161,0161,0161,0161,0161,0161,0161,0132,0133,-001,-001,-001,-001,-001],
	[-001,-001,-001,-001,-001,0110,0111,0002,0002,0002,0002,-007,0161,-007,0234,0234,0234,0161,0124,0125,-001,-001,-001,-001,-001],
	[-001,-001,-001,-001,-001,0118,0119,-007,-007,-007,-007,-007,0161,-007,0002,0002,0002,0234,0132,0133,-001,-001,-001,-001,-001],
	[-001,-001,-001,-001,-001,0110,0111,0161,0161,0161,0161,0161,0161,0234,0002,0002,0002,-007,0230,0231,-001,-001,-001,-001,-001],
	[-001,-001,-001,-001,-001,0118,0119,0161,-007,-007,-007,0234,-007,0161,0161,0161,0161,0161,0238,0239,-001,-001,-001,-001,-001],
	[-001,-001,-001,-001,-001,0110,0111,0161,0234,0234,0234,0002,0234,-007,0234,0234,-007,0161,0246,0247,-001,-001,-001,-001,-001],
	[-001,-001,-001,-001,-001,0118,0119,0161,0002,0002,0002,0002,0002,-007,0002,0002,0234,0161,0124,0125,-001,-001,-001,-001,-001],
	[-001,-001,-001,-001,-001,0110,0111,0161,-007,0002,0002,-007,-007,-007,0002,0002,-007,0161,0132,0133,-001,-001,-001,-001,-001],
	[-001,-001,-001,-001,-001,0118,0119,0161,0161,0161,0161,0161,0161,0161,0161,0161,0161,0161,0124,0125,-001,-001,-001,-001,-001],
	[-001,-001,-001,-001,-001,0156,0157,0126,0127,0126,0127,0126,0161,0126,0127,0126,0127,0126,0158,0159,-001,-001,-001,-001,-001],
	[-001,-001,-001,-001,-001,0164,0165,0134,0135,0134,0135,0134,0161,0134,0135,0134,0135,0134,0166,0167,-001,-001,-001,-001,-001],
	[-001,-001,-001,-001,-001,-001,-001,-001,-001,-001,-001,-001,-001,-001,-001,-001,-001,-001,-001,-001,-001,-001,-001,-001,-001],
	[-001,-001,-001,-001,-001,-001,-001,-001,-001,-001,-001,-001,-001,-001,-001,-001,-001,-001,-001,-001,-001,-001,-001,-001,-001],
	[-001,-001,-001,-001,-001,-001,-001,-001,-001,-001,-001,-001,-001,-001,-001,-001,-001,-001,-001,-001,-001,-001,-001,-001,-001],
	[-001,-001,-001,-001,-001,-001,-001,-001,-001,-001,-001,-001,-001,-001,-001,-001,-001,-001,-001,-001,-001,-001,-001,-001,-001]
	],
	"couche1": [
	[-001,-001,-001,-001,-001,-001,-001,-001,-001,-001,-001,-001,-001,-001,-001,-001,-001,-001,-001,-001,-001,-001,-001,-001,-001],
	[-001,-001,-001,-001,-001,-001,-001,-001,-001,-001,-001,0232,0232,0232,-001,-001,-001,-001,-001,-001,-001,-001,-001,-001,-001],
	[-001,-001,-001,-001,-001,-001,-001,-001,-001,-001,-001,0168,0169,0170,-001,-001,-001,-001,-001,-001,-001,-001,-001,-001,-001],
	[-001,-001,-001,-001,-001,-001,-001,-001,-001,-001,-001,0176,0177,0178,-001,-001,-001,-001,-001,-001,-001,-001,-001,-001,-001],
	[-001,-001,-001,-001,-001,-001,-001,-001,-001,-001,-001,-001,-001,-001,-001,-001,-001,-001,-001,-001,-001,-001,-001,-001,-001],
	[-001,-001,-001,-001,-001,-001,-001,-001,-001,-001,-001,-001,-001,-001,-001,-001,-001,-001,-001,-001,-001,-001,-001,-001,-001],
	[-001,-001,-001,-001,-001,-001,-001,-001,-001,-001,-001,-001,-001,-001,-001,-001,-001,0191,-001,-001,-001,-001,-001,-001,-001],
	[-001,-001,-001,-001,-001,-001,-001,-001,-001,-001,-001,-001,-001,-001,-001,-001,-001,-001,-001,-001,-001,-001,-001,-001,-001],
	[-001,-001,-001,-001,-001,-001,-001,-001,-001,-001,-001,-001,-001,-001,-001,-001,-001,-001,-001,-001,-001,-001,-001,-001,-001],
	[-001,-001,-001,-001,-001,-001,-001,-001,-001,-001,-001,-001,-001,-001,-001,-001,-001,-001,-001,-001,-001,-001,-001,-001,-001],
	[-001,-001,-001,-001,-001,-001,-001,-001,-001,-001,-001,-001,-001,-001,-001,-001,-001,-001,-001,-001,-001,-001,-001,-001,-001],
	[-001,-001,-001,-001,-001,-001,-001,-001,-001,-001,-001,-001,-001,-001,-001,-001,-001,-001,-001,-001,-001,-001,-001,-001,-001],
	[-001,-001,-001,-001,-001,-001,-001,-001,-001,-001,-001,-001,-001,-001,-001,-001,-001,-001,-001,-001,-001,-001,-001,-001,-001],
	[-001,-001,-001,-001,-001,-001,-001,-001,-001,-001,-001,-001,-001,-001,-001,-001,-001,-001,-001,-001,-001,-001,-001,-001,-001],
	[-001,-001,-001,-001,-001,-001,-001,-001,-001,-001,-001,0184,0185,0186,-001,-001,-001,-001,-001,-001,-001,-001,-001,-001,-001],
	[-001,-001,-001,-001,-001,-001,-001,-001,-001,-001,-001,0192,0193,0194,-001,-001,-001,-001,-001,-001,-001,-001,-001,-001,-001],
	[-001,-001,-001,-001,-001,-001,-001,-001,-001,-001,-001,-001,-001,-001,-001,-001,-001,-001,-001,-001,-001,-001,-001,-001,-001],
	[-001,-001,-001,-001,-001,-001,-001,-001,-001,-001,-001,-001,-001,-001,-001,-001,-001,-001,-001,-001,-001,-001,-001,-001,-001],
	[-001,-001,-001,-001,-001,-001,-001,-001,-001,-001,-001,-001,-001,-001,-001,-001,-001,-001,-001,-001,-001,-001,-001,-001,-001],
	[-001,-001,-001,-001,-001,-001,-001,-001,-001,-001,-001,-001,-001,-001,-001,-001,-001,-001,-001,-001,-001,-001,-001,-001,-001]
	],
	"couche2": [
	[-001,-001,-001,-001,-001,-001,-001,-001,-001,-001,-001,-001,-001,-001,-001,-001,-001,-001,-001,-001,-001,-001,-001,-001,-001],
	[-001,-001,-001,-001,-001,-001,-001,-001,-001,-001,-001,-001,-001,-001,-001,-001,-001,-001,-001,-001,-001,-001,-001,-001,-001],
	[-001,-001,-001,-001,-001,-001,-001,-001,-001,-001,-001,-001,-001,-001,-001,-001,-001,-001,-001,-001,-001,-001,-001,-001,-001],
	[-001,-001,-001,-001,-001,-001,-001,-001,-001,-001,-001,-001,-001,-001,-001,-001,-001,-001,-001,-001,-001,-001,-001,-001,-001],
	[-001,-001,-001,-001,-001,-001,-001,-001,-001,-001,-001,-001,-001,-001,-001,-001,-001,-001,-001,-001,-001,-001,-001,-001,-001],
	[-001,-001,-001,-001,-001,-001,-001,-001,-001,-001,-001,-001,-001,-001,-001,-001,-001,-001,-001,-001,-001,-001,-001,-001,-001],
	[-001,-001,-001,-001,-001,-001,-001,-001,-001,-001,-001,-001,-001,-001,-001,-001,-001,-001,-001,-001,-001,-001,-001,-001,-001],
	[-001,-001,-001,-001,-001,-001,-001,-001,-001,-001,-001,-001,-001,-001,-001,-001,-001,-001,-001,-001,-001,-001,-001,-001,-001],
	[-001,-001,-001,-001,-001,-001,-001,-001,-001,-001,-001,-001,-001,-001,-001,-001,-001,-001,-001,-001,-001,-001,-001,-001,-001],
	[-001,-001,-001,-001,-001,-001,-001,-001,-001,-001,-001,-001,-001,-001,-001,-001,-001,-001,-001,-001,-001,-001,-001,-001,-001],
	[-001,-001,-001,-001,-001,-001,-001,-001,-001,-001,-001,-001,-001,-001,-001,-001,-001,-001,-001,-001,-001,-001,-001,-001,-001],
	[-001,-001,-001,-001,-001,-001,-001,-001,-001,-001,-001,-001,-001,-001,-001,-001,-001,-001,-001,-001,-001,-001,-001,-001,-001],
	[-001,-001,-001,-001,-001,-001,-001,-001,-001,-001,-001,-001,-001,-001,-001,-001,-001,-001,-001,-001,-001,-001,-001,-001,-001],
	[-001,-001,-001,-001,-001,-001,-001,-001,-001,-001,-001,-001,-001,-001,-001,-001,-001,-001,-001,-001,-001,-001,-001,-001,-001],
	[-001,-001,-001,-001,-001,-001,-001,-001,-001,-001,-001,-001,-001,-001,-001,-001,-001,-001,-001,-001,-001,-001,-001,-001,-001],
	[-001,-001,-001,-001,-001,-001,-001,-001,-001,-001,-001,-001,-001,-001,-001,-001,-001,-001,-001,-001,-001,-001,-001,-001,-001],
	[-001,-001,-001,-001,-001,-001,-001,-001,-001,-001,-001,-001,-001,-001,-001,-001,-001,-001,-001,-001,-001,-001,-001,-001,-001],
	[-001,-001,-001,-001,-001,-001,-001,-001,-001,-001,-001,-001,-001,-001,-001,-001,-001,-001,-001,-001,-001,-001,-001,-001,-001],
	[-001,-001,-001,-001,-001,-001,-001,-001,-001,-001,-001,-001,-001,-001,-001,-001,-001,-001,-001,-001,-001,-001,-001,-001,-001],
	[-001,-001,-001,-001,-001,-001,-001,-001,-001,-001,-001,-001,-001,-001,-001,-001,-001,-001,-001,-001,-001,-001,-001,-001,-001]
	],
	"events": [
	{
		"id": 5,
		"nom": "Clone[341][055]",
		"x": 11,
		"y": 8
	},
	{
		"id": 11,
		"nom": "Clone[341][149]",
		"x": 0,
		"y": 0
	},
	{
		"id": 6,
		"nom": "Clone[341][055]",
		"x": 8,
		"y": 8
	},
	{
		"id": 1,
		"nom": "Clone[341][055]",
		"x": 9,
		"y": 8
	},
	{
		"id": 12,
		"nom": "Clone[341][0082]",
		"x": 17,
		"y": 6
	},
	{
		"id": 7,
		"nom": "EV007",
		"x": 19,
		"y": 9,
		"pages": [
		{
			"conditions": [
			{
				"nom": "ArriveeAuContact"
			}
			],
			"commandes": [
			{
				"nom": "ChangerDeMap",
				"variable": false,
				"numeroNouvelleMap": 501,
				"xDebutHeros": 5,
				"yDebutHeros": 10
			}
			],
			"vitesse": 8,
			"frequence": 8,
			"animeEnMouvement": true,
			"animeALArret": false,
			"directionFixe": false,
			"traversable": false,
			"auDessusDeTout": false
		}
		]
	},
	{
		"id": 2,
		"nom": "Clone[341][004]",
		"x": 12,
		"y": 8
	},
	{
		"id": 13,
		"nom": "EV013",
		"x": 14,
		"y": 2,
		"pages": [
		{
			"conditions": [
			],
			"commandes": [
			{
				"nom": "EffacerImage",
				"numero": 2
			},
			{
				"nom": "SupprimerEvent"
			}
			],
			"vitesse": 8,
			"frequence": 8,
			"animeEnMouvement": false,
			"animeALArret": false,
			"directionFixe": false,
			"traversable": false,
			"auDessusDeTout": false
		}
		]
	},
	{
		"id": 8,
		"nom": "Mur (32)",
		"x": 18,
		"y": 9,
		"pages": [
		{
			"conditions": [
			],
			"commandes": [
			{
				"nom": "ConditionArmeEquipee",
				"idArme": 2,
				"numero": 0
			},
			{
				"nom": "ConditionScript",
				"script": "$game_player.target_in_da_zone?(@event_id,0)",
				"numero": 1
			},
			{
				"nom": "ConditionTouche",
				"touche": "ACTION",
				"numero": 2
			},
			{
				"nom": "Attendre",
				"nombreDeFrames": 1
			},
			{
				"nom": "ConditionTouche",
				"touche": "ACTION",
				"numero": 3
			},
			{
				"nom": "TremblementDeTerre",
				"intensite": 5,
				"vitesse": 9,
				"nombreDeFrames": 33
			},
			{
				"nom": "JouerEffetSonore",
				"nomFichierSonore": "129-Earth01.ogg",
				"volume": 1.00,
				"tempo": 1.00
			},
			{
				"nom": "Deplacement",
				"ignorerLesMouvementsImpossibles": false,
				"repeterLeDeplacement": false,
				"attendreLaFinDuDeplacement": false,
				"mouvements": [
				{
					"nom": "RendreTraversable",
					"traversable": true
				},
				{
					"nom": "ModifierApparence",
					"image": "mur casse character",
					"direction": 1,
					"animation": 0,
					"teinte": 0
				}
				]
			},
			{
				"nom": "JouerAnimation",
				"idAnimation": 37
			},
			{
				"nom": "Attendre",
				"nombreDeFrames": 16
			},
			{
				"nom": "JouerEffetMusical",
				"nomFichierSonore": "Fanfare (paquerette).mp3",
				"volume": 1.00,
				"tempo": 1.00
			},
			{
				"nom": "ModifierInterrupteurLocal",
				"numeroInterrupteurLocal": 0,
				"valeurADonner": true
			},
			{
				"nom": "ConditionFin",
				"numero": 3
			},
			{
				"nom": "ConditionFin",
				"numero": 2
			},
			{
				"nom": "ConditionFin",
				"numero": 1
			},
			{
				"nom": "ConditionFin",
				"numero": 0
			},
			{
				"nom": "Attendre",
				"nombreDeFrames": 1
			}
			],
			"image": "mur character",
			"directionInitiale": 1,
			"vitesse": 8,
			"frequence": 8,
			"animeEnMouvement": false,
			"animeALArret": false,
			"directionFixe": true,
			"traversable": false,
			"auDessusDeTout": false
		},
		{
			"conditions": [
			{
				"nom": "Parler"
			},
			{
				"nom": "InterrupteurLocal",
				"numeroMap": 502,
				"numeroEvent": 8,
				"numeroInterrupteurLocal": 0,
				"valeurQuIlEstCenseAvoir": true
			}
			],
			"commandes": [
			],
			"image": "mur casse character",
			"directionInitiale": 1,
			"vitesse": 8,
			"frequence": 8,
			"animeEnMouvement": false,
			"animeALArret": false,
			"directionFixe": true,
			"traversable": true,
			"auDessusDeTout": true
		}
		]
	},
	{
		"id": 3,
		"nom": "EV003",
		"x": 12,
		"y": 15,
		"pages": [
		{
			"conditions": [
			{
				"nom": "ArriveeAuContact"
			}
			],
			"commandes": [
			{
				"nom": "ChangerDeMap",
				"variable": false,
				"numeroNouvelleMap": 499,
				"xDebutHeros": 12,
				"yDebutHeros": 4
			}
			],
			"vitesse": 8,
			"frequence": 8,
			"animeEnMouvement": true,
			"animeALArret": false,
			"directionFixe": false,
			"traversable": false,
			"auDessusDeTout": false
		}
		]
	},
	{
		"id": 9,
		"nom": "Clone[341][149]",
		"x": 12,
		"y": 9
	},
	{
		"id": 4,
		"nom": "Clone[341][055]",
		"x": 10,
		"y": 8
	},
	{
		"id": 10,
		"nom": "EV010",
		"x": 12,
		"y": 2,
		"pages": [
		{
			"conditions": [
			{
				"nom": "ArriveeAuContact"
			}
			],
			"commandes": [
			{
				"nom": "ChangerDeMap",
				"variable": false,
				"numeroNouvelleMap": 508,
				"xDebutHeros": 17,
				"yDebutHeros": 26
			}
			],
			"vitesse": 8,
			"frequence": 8,
			"animeEnMouvement": true,
			"animeALArret": false,
			"directionFixe": false,
			"traversable": false,
			"auDessusDeTout": false
		}
		]
	}
	]
}
