{
	"nom": "Chemins glacés 2",
	"tileset": "Zone Enneigée",
	"largeur": 45,
	"hauteur": 25,
	"musique": {
		"nomFichierSonore": "",
		"volume": 1.00,
		"tempo": 1.00
	},
	"fondSonore": {
		"nomFichierSonore": "",
		"volume": 0.80,
		"tempo": 1.00
	},
	"couche0": [
	[0168,0168,0168,0168,0168,0168,0168,0168,0168,0168,0168,0168,0168,0168,0168,0168,0168,0168,0168,0168,0168,0168,0168,0168,0168,0168,0168,0168,0168,0169,0170,0170,0170,0180,0168,0168,0168,0168,0168,0168,0168,0168,0168,0168,0168],
	[0168,0168,0168,0168,0168,0168,0168,0168,0168,0168,0168,0168,0168,0168,0168,0168,0168,0168,0168,0168,0168,0168,0168,0168,0168,0168,0168,0168,0168,0184,0009,0003,0013,0188,0168,0168,0168,0168,0168,0168,0168,0168,0168,0168,0168],
	[0168,0168,0168,0168,0168,0168,0168,0168,0168,0168,0168,0168,0168,0168,0168,0168,0168,0168,0168,0168,0168,0168,0168,0168,0168,0168,0168,0168,0168,0184,0024,0000,0030,0188,0168,0168,0168,0168,0168,0168,0168,0168,0168,0168,0168],
	[0168,0168,0168,0168,0168,0168,0168,0168,0168,0168,0168,0168,0168,0168,0168,0168,0168,0168,0168,0168,0168,0168,0168,0168,0168,0168,0168,0168,0168,0184,0024,0000,0030,0188,0168,0168,0168,0168,0168,0168,0168,0168,0168,0168,0168],
	[0168,0168,0168,0168,0168,0168,0168,0168,0168,0168,0168,0168,0168,0168,0168,0168,0176,0170,0170,0170,0170,0170,0170,0170,0170,0170,0170,0170,0170,0177,0024,0000,0030,0179,0170,0170,0180,0168,0168,0168,0168,0168,0168,0168,0168],
	[0168,0168,0168,0168,0168,0168,0168,0168,0168,0168,0168,0168,0168,0168,0168,0168,0184,0009,0010,0010,0010,0010,0010,0010,0010,0010,0010,0010,0010,0010,0017,0000,0021,0010,0010,0022,0188,0168,0168,0168,0168,0168,0168,0168,0168],
	[0168,0168,0168,0168,0168,0168,0168,0168,0168,0168,0168,0168,0168,0168,0168,0168,0184,0024,-008,-008,-008,-008,-008,-008,-008,-008,-008,-008,-008,-008,-008,-008,-008,-008,-008,0030,0188,0168,0168,0168,0168,0168,0168,0168,0168],
	[0168,0168,0168,0168,0168,0168,0168,0168,0168,0168,0168,0168,0168,0168,0168,0168,0184,0024,-008,-008,-008,-008,-008,-008,-008,-008,-008,-008,-008,-008,-008,-008,-008,-008,-008,0030,0188,0168,0168,0168,0168,0168,0168,0168,0168],
	[0168,0168,0168,0168,0168,0168,0168,0168,0168,0168,0168,0168,0168,0168,0168,0168,0184,0024,-008,-008,-008,-008,-008,-008,-008,-008,-008,-008,-008,-008,-008,-008,-008,-008,-008,0030,0188,0168,0168,0168,0168,0168,0168,0168,0168],
	[0168,0168,0168,0168,0168,0168,0168,0168,0168,0168,0168,0168,0168,0168,0168,0168,0184,0024,-008,-008,-008,-008,-008,-008,-008,-008,0000,-008,-008,-008,-008,0000,-008,-008,-008,0030,0188,0168,0168,0168,0168,0168,0168,0168,0168],
	[0168,0168,0168,0168,0168,0168,0168,0168,0168,0168,0168,0168,0168,0168,0168,0168,0184,0024,-008,-008,-008,-008,-008,-008,-008,-008,-008,-008,-008,-008,-008,-008,-008,-008,-008,0030,0188,0168,0168,0168,0168,0168,0168,0168,0168],
	[0168,0168,0168,0168,0168,0168,0168,0168,0168,0168,0168,0168,0168,0168,0168,0168,0184,0024,-008,-008,-008,-008,-008,-008,-008,-008,-008,-008,-008,-008,-008,-008,-008,-008,-008,0030,0188,0168,0168,0168,0168,0168,0168,0168,0168],
	[0168,0168,0168,0168,0168,0168,0168,0168,0168,0168,0168,0168,0168,0168,0168,0168,0184,0024,-008,-008,-008,-008,-008,-008,-008,-008,-008,-008,-008,-008,-008,-008,-008,-008,-008,0030,0188,0168,0168,0168,0168,0168,0168,0168,0168],
	[0168,0168,0168,0168,0168,0168,0168,0168,0168,0176,0170,0170,0170,0170,0170,0170,0177,0024,-008,-008,-008,-008,0000,-008,-008,-008,0000,-008,-008,-008,-008,-008,-008,-008,-008,0030,0188,0168,0168,0168,0168,0168,0168,0168,0168],
	[0168,0168,0168,0168,0168,0168,0168,0168,0168,0184,0000,0000,0009,0010,0010,0010,0013,0024,-008,-008,-008,-008,-008,-008,-008,-008,-008,-008,-008,-008,-008,-008,-008,-008,-008,0030,0188,0168,0168,0168,0168,0168,0168,0168,0168],
	[0168,0168,0168,0168,0168,0168,0168,0168,0168,0184,0000,0000,0024,0000,0000,0000,0021,0017,-008,-008,-008,-008,-008,-008,-008,-008,-008,-008,-008,-008,-008,-008,-008,-008,-008,0030,0188,0168,0168,0168,0168,0168,0168,0168,0168],
	[0168,0168,0168,0168,0168,0168,0168,0168,0168,0184,0000,0000,0024,0000,0000,0000,0000,0000,0000,-008,-008,-008,0000,-008,-008,-008,-008,-008,-008,-008,-008,-008,-008,-008,-008,0030,0188,0168,0168,0168,0168,0168,0168,0168,0168],
	[0168,0168,0168,0168,0168,0168,0168,0168,0168,0184,0009,0010,0017,0000,0000,0000,0053,0049,-008,-008,-008,-008,-008,-008,-008,-008,-008,-008,-008,-008,-008,-008,-008,-008,-008,0030,0188,0168,0168,0168,0168,0168,0168,0168,0168],
	[0168,0168,0168,0168,0168,0168,0168,0168,0168,0184,0024,0000,0000,0000,0000,0000,0030,0024,-008,-008,-008,-008,-008,-008,-008,-008,-008,-008,-008,-008,-008,-008,-008,-008,-008,0030,0188,0168,0168,0168,0168,0168,0168,0168,0168],
	[0168,0168,0168,0168,0168,0168,0168,0168,0168,0184,0024,0000,0000,0000,0000,0008,0030,0024,-008,-008,-008,-008,-008,-008,-008,-008,-008,-008,-008,-008,-008,-008,-008,-008,-008,0030,0188,0168,0168,0168,0168,0168,0168,0168,0168],
	[0168,0168,0168,0168,0168,0168,0168,0168,0168,0184,0057,0059,0049,0000,0053,0059,0061,0024,-008,-008,-008,-008,-008,-008,-008,-008,-008,-008,-008,-008,-008,-008,-008,-008,-008,0030,0188,0168,0168,0168,0168,0168,0168,0168,0168],
	[0168,0168,0168,0168,0168,0168,0168,0168,0168,0192,0202,0193,0024,0000,0030,0195,0193,0057,0059,0059,0059,0059,0059,0059,0059,0059,0059,0059,0059,0059,0059,0059,0059,0049,0000,0030,0188,0168,0168,0168,0168,0168,0168,0168,0168],
	[0168,0168,0168,0168,0168,0168,0168,0168,0168,0168,0168,0184,0024,0000,0030,0188,0201,0202,0202,0202,0202,0202,0202,0202,0202,0202,0202,0202,0202,0202,0202,0202,0193,0057,0051,0061,0188,0168,0168,0168,0168,0168,0168,0168,0168],
	[0168,0168,0168,0168,0168,0168,0168,0168,0168,0168,0168,0184,0024,0000,0030,0188,0168,0168,0168,0168,0168,0168,0168,0168,0168,0168,0168,0168,0168,0168,0168,0168,0201,0202,0202,0202,0203,0168,0168,0168,0168,0168,0168,0168,0168],
	[0168,0168,0168,0168,0168,0168,0168,0168,0168,0168,0168,0184,0024,0000,0030,0188,0168,0168,0168,0168,0168,0168,0168,0168,0168,0168,0168,0168,0168,0168,0168,0168,0168,0168,0168,0168,0168,0168,0168,0168,0168,0168,0168,0168,0168]
	],
	"couche1": [
	[-001,-001,-001,-001,-001,-001,-001,-001,-001,-001,-001,-001,-001,-001,-001,-001,-001,-001,-001,-001,-001,-001,-001,-001,-001,-001,-001,-001,-001,-001,-001,-001,-001,-001,-001,-001,-001,-001,-001,-001,-001,-001,-001,-001,-001],
	[-001,-001,-001,-001,-001,-001,-001,-001,-001,-001,-001,-001,-001,-001,-001,-001,-001,-001,-001,-001,-001,-001,-001,-001,-001,-001,-001,-001,-001,-001,-001,0004,-001,-001,-001,-001,-001,-001,-001,-001,-001,-001,-001,-001,-001],
	[-001,-001,-001,-001,-001,-001,-001,-001,-001,-001,-001,-001,-001,-001,-001,-001,-001,-001,-001,-001,-001,-001,-001,-001,-001,-001,-001,-001,-001,-001,-001,-001,-001,-001,-001,-001,-001,-001,-001,-001,-001,-001,-001,-001,-001],
	[-001,-001,-001,-001,-001,-001,-001,-001,-001,-001,-001,-001,-001,-001,-001,-001,-001,-001,-001,-001,-001,-001,-001,-001,-001,-001,-001,-001,-001,-001,-001,-001,-001,-001,-001,-001,-001,-001,-001,-001,-001,-001,-001,-001,-001],
	[-001,-001,-001,-001,-001,-001,-001,-001,-001,-001,-001,-001,-001,-001,-001,-001,-001,-001,-001,-001,-001,-001,-001,-001,-001,-001,-001,-001,-001,-001,-001,-001,-001,-001,-001,-001,-001,-001,-001,-001,-001,-001,-001,-001,-001],
	[-001,-001,-001,-001,-001,-001,-001,-001,-001,-001,-001,-001,-001,-001,-001,-001,-001,-001,-001,-001,-001,-001,-001,-001,-001,-001,-001,-001,-001,-001,-001,-001,-001,-001,-001,-001,-001,-001,-001,-001,-001,-001,-001,-001,-001],
	[-001,-001,-001,-001,-001,-001,-001,-001,-001,-001,-001,-001,-001,-001,-001,-001,-001,-001,-001,-001,-001,-001,-001,-001,-001,-001,-001,-001,-001,-001,-001,-001,-001,-001,-001,-001,-001,-001,-001,-001,-001,-001,-001,-001,-001],
	[-001,-001,-001,-001,-001,-001,-001,-001,-001,-001,-001,-001,-001,-001,-001,-001,-001,-001,-001,-001,-001,-001,-001,-001,-001,-001,-001,-001,-001,-001,-001,-001,-001,-001,-001,-001,-001,-001,-001,-001,-001,-001,-001,-001,-001],
	[-001,-001,-001,-001,-001,-001,-001,-001,-001,-001,-001,-001,-001,-001,-001,-001,-001,-001,-001,-001,-001,-001,-001,-001,-001,-001,-001,-001,-001,-001,-001,-001,-001,-001,-001,-001,-001,-001,-001,-001,-001,-001,-001,-001,-001],
	[-001,-001,-001,-001,-001,-001,-001,-001,-001,-001,-001,-001,-001,-001,-001,-001,-001,-001,-001,-001,-001,-001,-001,-001,-001,-001,-001,-001,-001,-001,-001,-001,-001,-001,-001,-001,-001,-001,-001,-001,-001,-001,-001,-001,-001],
	[-001,-001,-001,-001,-001,-001,-001,-001,-001,-001,-001,-001,-001,-001,-001,-001,-001,-001,-001,-001,-001,-001,-001,-001,-001,-001,-001,-001,-001,-001,-001,-001,-001,-001,-001,-001,-001,-001,-001,-001,-001,-001,-001,-001,-001],
	[-001,-001,-001,-001,-001,-001,-001,-001,-001,-001,-001,-001,-001,-001,-001,-001,-001,-001,-001,-001,-001,-001,-001,-001,-001,-001,-001,-001,-001,-001,-001,-001,-001,-001,-001,-001,-001,-001,-001,-001,-001,-001,-001,-001,-001],
	[-001,-001,-001,-001,-001,-001,-001,-001,-001,-001,-001,-001,-001,-001,-001,-001,-001,-001,-001,-001,-001,-001,-001,-001,-001,-001,-001,-001,-001,-001,-001,-001,-001,-001,-001,-001,-001,-001,-001,-001,-001,-001,-001,-001,-001],
	[-001,-001,-001,-001,-001,-001,-001,-001,-001,-001,0125,-001,-001,-001,-001,-001,-001,-001,-001,-001,-001,-001,-001,-001,-001,-001,-001,-001,-001,-001,-001,-001,-001,-001,-001,-001,-001,-001,-001,-001,-001,-001,-001,-001,-001],
	[-001,-001,-001,-001,-001,-001,-001,-001,-001,-001,0133,-001,-001,0123,-001,-001,-001,-001,-001,-001,-001,-001,-001,-001,-001,-001,-001,-001,-001,-001,-001,-001,-001,-001,-001,-001,-001,-001,-001,-001,-001,-001,-001,-001,-001],
	[-001,-001,-001,-001,-001,-001,-001,-001,-001,-001,-001,-001,-001,0131,-001,0139,-001,-001,-001,-001,-001,-001,-001,-001,-001,-001,-001,-001,-001,-001,-001,-001,-001,-001,-001,-001,-001,-001,-001,-001,-001,-001,-001,-001,-001],
	[-001,-001,-001,-001,-001,-001,-001,-001,-001,-001,-001,-001,-001,-001,-001,-001,-001,-001,-001,-001,-001,-001,-001,-001,-001,-001,-001,-001,-001,-001,-001,-001,-001,-001,-001,-001,-001,-001,-001,-001,-001,-001,-001,-001,-001],
	[-001,-001,-001,-001,-001,-001,-001,-001,-001,-001,-001,-001,-001,-001,-001,-001,-001,-001,-001,-001,-001,-001,-001,-001,-001,-001,-001,-001,-001,-001,-001,-001,-001,-001,-001,-001,-001,-001,-001,-001,-001,-001,-001,-001,-001],
	[-001,-001,-001,-001,-001,-001,-001,-001,-001,-001,-001,0139,-001,-001,-001,-001,-001,-001,-001,-001,-001,-001,-001,-001,-001,-001,-001,-001,-001,-001,-001,-001,-001,-001,-001,-001,-001,-001,-001,-001,-001,-001,-001,-001,-001],
	[-001,-001,-001,-001,-001,-001,-001,-001,-001,-001,-001,-001,-001,-001,-001,-001,-001,-001,-001,-001,-001,-001,-001,-001,-001,-001,-001,-001,-001,-001,-001,-001,-001,-001,-001,-001,-001,-001,-001,-001,-001,-001,-001,-001,-001],
	[-001,-001,-001,-001,-001,-001,-001,-001,-001,-001,-001,-001,-001,-001,-001,-001,-001,-001,-001,-001,-001,-001,-001,-001,-001,-001,-001,-001,-001,-001,-001,-001,-001,-001,-001,-001,-001,-001,-001,-001,-001,-001,-001,-001,-001],
	[-001,-001,-001,-001,-001,-001,-001,-001,-001,-001,-001,-001,-001,-001,-001,-001,-001,-001,-001,-001,-001,-001,-001,-001,-001,-001,-001,-001,-001,-001,-001,-001,-001,-001,-001,-001,-001,-001,-001,-001,-001,-001,-001,-001,-001],
	[-001,-001,-001,-001,-001,-001,-001,-001,-001,-001,-001,-001,-001,-001,-001,-001,-001,-001,-001,-001,-001,-001,-001,-001,-001,-001,-001,-001,-001,-001,-001,-001,-001,-001,0050,-001,-001,-001,-001,-001,-001,-001,-001,-001,-001],
	[-001,-001,-001,-001,-001,-001,-001,-001,-001,-001,-001,-001,-001,-001,-001,-001,-001,-001,-001,-001,-001,-001,-001,-001,-001,-001,-001,-001,-001,-001,-001,-001,-001,-001,-001,-001,-001,-001,-001,-001,-001,-001,-001,-001,-001],
	[-001,-001,-001,-001,-001,-001,-001,-001,-001,-001,-001,-001,-001,-001,-001,-001,-001,-001,-001,-001,-001,-001,-001,-001,-001,-001,-001,-001,-001,-001,-001,-001,-001,-001,-001,-001,-001,-001,-001,-001,-001,-001,-001,-001,-001]
	],
	"couche2": [
	[-001,-001,-001,-001,-001,-001,-001,-001,-001,-001,-001,-001,-001,-001,-001,-001,-001,-001,-001,-001,-001,-001,-001,-001,-001,-001,-001,-001,-001,-001,-001,-001,-001,-001,-001,-001,-001,-001,-001,-001,-001,-001,-001,-001,-001],
	[-001,-001,-001,-001,-001,-001,-001,-001,-001,-001,-001,-001,-001,-001,-001,-001,-001,-001,-001,-001,-001,-001,-001,-001,-001,-001,-001,-001,-001,-001,-001,-001,-001,-001,-001,-001,-001,-001,-001,-001,-001,-001,-001,-001,-001],
	[-001,-001,-001,-001,-001,-001,-001,-001,-001,-001,-001,-001,-001,-001,-001,-001,-001,-001,-001,-001,-001,-001,-001,-001,-001,-001,-001,-001,-001,-001,-001,-001,-001,-001,-001,-001,-001,-001,-001,-001,-001,-001,-001,-001,-001],
	[-001,-001,-001,-001,-001,-001,-001,-001,-001,-001,-001,-001,-001,-001,-001,-001,-001,-001,-001,-001,-001,-001,-001,-001,-001,-001,-001,-001,-001,-001,-001,-001,-001,-001,-001,-001,-001,-001,-001,-001,-001,-001,-001,-001,-001],
	[-001,-001,-001,-001,-001,-001,-001,-001,-001,-001,-001,-001,-001,-001,-001,-001,-001,-001,-001,-001,-001,-001,-001,-001,-001,-001,-001,-001,-001,-001,-001,-001,-001,-001,-001,-001,-001,-001,-001,-001,-001,-001,-001,-001,-001],
	[-001,-001,-001,-001,-001,-001,-001,-001,-001,-001,-001,-001,-001,-001,-001,-001,-001,-001,-001,-001,-001,-001,-001,-001,-001,-001,-001,-001,-001,-001,-001,-001,-001,-001,-001,-001,-001,-001,-001,-001,-001,-001,-001,-001,-001],
	[-001,-001,-001,-001,-001,-001,-001,-001,-001,-001,-001,-001,-001,-001,-001,-001,-001,-001,-001,-001,-001,-001,-001,-001,-001,-001,-001,-001,-001,-001,-001,-001,-001,-001,-001,-001,-001,-001,-001,-001,-001,-001,-001,-001,-001],
	[-001,-001,-001,-001,-001,-001,-001,-001,-001,-001,-001,-001,-001,-001,-001,-001,-001,-001,-001,-001,-001,-001,-001,-001,-001,-001,-001,-001,-001,-001,-001,-001,-001,-001,-001,-001,-001,-001,-001,-001,-001,-001,-001,-001,-001],
	[-001,-001,-001,-001,-001,-001,-001,-001,-001,-001,-001,-001,-001,-001,-001,-001,-001,-001,-001,-001,-001,-001,-001,-001,-001,-001,-001,-001,-001,-001,-001,-001,-001,-001,-001,-001,-001,-001,-001,-001,-001,-001,-001,-001,-001],
	[-001,-001,-001,-001,-001,-001,-001,-001,-001,-001,-001,-001,-001,-001,-001,-001,-001,-001,-001,-001,-001,-001,-001,-001,-001,-001,-001,-001,-001,-001,-001,-001,-001,-001,-001,-001,-001,-001,-001,-001,-001,-001,-001,-001,-001],
	[-001,-001,-001,-001,-001,-001,-001,-001,-001,-001,-001,-001,-001,-001,-001,-001,-001,-001,-001,-001,-001,-001,-001,-001,-001,-001,-001,-001,-001,-001,-001,-001,-001,-001,-001,-001,-001,-001,-001,-001,-001,-001,-001,-001,-001],
	[-001,-001,-001,-001,-001,-001,-001,-001,-001,-001,-001,-001,-001,-001,-001,-001,-001,-001,-001,-001,-001,-001,-001,-001,-001,-001,-001,-001,-001,-001,-001,-001,-001,-001,-001,-001,-001,-001,-001,-001,-001,-001,-001,-001,-001],
	[-001,-001,-001,-001,-001,-001,-001,-001,-001,-001,-001,-001,-001,-001,-001,-001,-001,-001,-001,-001,-001,-001,-001,-001,-001,-001,-001,-001,-001,-001,-001,-001,-001,-001,-001,-001,-001,-001,-001,-001,-001,-001,-001,-001,-001],
	[-001,-001,-001,-001,-001,-001,-001,-001,-001,-001,-001,-001,-001,-001,-001,-001,-001,-001,-001,-001,-001,-001,-001,-001,-001,-001,-001,-001,-001,-001,-001,-001,-001,-001,-001,-001,-001,-001,-001,-001,-001,-001,-001,-001,-001],
	[-001,-001,-001,-001,-001,-001,-001,-001,-001,-001,-001,-001,-001,-001,-001,-001,-001,-001,-001,-001,-001,-001,-001,-001,-001,-001,-001,-001,-001,-001,-001,-001,-001,-001,-001,-001,-001,-001,-001,-001,-001,-001,-001,-001,-001],
	[-001,-001,-001,-001,-001,-001,-001,-001,-001,-001,-001,-001,-001,-001,-001,-001,-001,-001,-001,-001,-001,-001,-001,-001,-001,-001,-001,-001,-001,-001,-001,-001,-001,-001,-001,-001,-001,-001,-001,-001,-001,-001,-001,-001,-001],
	[-001,-001,-001,-001,-001,-001,-001,-001,-001,-001,-001,-001,-001,-001,-001,-001,-001,-001,-001,-001,-001,-001,-001,-001,-001,-001,-001,-001,-001,-001,-001,-001,-001,-001,-001,-001,-001,-001,-001,-001,-001,-001,-001,-001,-001],
	[-001,-001,-001,-001,-001,-001,-001,-001,-001,-001,-001,-001,-001,-001,-001,-001,-001,-001,-001,-001,-001,-001,-001,-001,-001,-001,-001,-001,-001,-001,-001,-001,-001,-001,-001,-001,-001,-001,-001,-001,-001,-001,-001,-001,-001],
	[-001,-001,-001,-001,-001,-001,-001,-001,-001,-001,-001,-001,-001,-001,-001,-001,-001,-001,-001,-001,-001,-001,-001,-001,-001,-001,-001,-001,-001,-001,-001,-001,-001,-001,-001,-001,-001,-001,-001,-001,-001,-001,-001,-001,-001],
	[-001,-001,-001,-001,-001,-001,-001,-001,-001,-001,-001,-001,-001,-001,-001,-001,-001,-001,-001,-001,-001,-001,-001,-001,-001,-001,-001,-001,-001,-001,-001,-001,-001,-001,-001,-001,-001,-001,-001,-001,-001,-001,-001,-001,-001],
	[-001,-001,-001,-001,-001,-001,-001,-001,-001,-001,-001,-001,-001,-001,-001,-001,-001,-001,-001,-001,-001,-001,-001,-001,-001,-001,-001,-001,-001,-001,-001,-001,-001,-001,-001,-001,-001,-001,-001,-001,-001,-001,-001,-001,-001],
	[-001,-001,-001,-001,-001,-001,-001,-001,-001,-001,-001,-001,-001,-001,-001,-001,-001,-001,-001,-001,-001,-001,-001,-001,-001,-001,-001,-001,-001,-001,-001,-001,-001,-001,-001,-001,-001,-001,-001,-001,-001,-001,-001,-001,-001],
	[-001,-001,-001,-001,-001,-001,-001,-001,-001,-001,-001,-001,-001,-001,-001,-001,-001,-001,-001,-001,-001,-001,-001,-001,-001,-001,-001,-001,-001,-001,-001,-001,-001,-001,-001,-001,-001,-001,-001,-001,-001,-001,-001,-001,-001],
	[-001,-001,-001,-001,-001,-001,-001,-001,-001,-001,-001,-001,-001,-001,-001,-001,-001,-001,-001,-001,-001,-001,-001,-001,-001,-001,-001,-001,-001,-001,-001,-001,-001,-001,-001,-001,-001,-001,-001,-001,-001,-001,-001,-001,-001],
	[-001,-001,-001,-001,-001,-001,-001,-001,-001,-001,-001,-001,-001,-001,-001,-001,-001,-001,-001,-001,-001,-001,-001,-001,-001,-001,-001,-001,-001,-001,-001,-001,-001,-001,-001,-001,-001,-001,-001,-001,-001,-001,-001,-001,-001]
	],
	"events": [
	{
		"id": 247,
		"nom": "EV247",
		"x": 13,
		"y": 24,
		"pages": [
		{
			"conditions": [
			{
				"nom": "ArriveeAuContact"
			}
			],
			"commandes": [
			{
				"nom": "ChangerDeMap",
				"variable": false,
				"numeroNouvelleMap": 500,
				"xDebutHeros": 19,
				"yDebutHeros": 1
			}
			],
			"vitesse": "moderee",
			"frequence": "basse",
			"animeEnMouvement": true,
			"animeALArret": false,
			"directionFixe": false,
			"traversable": false,
			"auDessusDeTout": false
		}
		]
	},
	{
		"id": 248,
		"nom": "EV248",
		"x": 31,
		"y": 1,
		"pages": [
		{
			"conditions": [
			{
				"nom": "ArriveeAuContact"
			}
			],
			"commandes": [
			{
				"nom": "ChangerDeMap",
				"variable": false,
				"numeroNouvelleMap": 655,
				"xDebutHeros": 15,
				"yDebutHeros": 11
			}
			],
			"vitesse": "moderee",
			"frequence": "basse",
			"animeEnMouvement": true,
			"animeALArret": false,
			"directionFixe": false,
			"traversable": false,
			"auDessusDeTout": false
		}
		]
	},
	{
		"id": 1,
		"nom": "activer le verglas",
		"x": 14,
		"y": 23,
		"pages": [
		{
			"conditions": [
			],
			"commandes": [
			{
				"nom": "ModifierMeteo",
				"type": "neige",
				"intensite": 9
			},
			{
				"nom": "ModifierInterrupteur",
				"numeroInterrupteur": 36,
				"valeur": true
			},
			{
				"nom": "AppelerPageCommune",
				"numeroPageCommune": 55
			},
			{
				"nom": "SupprimerEvent"
			}
			],
			"vitesse": "tres rapide",
			"frequence": "la plus haute",
			"animeEnMouvement": false,
			"animeALArret": false,
			"directionFixe": false,
			"traversable": true,
			"auDessusDeTout": false
		}
		]
	},
	{
		"id": 249,
		"nom": "EV249",
		"x": 34,
		"y": 22,
		"pages": [
		{
			"conditions": [
			{
				"nom": "ArriveeAuContact"
			}
			],
			"commandes": [
			{
				"nom": "ChangerDeMap",
				"variable": false,
				"numeroNouvelleMap": 500,
				"xDebutHeros": 33,
				"yDebutHeros": 11
			}
			],
			"vitesse": "moderee",
			"frequence": "basse",
			"animeEnMouvement": true,
			"animeALArret": false,
			"directionFixe": false,
			"traversable": false,
			"auDessusDeTout": false
		}
		]
	},
	{
		"id": 2,
		"nom": "bonhomme de neige",
		"x": 10,
		"y": 13,
		"pages": [
		{
			"conditions": [
			{
				"nom": "Parler"
			}
			],
			"commandes": [
			],
			"image": 125,
			"vitesse": "moderee",
			"frequence": "basse",
			"animeEnMouvement": false,
			"animeALArret": false,
			"directionFixe": true,
			"traversable": true,
			"auDessusDeTout": true
		}
		]
	},
	{
		"id": 3,
		"nom": "Clone[21][6]",
		"x": 14,
		"y": 15
	}
	]
}
