{
	"nom": "11 (noir) mini",
	"tileset": "Sanctuaire de Kazan",
	"largeur": 21,
	"hauteur": 15,
	"musique": {
		"nomFichierSonore": "",
		"volume": 1.00,
		"tempo": 1.00
	},
	"fondSonore": {
		"nomFichierSonore": "",
		"volume": 0.80,
		"tempo": 1.00
	},
	"couche0": [
	[0036,0037,0004,0005,0004,0005,0004,0005,0004,0005,0004,0005,0004,0005,0004,0005,0004,0005,0004,0038,0039],
	[0044,0045,0012,0013,0012,0013,0012,0013,0012,0013,0012,0013,0012,0013,0012,0013,0012,0013,0012,0046,0047],
	[0048,0049,0000,0000,0000,0234,0234,0234,0000,0000,0000,0000,0000,0234,0234,0234,0000,0000,0000,0020,0021],
	[0056,0057,0000,0000,0000,0000,0000,0000,0000,0234,0000,0234,0000,0000,0000,0002,0000,0234,0000,0028,0029],
	[0064,0065,0000,0000,0000,0234,0234,0234,0234,0002,0000,0002,0234,0234,0234,0002,0234,0002,0000,0020,0021],
	[0006,0007,0234,0234,0234,0002,0000,0002,0000,0000,0000,0000,0000,0000,0000,0000,0000,0002,0000,0028,0029],
	[0014,0015,0002,0002,0002,0002,0000,0002,0234,0234,0000,0234,0234,0234,0234,0234,0000,0002,0000,0020,0021],
	[0006,0007,0002,0000,0000,0000,0000,0002,0000,0002,0000,0000,0000,0002,0002,0002,0000,0002,0000,0028,0029],
	[0014,0015,0002,0000,0234,0234,0000,0002,0000,0002,0234,0234,0000,0002,0000,0000,0000,0000,0000,0020,0021],
	[0006,0007,0002,0000,0002,0002,0000,0002,0000,0000,0000,0002,0234,0002,0000,0234,0234,0234,0234,0028,0029],
	[0014,0015,0000,0000,0000,0002,0000,0002,0000,0234,0000,0002,0000,0000,0000,0002,0000,0000,0000,0050,0051],
	[0006,0007,0000,0000,0000,0002,0000,0000,0000,0002,0000,0002,0234,0234,0000,0002,0000,0000,0000,0058,0059],
	[0014,0015,0000,0000,0000,0002,0234,0234,0234,0002,0000,0000,0000,0000,0000,0002,0000,0000,0000,0066,0067],
	[0052,0053,0032,0033,0034,0023,0022,0023,0022,0023,0022,0023,0022,0023,0022,0023,0032,0033,0034,0054,0055],
	[0060,0061,0040,0041,0042,0031,0030,0031,0030,0031,0030,0031,0030,0031,0030,0031,0040,0041,0042,0062,0063]
	],
	"couche1": [
	[-001,-001,-001,-001,-001,-001,-001,-001,-001,-001,-001,-001,-001,-001,-001,-001,-001,-001,-001,-001,-001],
	[-001,-001,-001,-001,-001,-001,-001,-001,-001,-001,-001,-001,-001,-001,-001,-001,-001,-001,-001,-001,-001],
	[-001,-001,-001,-001,-001,-001,-001,-001,-001,-001,-001,-001,-001,-001,-001,-001,-001,-001,-001,-001,-001],
	[-001,-001,-001,-001,-001,-001,-001,-001,-001,-001,-001,-001,-001,-001,-001,-001,-001,-001,-001,-001,-001],
	[-001,-001,-001,-001,-001,-001,-001,-001,-001,-001,-001,-001,-001,-001,-001,-001,-001,-001,-001,-001,-001],
	[-001,-001,-001,-001,-001,-001,-001,-001,-001,-001,-001,-001,-001,-001,-001,-001,-001,-001,-001,-001,-001],
	[-001,-001,-001,-001,-001,-001,-001,-001,-001,-001,-001,-001,-001,-001,-001,-001,-001,-001,-001,-001,-001],
	[-001,-001,-001,-001,-001,-001,-001,-001,-001,-001,-001,-001,-001,-001,-001,-001,-001,-001,-001,-001,-001],
	[-001,-001,-001,-001,-001,-001,-001,-001,-001,-001,-001,-001,-001,-001,-001,-001,-001,-001,-001,-001,-001],
	[-001,-001,-001,-001,-001,-001,-001,-001,-001,-001,-001,-001,-001,-001,-001,-001,-001,-001,-001,-001,-001],
	[-001,-001,-001,-001,-001,-001,-001,-001,-001,-001,-001,-001,-001,-001,-001,-001,-001,-001,-001,-001,-001],
	[-001,-001,-001,0011,-001,-001,-001,-001,-001,-001,-001,-001,-001,-001,-001,-001,-001,-001,-001,-001,-001],
	[-001,-001,-001,-001,-001,-001,-001,-001,-001,-001,-001,-001,-001,-001,-001,-001,-001,-001,-001,-001,-001],
	[-001,-001,-001,-001,-001,-001,-001,-001,-001,-001,-001,-001,-001,-001,-001,-001,-001,-001,-001,-001,-001],
	[-001,-001,-001,-001,-001,-001,-001,-001,-001,-001,-001,-001,-001,-001,-001,-001,-001,-001,-001,-001,-001]
	],
	"couche2": [
	[-001,-001,-001,-001,-001,-001,-001,-001,-001,-001,-001,-001,-001,-001,-001,-001,-001,-001,-001,-001,-001],
	[-001,-001,-001,-001,-001,-001,-001,-001,-001,-001,-001,-001,-001,-001,-001,-001,-001,-001,-001,-001,-001],
	[-001,-001,-001,-001,-001,-001,-001,-001,-001,-001,-001,-001,-001,-001,-001,-001,-001,-001,-001,-001,-001],
	[-001,-001,-001,-001,-001,-001,-001,-001,-001,-001,-001,-001,-001,-001,-001,-001,-001,-001,-001,-001,-001],
	[-001,-001,-001,-001,-001,-001,-001,-001,-001,-001,-001,-001,-001,-001,-001,-001,-001,-001,-001,-001,-001],
	[-001,-001,-001,-001,-001,-001,-001,-001,-001,-001,-001,-001,-001,-001,-001,-001,-001,-001,-001,-001,-001],
	[-001,-001,-001,-001,-001,-001,-001,-001,-001,-001,-001,-001,-001,-001,-001,-001,-001,-001,-001,-001,-001],
	[-001,-001,-001,-001,-001,-001,-001,-001,-001,-001,-001,-001,-001,-001,-001,-001,-001,-001,-001,-001,-001],
	[-001,-001,-001,-001,-001,-001,-001,-001,-001,-001,-001,-001,-001,-001,-001,-001,-001,-001,-001,-001,-001],
	[-001,-001,-001,-001,-001,-001,-001,-001,-001,-001,-001,-001,-001,-001,-001,-001,-001,-001,-001,-001,-001],
	[-001,-001,-001,-001,-001,-001,-001,-001,-001,-001,-001,-001,-001,-001,-001,-001,-001,-001,-001,-001,-001],
	[-001,-001,-001,-001,-001,-001,-001,-001,-001,-001,-001,-001,-001,-001,-001,-001,-001,-001,-001,-001,-001],
	[-001,-001,-001,-001,-001,-001,-001,-001,-001,-001,-001,-001,-001,-001,-001,-001,-001,-001,-001,-001,-001],
	[-001,-001,-001,-001,-001,-001,-001,-001,-001,-001,-001,-001,-001,-001,-001,-001,-001,-001,-001,-001,-001],
	[-001,-001,-001,-001,-001,-001,-001,-001,-001,-001,-001,-001,-001,-001,-001,-001,-001,-001,-001,-001,-001]
	],
	"events": [
	{
		"id": 16,
		"nom": "Clone[341][045]",
		"x": 13,
		"y": 10
	},
	{
		"id": 22,
		"nom": "Clone[341][045]",
		"x": 5,
		"y": 3
	},
	{
		"id": 11,
		"nom": "Clone[341][045]",
		"x": 3,
		"y": 9
	},
	{
		"id": 17,
		"nom": "Clone[341][045]",
		"x": 16,
		"y": 7
	},
	{
		"id": 12,
		"nom": "Obscurité",
		"x": 20,
		"y": 0,
		"pages": [
		{
			"conditions": [
			],
			"commandes": [
			{
				"nom": "ConditionTouche",
				"touche": "ACTION",
				"numero": 0
			},
			{
				"nom": "ConditionArmeEquipee",
				"idArme": 1,
				"numero": 1
			},
			{
				"nom": "AfficherImage",
				"numero": 2,
				"nomImage": "trou noir grotte grand",
				"centre": false,
				"variables": false,
				"x": 0,
				"y": 0,
				"zoomX": 100,
				"zoomY": 100,
				"opacite": 235,
				"modeDeFusion": "normal"
			},
			{
				"nom": "ConditionSinon",
				"numero": 1
			},
			{
				"nom": "ConditionArmeEquipee",
				"idArme": 3,
				"numero": 2
			},
			{
				"nom": "AfficherImage",
				"numero": 2,
				"nomImage": "trou noir grotte grand",
				"centre": false,
				"variables": false,
				"x": 0,
				"y": 0,
				"zoomX": 100,
				"zoomY": 100,
				"opacite": 235,
				"modeDeFusion": "normal"
			},
			{
				"nom": "ConditionSinon",
				"numero": 2
			},
			{
				"nom": "AfficherImage",
				"numero": 2,
				"nomImage": "trou noir grotte 3",
				"centre": false,
				"variables": false,
				"x": 0,
				"y": 0,
				"zoomX": 100,
				"zoomY": 100,
				"opacite": 255,
				"modeDeFusion": "normal"
			},
			{
				"nom": "ConditionFin",
				"numero": 2
			},
			{
				"nom": "ConditionFin",
				"numero": 1
			},
			{
				"nom": "ConditionSinon",
				"numero": 0
			},
			{
				"nom": "AfficherImage",
				"numero": 2,
				"nomImage": "trou noir grotte 3",
				"centre": false,
				"variables": false,
				"x": 0,
				"y": 0,
				"zoomX": 100,
				"zoomY": 100,
				"opacite": 255,
				"modeDeFusion": "normal"
			},
			{
				"nom": "ConditionFin",
				"numero": 0
			}
			],
			"vitesse": 8,
			"frequence": 8,
			"animeEnMouvement": true,
			"animeALArret": false,
			"directionFixe": false,
			"traversable": false,
			"auDessusDeTout": false
		}
		]
	},
	{
		"id": 18,
		"nom": "Clone[341][045]",
		"x": 16,
		"y": 3
	},
	{
		"id": 13,
		"nom": "Pancarte",
		"x": 3,
		"y": 11,
		"pages": [
		{
			"conditions": [
			{
				"nom": "Parler"
			}
			],
			"commandes": [
			{
				"nom": "ConditionDirection",
				"idEventConcerne": 0,
				"direction": 3,
				"numero": 0
			},
			{
				"nom": "ModifierInterrupteur",
				"numeroInterrupteur": 12,
				"valeur": true
			},
			{
				"nom": "ConditionVariable",
				"numeroVariable": 121,
				"inegalite": "==",
				"valeurQuIlEstCenseAvoir": 0,
				"comparerAUneAutreVariable": false,
				"numero": 1
			},
			{
				"nom": "Message",
				"texte": "La torche vive repousse l'obscurité et \\nconsume les obstacles inflammables."
			},
			{
				"nom": "ConditionSinon",
				"numero": 1
			},
			{
				"nom": "Message",
				"texte": "The bright torch will repel the dark and\\nconsumes flammable obstacles."
			},
			{
				"nom": "ConditionFin",
				"numero": 1
			},
			{
				"nom": "Attendre",
				"nombreDeFrames": 5
			},
			{
				"nom": "ConditionFin",
				"numero": 0
			},
			{
				"nom": "ModifierInterrupteur",
				"numeroInterrupteur": 12,
				"valeur": false
			}
			],
			"vitesse": 8,
			"frequence": 8,
			"animeEnMouvement": false,
			"animeALArret": false,
			"directionFixe": false,
			"traversable": false,
			"auDessusDeTout": false
		}
		]
	},
	{
		"id": 19,
		"nom": "Clone[341][045]",
		"x": 9,
		"y": 5
	},
	{
		"id": 8,
		"nom": "Clone[021][015]",
		"x": 12,
		"y": 8
	},
	{
		"id": 14,
		"nom": "Clone[341][045]",
		"x": 7,
		"y": 11
	},
	{
		"id": 20,
		"nom": "Clone[341][045]",
		"x": 9,
		"y": 2
	},
	{
		"id": 9,
		"nom": "Clone[021][015]",
		"x": 11,
		"y": 11
	},
	{
		"id": 21,
		"nom": "Clone[341][045]",
		"x": 12,
		"y": 3
	}
	]
}
