{
	"nom": "boss mini",
	"tileset": "Sanctuaire de Kazan",
	"largeur": 21,
	"hauteur": 30,
	"couche0": [
	[0004,0005,0004,0005,0004,0005,0004,0005,0004,0016,0017,0018,0004,0005,0004,0005,0004,0005,0004,0005,0004],
	[0226,0226,0226,0013,0012,0013,0012,0013,0012,0024,0160,0026,0012,0013,0012,0013,0012,0013,0012,0013,0012],
	[0036,0037,0004,0005,0004,0005,0004,0117,0004,0005,0004,0005,0004,0117,0004,0005,0004,0005,0004,0038,0039],
	[0044,0045,0012,0013,0012,0013,0012,0125,0012,0013,0012,0013,0012,0125,0012,0013,0012,0013,0012,0046,0047],
	[0006,0007,0010,0010,0010,0000,0000,0000,0000,0000,0000,0000,0000,0000,0000,0000,0010,0010,0010,0020,0021],
	[0014,0015,0010,0010,0010,0000,0000,0000,0000,0000,0000,0000,0000,0000,0000,0000,0010,0010,0010,0028,0029],
	[0006,0007,0010,0010,0010,0000,0000,0000,0000,0000,0000,0000,0000,0000,0000,0000,0010,0010,0010,0020,0021],
	[0014,0015,0000,0000,0000,0000,-007,-007,-007,0000,0000,0000,-007,-007,-007,0000,0000,0000,0000,0028,0029],
	[0006,0007,0000,0000,0000,-007,-007,-007,-007,0000,0000,0000,-007,-007,-007,-007,0000,0000,0000,0020,0021],
	[0014,0015,0000,0000,-007,-007,-007,-007,-007,0000,0000,0000,-007,-007,-007,-007,-007,0000,0000,0028,0029],
	[0006,0007,0000,0000,-007,-007,-007,-007,0000,0000,0000,0000,0000,-007,-007,-007,-007,0000,0000,0020,0021],
	[0014,0015,0000,0000,-007,-007,-007,0000,0000,0000,0000,0000,0000,0000,-007,-007,-007,0000,0000,0028,0029],
	[0006,0007,0000,0000,0000,0000,0000,0000,0000,0000,0000,0000,0000,0000,0000,0000,0000,0000,0000,0020,0021],
	[0014,0015,0000,0000,0000,0000,0000,0000,0000,0010,0010,0010,0000,0000,0000,0000,0000,0000,0000,0028,0029],
	[0006,0007,0000,0000,0000,0000,0000,0000,0000,0010,0010,0010,0000,0000,0000,0000,0000,0000,0000,0020,0021],
	[0014,0015,0000,0000,0000,0000,0000,0000,0000,0010,0010,0010,0000,0000,0000,0000,0000,0000,0000,0028,0029],
	[0006,0007,0000,0000,0000,0000,0000,0000,0000,0000,0000,0000,0000,0000,0000,0000,0000,0000,0000,0020,0021],
	[0014,0015,0000,0000,0000,0000,0000,0000,0000,0000,0000,0000,0000,0000,0000,0000,0000,0000,0000,0028,0029],
	[0006,0007,0000,0000,-007,-007,-007,0000,0000,0000,0000,0000,0000,0000,-007,-007,-007,0000,0000,0020,0021],
	[0014,0015,0000,0000,-007,-007,-007,-007,0000,0000,0000,0000,0000,-007,-007,-007,-007,0000,0000,0028,0029],
	[0006,0007,0000,0000,-007,-007,-007,-007,-007,0000,0000,0000,-007,-007,-007,-007,-007,0000,0000,0020,0021],
	[0014,0015,0000,0000,0000,-007,-007,-007,-007,0000,0000,0000,-007,-007,-007,-007,0000,0000,0000,0028,0029],
	[0006,0007,0000,0000,0000,0000,-007,-007,-007,0000,0000,0000,-007,-007,-007,0000,0000,0000,0000,0020,0021],
	[0014,0015,0010,0010,0010,0000,0000,0000,0000,0000,0000,0000,0000,0000,0000,0000,0010,0010,0010,0028,0029],
	[0006,0007,0010,0010,0010,0000,0000,0000,0000,0000,0000,0000,0000,0000,0000,0000,0010,0010,0010,0020,0021],
	[0014,0015,0010,0010,0010,0000,0000,0000,0000,0000,0000,0000,0000,0000,0000,0000,0010,0010,0010,0028,0029],
	[0052,0053,0023,0022,0023,0022,0023,0116,0023,0022,0023,0022,0023,0116,0023,0022,0023,0022,0023,0054,0055],
	[0060,0061,0031,0030,0031,0030,0031,0124,0031,0030,0031,0030,0031,0124,0031,0030,0031,0030,0031,0062,0063],
	[0022,0023,0022,0032,0169,0034,0023,0023,0022,0023,0022,0023,0022,0023,0022,0023,0022,0023,0022,0023,0022],
	[0030,0031,0030,0040,0041,0042,0031,0031,0030,0031,0030,0031,0030,0031,0030,0031,0030,0031,0030,0031,0030]
	],
	"couche1": [
	[-001,-001,-001,-001,-001,-001,-001,-001,-001,-001,-001,-001,-001,-001,-001,-001,-001,-001,-001,-001,-001],
	[-001,-001,-001,-001,-001,-001,-001,-001,-001,-001,-001,-001,-001,-001,-001,-001,-001,-001,-001,-001,-001],
	[-001,-001,-001,-001,-001,-001,-001,-001,-001,-001,-005,-001,-001,-001,-001,-001,-001,-001,-001,-001,-001],
	[-001,-001,-001,-001,-001,-001,-001,-001,-001,-001,-005,-001,-001,-001,-001,-001,-001,-001,-001,-001,-001],
	[-001,-001,-001,-001,-001,-001,-001,-001,-001,-001,-001,-001,-001,-001,-001,-001,-001,-001,-001,-001,-001],
	[-001,-001,-001,-001,-001,-001,-001,-001,-001,-001,-001,-001,-001,-001,-001,-001,-001,-001,-001,-001,-001],
	[-001,-001,-001,-001,-001,-001,-001,-001,-001,-001,-001,-001,-001,-001,-001,-001,-001,-001,-001,-001,-001],
	[-001,-001,-001,-001,-001,-001,-001,-001,-001,-001,-001,-001,-001,-001,-001,-001,-001,-001,-001,-001,-001],
	[-001,-001,-001,-001,-001,-001,-001,-001,-001,-001,-001,-001,-001,-001,-001,-001,-001,-001,-001,-001,-001],
	[-001,-001,-001,-001,-001,-001,-001,-001,-001,-001,-001,-001,-001,-001,-001,-001,-001,-001,-001,-001,-001],
	[-001,-001,-001,-001,-001,-001,-001,-001,-001,-001,-001,-001,-001,-001,-001,-001,-001,-001,-001,-001,-001],
	[-001,-001,-001,-001,-001,-001,-001,-001,-001,-001,-001,-001,-001,-001,-001,-001,-001,-001,-001,-001,-001],
	[-001,-001,-001,-001,-001,-001,-001,-001,-001,-001,-001,-001,-001,-001,-001,-001,-001,-001,-001,-001,-001],
	[-001,-001,-001,-001,-001,-001,-001,-001,-001,-001,-001,-001,-001,-001,-001,-001,-001,-001,-001,-001,-001],
	[-001,-001,-001,-001,-001,-001,-001,-001,-001,-001,-001,-001,-001,-001,-001,-001,-001,-001,-001,-001,-001],
	[-001,-001,-001,-001,-001,-001,-001,-001,-001,-001,-001,-001,-001,-001,-001,-001,-001,-001,-001,-001,-001],
	[-001,-001,-001,-001,-001,-001,-001,-001,-001,-001,-001,-001,-001,-001,-001,-001,-001,-001,-001,-001,-001],
	[-001,-001,-001,-001,-001,-001,-001,-001,-001,-001,-001,-001,-001,-001,-001,-001,-001,-001,-001,-001,-001],
	[-001,-001,-001,-001,-001,-001,-001,-001,-001,-001,-001,-001,-001,-001,-001,-001,-001,-001,-001,-001,-001],
	[-001,-001,-001,-001,-001,-001,-001,-001,-001,-001,-001,-001,-001,-001,-001,-001,-001,-001,-001,-001,-001],
	[-001,-001,-001,-001,-001,-001,-001,-001,-001,-001,-001,-001,-001,-001,-001,-001,-001,-001,-001,-001,-001],
	[-001,-001,-001,-001,-001,-001,-001,-001,-001,-001,-001,-001,-001,-001,-001,-001,-001,-001,-001,-001,-001],
	[-001,-001,-001,-001,-001,-001,-001,-001,-001,-001,-001,-001,-001,-001,-001,-001,-001,-001,-001,-001,-001],
	[-001,-001,-001,-001,-001,-001,-001,-001,-001,-001,-001,-001,-001,-001,-001,-001,-001,-001,-001,-001,-001],
	[-001,-001,-001,-001,-001,-001,-001,-001,-001,-001,-001,-001,-001,-001,-001,-001,-001,-001,-001,-001,-001],
	[-001,-001,-001,-001,-001,-001,-001,-001,-001,-001,-001,-001,-001,-001,-001,-001,-001,-001,-001,-001,-001],
	[-001,-001,-001,-001,-003,-001,-001,-001,-001,-001,-001,-001,-001,-001,-001,-001,-001,-001,-001,-001,-001],
	[-001,-001,-001,-001,-003,-001,-001,-001,-001,-001,-001,-001,-001,-001,-001,-001,-001,-001,-001,-001,-001],
	[-001,-001,-001,-001,-001,-001,-001,-001,-001,-001,-001,-001,-001,-001,-001,-001,-001,-001,-001,-001,-001],
	[-001,-001,-001,-001,-001,-001,-001,-001,-001,-001,-001,-001,-001,-001,-001,-001,-001,-001,-001,-001,-001]
	],
	"couche2": [
	[-001,-001,-001,-001,-001,-001,-001,-001,-001,-001,-001,-001,-001,-001,-001,-001,-001,-001,-001,-001,-001],
	[-001,-001,-001,-001,-001,-001,-001,-001,-001,-001,-001,-001,-001,-001,-001,-001,-001,-001,-001,-001,-001],
	[-001,-001,-001,-001,-001,-001,-001,-001,-001,-001,-001,-001,-001,-001,-001,-001,-001,-001,-001,-001,-001],
	[-001,-001,-001,-001,-001,-001,-001,-001,-001,-001,-001,-001,-001,-001,-001,-001,-001,-001,-001,-001,-001],
	[-001,-001,-001,-001,-001,-001,-001,-001,-001,-001,-001,-001,-001,-001,-001,-001,-001,-001,-001,-001,-001],
	[-001,-001,-001,-001,-001,-001,-001,-001,-001,-001,-001,-001,-001,-001,-001,-001,-001,-001,-001,-001,-001],
	[-001,-001,-001,-001,-001,-001,-001,-001,-001,-001,-001,-001,-001,-001,-001,-001,-001,-001,-001,-001,-001],
	[-001,-001,-001,-001,-001,-001,-001,-001,-001,-001,-001,-001,-001,-001,-001,-001,-001,-001,-001,-001,-001],
	[-001,-001,-001,-001,-001,-001,-001,-001,-001,-001,-001,-001,-001,-001,-001,-001,-001,-001,-001,-001,-001],
	[-001,-001,-001,-001,-001,-001,-001,-001,-001,-001,-001,-001,-001,-001,-001,-001,-001,-001,-001,-001,-001],
	[-001,-001,-001,-001,-001,-001,-001,-001,-001,-001,-001,-001,-001,-001,-001,-001,-001,-001,-001,-001,-001],
	[-001,-001,-001,-001,-001,-001,-001,-001,-001,-001,-001,-001,-001,-001,-001,-001,-001,-001,-001,-001,-001],
	[-001,-001,-001,-001,-001,-001,-001,-001,-001,-001,-001,-001,-001,-001,-001,-001,-001,-001,-001,-001,-001],
	[-001,-001,-001,-001,-001,-001,-001,-001,-001,-001,-001,-001,-001,-001,-001,-001,-001,-001,-001,-001,-001],
	[-001,-001,-001,-001,-001,-001,-001,-001,-001,-001,-001,-001,-001,-001,-001,-001,-001,-001,-001,-001,-001],
	[-001,-001,-001,-001,-001,-001,-001,-001,-001,-001,-001,-001,-001,-001,-001,-001,-001,-001,-001,-001,-001],
	[-001,-001,-001,-001,-001,-001,-001,-001,-001,-001,-001,-001,-001,-001,-001,-001,-001,-001,-001,-001,-001],
	[-001,-001,-001,-001,-001,-001,-001,-001,-001,-001,-001,-001,-001,-001,-001,-001,-001,-001,-001,-001,-001],
	[-001,-001,-001,-001,-001,-001,-001,-001,-001,-001,-001,-001,-001,-001,-001,-001,-001,-001,-001,-001,-001],
	[-001,-001,-001,-001,-001,-001,-001,-001,-001,-001,-001,-001,-001,-001,-001,-001,-001,-001,-001,-001,-001],
	[-001,-001,-001,-001,-001,-001,-001,-001,-001,-001,-001,-001,-001,-001,-001,-001,-001,-001,-001,-001,-001],
	[-001,-001,-001,-001,-001,-001,-001,-001,-001,-001,-001,-001,-001,-001,-001,-001,-001,-001,-001,-001,-001],
	[-001,-001,-001,-001,-001,-001,-001,-001,-001,-001,-001,-001,-001,-001,-001,-001,-001,-001,-001,-001,-001],
	[-001,-001,-001,-001,-001,-001,-001,-001,-001,-001,-001,-001,-001,-001,-001,-001,-001,-001,-001,-001,-001],
	[-001,-001,-001,-001,-001,-001,-001,-001,-001,-001,-001,-001,-001,-001,-001,-001,-001,-001,-001,-001,-001],
	[-001,-001,-001,-001,-001,-001,-001,-001,-001,-001,-001,-001,-001,-001,-001,-001,-001,-001,-001,-001,-001],
	[-001,-001,-001,-001,-001,-001,-001,-001,-001,-001,-001,-001,-001,-001,-001,-001,-001,-001,-001,-001,-001],
	[-001,-001,-001,-001,-001,-001,-001,-001,-001,-001,-001,-001,-001,-001,-001,-001,-001,-001,-001,-001,-001],
	[-001,-001,-001,-001,-001,-001,-001,-001,-001,-001,-001,-001,-001,-001,-001,-001,-001,-001,-001,-001,-001],
	[-001,-001,-001,-001,-001,-001,-001,-001,-001,-001,-001,-001,-001,-001,-001,-001,-001,-001,-001,-001,-001]
	],
	"events": [
	]
}
