{
	"nom": "maquette",
	"tileset": "NE PAS UTILISER",
	"largeur": 20,
	"hauteur": 15,
	"musique": {
		"nomFichierSonore": "",
		"volume": 1.00,
		"tempo": 1.00
	},
	"fondSonore": {
		"nomFichierSonore": "",
		"volume": 0.80,
		"tempo": 1.00
	},
	"couche0": [
	[0001,0001,0002,0003,0004,0065,0066,0067,0004,0005,0006,0007,0002,0003,0004,0005,0004,0005,0006,0007],
	[0001,0001,0010,0011,0012,0073,0074,0075,0012,0013,0014,0015,0010,0011,0012,0013,0012,0013,0014,0015],
	[0002,0003,0070,0071,0000,0000,0008,0000,0000,0000,0022,0023,0018,0019,0000,0000,0000,0000,0022,0023],
	[0010,0011,0078,0079,0000,0000,0000,0009,0000,0000,0030,0031,0026,0027,0000,0000,0000,0000,0084,0085],
	[0018,0019,-008,-008,-008,0000,0008,0000,0000,0000,0068,0069,0070,0071,0000,0000,0000,0000,0092,0093],
	[0026,0027,-008,-008,-008,0000,0000,0009,0000,0000,0076,0077,0078,0079,0000,0000,0000,0000,0100,0101],
	[0018,0019,-008,-008,-008,0000,0008,0000,0000,0000,-008,-008,-008,-004,0000,0000,0000,0000,0022,0023],
	[0026,0027,-008,-008,-008,0000,0000,0009,0000,0000,-008,-008,-008,-004,-004,-004,-004,-004,0030,0031],
	[0018,0019,-008,-008,-008,0000,0008,0000,0000,0000,-008,-008,-008,-008,-008,-008,-008,-008,0022,0023],
	[0018,0019,-008,-008,-008,0000,0000,0009,0000,0000,-008,-008,-008,-008,-008,-008,-008,-008,0030,0031],
	[0026,0027,-008,-008,0000,0000,0008,0000,0000,0000,0000,-008,-008,-008,-008,-008,-008,-008,0022,0023],
	[0018,0019,0000,0000,0000,0000,0000,0009,0000,0000,0000,0000,0052,0053,0036,0037,0036,0037,0038,0039],
	[0026,0027,0000,0000,0000,0000,0008,0000,0000,0000,0000,0000,0060,0061,0044,0045,0044,0045,0046,0047],
	[0034,0035,0036,0037,0036,0097,0098,0099,0036,0037,0036,0037,0038,0039,0001,0001,0001,0001,0001,0001],
	[0042,0043,0044,0045,0044,0105,0106,0107,0044,0045,0044,0045,0046,0047,0001,0001,0001,0001,0001,0001]
	],
	"couche1": [
	[-001,-001,-001,-001,-001,-001,-001,-001,-001,-001,-001,-001,-001,-001,-001,-001,-001,-001,-001,-001],
	[-001,-001,-001,-001,-001,-001,-001,-001,-001,-001,-001,-001,-001,-001,-001,-001,-001,-001,-001,-001],
	[-001,-001,-001,-001,-001,-001,-001,-001,-001,-001,-001,-001,-001,-001,-001,-001,-001,-001,-001,-001],
	[-001,-001,-001,-001,-001,-001,-001,-001,-001,-001,-001,-001,-001,-001,-001,-001,-001,-001,-001,-001],
	[-001,-001,-001,-001,-001,-001,-001,-001,-001,-001,-001,-001,-001,-001,-001,-001,-001,-001,-001,-001],
	[-001,-001,-001,-001,-001,-001,-001,-001,-001,-001,-001,-001,-001,-001,-001,-001,-001,-001,-001,-001],
	[-001,-001,-001,-001,-001,-001,-001,-001,-001,-001,-001,-001,-001,-001,-001,-001,-001,-001,-001,-001],
	[-001,-001,-001,-001,-001,-001,-001,-001,-001,-001,-001,-001,-001,-001,-001,-001,-001,-001,-001,-001],
	[-001,-001,-001,-001,-001,-001,-001,-001,-001,-001,-001,-001,-001,-001,-001,-001,-001,-001,-001,-001],
	[-001,-001,-001,-001,-001,-001,-001,-001,-001,-001,-001,-001,-001,-001,-001,-001,-001,-001,-001,-001],
	[-001,-001,-001,-001,-001,-001,-001,-001,-001,-001,-001,-001,-001,-001,-001,-001,-001,-001,-001,-001],
	[-001,-001,-001,-001,-001,-001,-001,-001,-001,-001,-001,-001,-001,-001,-001,-001,-001,-001,-001,-001],
	[-001,-001,-001,-001,-001,-001,-001,-001,-001,-001,-001,-001,-001,-001,-001,-001,-001,-001,-001,-001],
	[-001,-001,-001,-001,-001,-001,-001,-001,-001,-001,-001,-001,-001,-001,-001,-001,-001,-001,-001,-001],
	[-001,-001,-001,-001,-001,-001,-001,-001,-001,-001,-001,-001,-001,-001,-001,-001,-001,-001,-001,-001]
	],
	"couche2": [
	[-001,-001,-001,-001,-001,-001,-001,-001,-001,-001,-001,-001,-001,-001,-001,-001,-001,-001,-001,-001],
	[-001,-001,-001,-001,-001,-001,-001,-001,-001,-001,-001,-001,-001,-001,-001,-001,-001,-001,-001,-001],
	[-001,-001,-001,-001,-001,-001,-001,-001,-001,-001,-001,-001,-001,-001,-001,-001,-001,-001,-001,-001],
	[-001,-001,-001,-001,-001,-001,-001,-001,-001,-001,-001,-001,-001,-001,-001,-001,-001,-001,-001,-001],
	[-001,-001,-001,-001,-001,-001,-001,-001,-001,-001,-001,-001,-001,-001,-001,-001,-001,-001,-001,-001],
	[-001,-001,-001,-001,-001,-001,-001,-001,-001,-001,-001,-001,-001,-001,-001,-001,-001,-001,-001,-001],
	[-001,-001,-001,-001,-001,-001,-001,-001,-001,-001,-001,-001,-001,-001,-001,-001,-001,-001,-001,-001],
	[-001,-001,-001,-001,-001,-001,-001,-001,-001,-001,-001,-001,-001,-001,-001,-001,-001,-001,-001,-001],
	[-001,-001,-001,-001,-001,-001,-001,-001,-001,-001,-001,-001,-001,-001,-001,-001,-001,-001,-001,-001],
	[-001,-001,-001,-001,-001,-001,-001,-001,-001,-001,-001,-001,-001,-001,-001,-001,-001,-001,-001,-001],
	[-001,-001,-001,-001,-001,-001,-001,-001,-001,-001,-001,-001,-001,-001,-001,-001,-001,-001,-001,-001],
	[-001,-001,-001,-001,-001,-001,-001,-001,-001,-001,-001,-001,-001,-001,-001,-001,-001,-001,-001,-001],
	[-001,-001,-001,-001,-001,-001,-001,-001,-001,-001,-001,-001,-001,-001,-001,-001,-001,-001,-001,-001],
	[-001,-001,-001,-001,-001,-001,-001,-001,-001,-001,-001,-001,-001,-001,-001,-001,-001,-001,-001,-001],
	[-001,-001,-001,-001,-001,-001,-001,-001,-001,-001,-001,-001,-001,-001,-001,-001,-001,-001,-001,-001]
	],
	"events": [
	{
		"id": 5,
		"nom": "EV005",
		"x": 11,
		"y": 5,
		"pages": [
		{
			"conditions": [
			],
			"commandes": [
			{
				"nom": "ModifierBrouillard",
				"opacite": 100,
				"modeDeFusion": "negatif",
				"defilementX": 0,
				"defilementY": 0,
				"zoom": 200,
				"nuance": 150,
				"nomImage": "006-Sandstorm02"
			}
			],
			"vitesse": "moderee",
			"frequence": "basse",
			"animeEnMouvement": true,
			"animeALArret": false,
			"directionFixe": false,
			"traversable": false,
			"auDessusDeTout": false
		}
		]
	},
	{
		"id": 6,
		"nom": "Réglages initiaux",
		"x": 11,
		"y": 4,
		"pages": [
		{
			"conditions": [
			],
			"commandes": [
			{
				"nom": "EffacerImage",
				"numero": 9
			},
			{
				"nom": "ModifierInterrupteur",
				"numeroInterrupteur": 12,
				"valeur": false
			},
			{
				"nom": "ConditionInterrupteur",
				"numeroInterrupteur": 1,
				"valeurQuIlEstCenseAvoir": false,
				"numero": 0
			},
			{
				"nom": "ModifierVariable",
				"numeroVariable": 5,
				"operationAFaire": "rendre egal a",
				"valeurADonner": 10,
				"operationAFaire2": "valeur brute"
			},
			{
				"nom": "ModifierVariable",
				"numeroVariable": 4,
				"operationAFaire": "rendre egal a",
				"valeurADonner": 10,
				"operationAFaire2": "valeur brute"
			},
			{
				"nom": "AjouterArme",
				"idArme": 0
			},
			{
				"nom": "AjouterArme",
				"idArme": 1
			},
			{
				"nom": "AjouterArme",
				"idArme": 4
			},
			{
				"nom": "AjouterArme",
				"idArme": 5
			},
			{
				"nom": "ModifierInterrupteur",
				"numeroInterrupteur": 1,
				"valeur": true
			},
			{
				"nom": "AjouterObjet",
				"idObjet": 0,
				"variable": false,
				"quantite": 1
			},
			{
				"nom": "AjouterObjet",
				"idObjet": 2,
				"variable": false,
				"quantite": 1
			},
			{
				"nom": "AjouterObjet",
				"idObjet": 3,
				"variable": false,
				"quantite": 1
			},
			{
				"nom": "AjouterObjet",
				"idObjet": 4,
				"variable": false,
				"quantite": 1
			},
			{
				"nom": "AjouterArme",
				"idArme": 2
			},
			{
				"nom": "AjouterArme",
				"idArme": 3
			},
			{
				"nom": "AjouterGadget",
				"idGadget": 1
			},
			{
				"nom": "AjouterObjet",
				"idObjet": 30,
				"variable": false,
				"quantite": 20
			},
			{
				"nom": "AjouterObjet",
				"idObjet": 31,
				"variable": false,
				"quantite": 1
			},
			{
				"nom": "AjouterGadget",
				"idGadget": 0
			},
			{
				"nom": "AjouterObjet",
				"idObjet": 5,
				"variable": false,
				"quantite": 1
			},
			{
				"nom": "AjouterArme",
				"idArme": 6
			},
			{
				"nom": "ConditionSinon",
				"numero": 0
			},
			{
				"nom": "ConditionFin",
				"numero": 0
			},
			{
				"nom": "Deplacement",
				"idEventADeplacer": 0,
				"ignorerLesMouvementsImpossibles": false,
				"repeterLeDeplacement": false,
				"attendreLaFinDuDeplacement": false,
				"mouvements": [
				{
					"nom": "ModifierApparence",
					"image": "Jiyounasu character",
					"direction": 0,
					"animation": 0,
					"teinte": 0
				},
				{
					"nom": "AppelerUneCommande",
					"nomCommande": "Attendre",
					"nombreDeFrames": 8
				},
				{
					"nom": "ModifierApparence",
					"image": "Jiyounasu character",
					"direction": 0,
					"animation": 0,
					"teinte": 0
				},
				{
					"nom": "RendreDirectionFixe",
					"directionFixe": false
				}
				]
			},
			{
				"nom": "EffacerImage",
				"numero": 3
			},
			{
				"nom": "SupprimerEvent"
			}
			],
			"vitesse": "tres rapide",
			"frequence": "la plus haute",
			"animeEnMouvement": false,
			"animeALArret": false,
			"directionFixe": false,
			"traversable": false,
			"auDessusDeTout": false
		}
		]
	},
	{
		"id": 1,
		"nom": "Clone[341][008]",
		"x": 15,
		"y": 2
	},
	{
		"id": 2,
		"nom": "Clone[341][039]",
		"x": 4,
		"y": 12
	},
	{
		"id": 3,
		"nom": "Clone[341][039]",
		"x": 9,
		"y": 12
	},
	{
		"id": 4,
		"nom": "Clone[341][001]",
		"x": 9,
		"y": 2
	}
	]
}
