{
	"nom": "Tour tambour",
	"tileset": "Desert",
	"largeur": 20,
	"hauteur": 30,
	"musique": {
		"nomFichierSonore": "",
		"volume": 1.00,
		"tempo": 1.00
	},
	"fondSonore": {
		"nomFichierSonore": "",
		"volume": 0.80,
		"tempo": 1.00
	},
	"couche0": [
	[0133,0133,0133,0133,0133,0133,0133,0133,0133,0133,0133,0133,0133,0133,0133,0133,0133,0133,0133,0133],
	[0133,0133,0133,0133,0133,0133,0133,0133,0133,0133,0133,0133,0133,0133,0133,0133,0133,0133,0133,0133],
	[0133,0133,0133,0133,0133,0133,0133,0133,0133,0133,0133,0133,0133,0133,0133,0133,0133,0133,0133,0133],
	[0133,0133,0133,0133,0133,0133,0133,0133,0133,0133,0133,0133,0133,0133,0133,0133,0133,0133,0133,0133],
	[0133,0133,0133,0080,0133,0133,0133,0133,0133,0133,0133,0133,0133,0133,0133,0133,0133,0133,0133,0133],
	[0080,0133,0133,0133,0133,0133,0133,0133,0133,0133,0133,0133,0133,0133,0133,0133,0133,0081,0133,0133],
	[0133,0133,0133,0133,0133,0133,0133,0133,0133,0133,0133,0133,0133,0133,0133,0133,0133,0133,0080,0133],
	[0133,0133,0133,0133,0133,0133,0133,0133,0133,0133,0133,0133,0133,0133,0133,0133,0133,0133,0133,0133],
	[0133,0133,0133,0133,0133,0133,0133,0133,0133,0133,0133,0133,0133,0133,0133,0133,0133,0133,0133,0133],
	[0133,0133,0133,0133,0133,0082,0133,0133,0133,0133,0133,0133,0133,0133,0133,0133,0133,0133,0133,0133],
	[0133,0081,0080,0133,0133,0133,0083,0133,0133,0133,0133,0133,0133,0133,0133,0133,0133,0133,0133,0133],
	[0133,0133,0133,0133,0133,0133,0133,0133,0133,0133,0133,0133,0133,0133,0133,0133,0133,0133,0133,0133],
	[0133,0133,0133,0133,0133,0133,0133,0133,0133,0133,0133,0133,0133,0082,0133,0133,0133,0133,0133,0133],
	[0133,0133,0133,0133,0133,0133,0133,0133,0133,0133,0133,0083,0133,0133,0133,0080,0133,0133,0133,0133],
	[0133,0133,0133,0133,0133,0133,0133,0133,0133,0133,0133,0133,0133,0133,0133,0133,0133,0133,0133,0133],
	[0133,0133,0133,0133,0133,0133,0080,0081,0133,0133,0133,0080,0080,0133,0133,0133,0133,0133,0133,0133],
	[0133,0133,0133,0133,0133,0133,0133,0080,0133,0133,0133,0080,0133,0133,0133,0133,0133,0133,0133,0133],
	[0133,0133,0133,0133,0133,0133,0133,0133,0133,0133,0133,0133,0133,0133,0133,0133,0133,0133,0133,0133],
	[0133,0133,0133,0133,0133,0133,0133,0133,0133,0133,0133,0133,0133,0133,0133,0133,0133,0133,0133,0133],
	[0133,0133,0133,0133,0133,0133,0133,0133,0133,0133,0133,0133,0133,0133,0133,0133,0133,0133,0133,0133],
	[0133,0133,0133,0133,0133,0133,0133,0133,0133,0133,0133,0133,0133,0133,0133,0133,0133,0133,0133,0133],
	[0133,0133,0133,0133,0133,0133,0133,0133,0133,0133,0133,0133,0133,0133,0133,0133,0133,0133,0133,0133],
	[0133,0133,0133,0133,0133,0133,0133,0133,0133,0133,0133,0133,0133,0133,0133,0133,0133,0133,0133,0133],
	[0133,0133,0133,0133,0133,0133,0133,0133,0133,0133,0133,0133,0133,0133,0133,0133,0133,0133,0133,0133],
	[0133,0133,0133,0133,0133,0133,0133,0133,0133,0133,0133,0133,0133,0133,0133,0133,0133,0133,0133,0133],
	[0133,0133,0133,0133,0133,0133,0133,0133,0133,0133,0133,0133,0133,0133,0133,0133,0133,0133,0133,0133],
	[0133,0133,0133,0133,0133,0133,0133,0133,0133,0133,0133,0133,0133,0133,0133,0133,0133,0133,0133,0133],
	[0133,0133,0133,0133,0133,0133,0133,0133,0133,0133,0133,0133,0133,0133,0133,0133,0133,0133,0133,0133],
	[0133,0133,0133,0133,0133,0133,0133,0133,0133,0133,0133,0133,0133,0133,0133,0133,0133,0133,0133,0133],
	[0133,0133,0133,0133,0133,0133,0133,0133,0133,0133,0133,0133,0133,0133,0133,0133,0133,0133,0133,0133]
	],
	"couche1": [
	[-001,-001,-001,-001,-001,-001,-001,-001,-001,0090,-001,-001,-001,-001,-001,-001,-001,-001,-001,-001],
	[-001,-001,-001,-001,-001,-001,-001,0096,0097,0098,0099,0100,-001,-001,-001,-001,-001,-001,-001,-001],
	[-001,-001,-001,-001,-001,-001,-001,0104,0105,0106,0107,0108,-001,-001,-001,-001,-001,-001,-001,-001],
	[-001,-001,-001,-001,-001,-001,-001,0112,0113,0114,0115,0116,-001,-001,-001,-001,-001,-001,-001,-001],
	[-001,-001,-001,-001,-001,-001,-001,0120,0121,0122,0123,0124,-001,-001,-001,-001,-001,0073,-001,-001],
	[-001,-001,-001,-001,-001,-001,-001,0112,0125,0126,0127,0116,-001,-001,-001,-001,-001,-001,-001,-001],
	[-001,-001,-001,-001,-001,-001,-001,0120,0121,0122,0123,0124,-001,-001,-001,-001,-001,-001,-001,-001],
	[-001,-001,-001,-001,-001,-001,-001,0112,0125,0126,0127,0116,-001,-001,-001,-001,-001,-001,-001,-001],
	[-001,-001,-001,-001,-001,-001,-001,0120,0121,0122,0123,0124,-001,-001,-001,-001,-001,-001,-001,-001],
	[-001,0073,-001,-001,-001,-001,-001,0128,0129,0130,0131,0132,-001,-001,-001,-001,-001,-001,-001,-001],
	[-001,-001,-001,-001,-001,-001,-001,0136,0137,0138,0139,0140,-001,-001,-001,-001,-001,-001,-001,-001],
	[-001,-001,-001,-001,-001,-001,-001,0144,0145,0146,0147,0148,-001,-001,-001,-001,-001,-001,-001,-001],
	[-001,-001,-001,-001,-001,-001,-001,0152,0153,0154,0155,0156,-001,-001,-001,-001,-001,-001,-001,-001],
	[-001,-001,-001,-001,-001,-001,-001,-001,-001,-001,0085,-001,-001,-001,-001,-001,-001,-001,-001,-001],
	[-001,-001,-001,-001,-001,-001,-001,0073,-001,-001,-001,-001,-001,-001,-001,-001,-001,-001,-001,-001],
	[-001,-001,-001,-001,-001,-001,-001,-001,-001,-001,-001,-001,-001,-001,-001,-001,-001,-001,-001,-001],
	[-001,-001,-001,-001,-001,-001,-001,-001,-001,-001,-001,-001,-001,-001,-001,-001,-001,-001,-001,-001],
	[-001,-001,-001,-001,-001,-001,-001,-001,-001,-001,-001,-001,-001,-001,-001,-001,-001,-001,-001,-001],
	[-001,-001,-001,-001,-001,-001,-001,-001,-001,-001,-001,-001,-001,-001,-001,-001,-001,-001,-001,-001],
	[-001,-001,-001,-001,-001,-001,-001,-001,-001,-001,-001,-001,-001,-001,-001,-001,-001,-001,-001,-001],
	[-001,-001,-001,-001,-001,-001,-001,-001,-001,-001,-001,-001,-001,-001,-001,-001,-001,-001,-001,-001],
	[-001,-001,-001,-001,-001,-001,-001,-001,-001,-001,-001,-001,-001,-001,-001,-001,-001,-001,-001,-001],
	[-001,-001,-001,-001,-001,-001,-001,-001,-001,-001,-001,-001,-001,-001,-001,-001,-001,-001,-001,-001],
	[-001,-001,-001,-001,-001,-001,-001,-001,-001,-001,-001,-001,-001,-001,-001,-001,-001,-001,-001,-001],
	[-001,-001,-001,-001,-001,-001,-001,-001,-001,-001,-001,-001,-001,-001,-001,-001,-001,-001,-001,-001],
	[-001,-001,-001,-001,-001,-001,-001,-001,-001,-001,-001,-001,-001,-001,-001,-001,-001,-001,-001,-001],
	[-001,-001,-001,-001,-001,-001,-001,-001,-001,-001,-001,-001,-001,-001,-001,-001,-001,-001,-001,-001],
	[-001,-001,-001,-001,-001,-001,-001,-001,-001,-001,-001,-001,-001,-001,-001,-001,-001,-001,-001,-001],
	[-001,-001,-001,-001,-001,-001,-001,-001,-001,-001,-001,-001,-001,-001,-001,-001,-001,-001,-001,-001],
	[-001,-001,-001,-001,-001,-001,-001,-001,-001,-001,-001,-001,-001,-001,-001,-001,-001,-001,-001,-001]
	],
	"couche2": [
	[-001,-001,-001,-001,-001,-001,-001,-001,-001,-001,-001,-001,-001,-001,-001,-001,-001,-001,-001,-001],
	[-001,-001,-001,-001,-001,-001,-001,-001,-001,-001,-001,-001,-001,-001,-001,-001,-001,-001,-001,-001],
	[-001,-001,-001,-001,-001,-001,-001,-001,-001,-001,-001,-001,-001,-001,-001,-001,-001,-001,-001,-001],
	[-001,-001,-001,-001,-001,-001,-001,-001,-001,-001,-001,-001,-001,-001,-001,-001,-001,-001,-001,-001],
	[-001,-001,-001,-001,-001,-001,-001,-001,-001,-001,-001,-001,-001,-001,-001,-001,-001,-001,-001,-001],
	[-001,-001,-001,-001,-001,-001,-001,-001,-001,-001,-001,-001,-001,-001,-001,-001,-001,-001,-001,-001],
	[-001,-001,-001,-001,-001,-001,-001,-001,-001,-001,-001,-001,-001,-001,-001,-001,-001,-001,-001,-001],
	[-001,-001,-001,-001,-001,-001,-001,-001,-001,-001,-001,-001,-001,-001,-001,-001,-001,-001,-001,-001],
	[-001,-001,-001,-001,-001,-001,-001,-001,-001,-001,-001,-001,-001,-001,-001,-001,-001,-001,-001,-001],
	[-001,-001,-001,-001,-001,-001,-001,-001,-001,-001,-001,-001,-001,-001,-001,-001,-001,-001,-001,-001],
	[-001,-001,-001,-001,-001,-001,-001,-001,-001,-001,-001,-001,-001,-001,-001,-001,-001,-001,-001,-001],
	[-001,-001,-001,-001,-001,-001,-001,-001,-001,-001,-001,-001,-001,-001,-001,-001,-001,-001,-001,-001],
	[-001,-001,-001,-001,-001,-001,-001,-001,-001,-001,-001,-001,-001,-001,-001,-001,-001,-001,-001,-001],
	[-001,-001,-001,-001,-001,-001,-001,-001,-001,-001,-001,-001,-001,-001,-001,-001,-001,-001,-001,-001],
	[-001,-001,-001,-001,-001,-001,-001,-001,-001,-001,-001,-001,-001,-001,-001,-001,-001,-001,-001,-001],
	[-001,-001,-001,-001,-001,-001,-001,-001,-001,-001,-001,-001,-001,-001,-001,-001,-001,-001,-001,-001],
	[-001,-001,-001,-001,-001,-001,-001,-001,-001,-001,-001,-001,-001,-001,-001,-001,-001,-001,-001,-001],
	[-001,-001,-001,-001,-001,-001,-001,-001,-001,-001,-001,-001,-001,-001,-001,-001,-001,-001,-001,-001],
	[-001,-001,-001,-001,-001,-001,-001,-001,-001,-001,-001,-001,-001,-001,-001,-001,-001,-001,-001,-001],
	[-001,-001,-001,-001,-001,-001,-001,-001,-001,-001,-001,-001,-001,-001,-001,-001,-001,-001,-001,-001],
	[-001,-001,-001,-001,-001,-001,-001,-001,-001,-001,-001,-001,-001,-001,-001,-001,-001,-001,-001,-001],
	[-001,-001,-001,-001,-001,-001,-001,-001,-001,-001,-001,-001,-001,-001,-001,-001,-001,-001,-001,-001],
	[-001,-001,-001,-001,-001,-001,-001,-001,-001,-001,-001,-001,-001,-001,-001,-001,-001,-001,-001,-001],
	[-001,-001,-001,-001,-001,-001,-001,-001,-001,-001,-001,-001,-001,-001,-001,-001,-001,-001,-001,-001],
	[-001,-001,-001,-001,-001,-001,-001,-001,-001,-001,-001,-001,-001,-001,-001,-001,-001,-001,-001,-001],
	[-001,-001,-001,-001,-001,-001,-001,-001,-001,-001,-001,-001,-001,-001,-001,-001,-001,-001,-001,-001],
	[-001,-001,-001,-001,-001,-001,-001,-001,-001,-001,-001,-001,-001,-001,-001,-001,-001,-001,-001,-001],
	[-001,-001,-001,-001,-001,-001,-001,-001,-001,-001,-001,-001,-001,-001,-001,-001,-001,-001,-001,-001],
	[-001,-001,-001,-001,-001,-001,-001,-001,-001,-001,-001,-001,-001,-001,-001,-001,-001,-001,-001,-001],
	[-001,-001,-001,-001,-001,-001,-001,-001,-001,-001,-001,-001,-001,-001,-001,-001,-001,-001,-001,-001]
	],
	"events": [
	{
		"id": 1,
		"nom": "crabe",
		"x": 16,
		"y": 8,
		"pages": [
		{
			"conditions": [
			{
				"nom": "Parler"
			}
			],
			"commandes": [
			],
			"image": "crabe2 character",
			"animationInitiale": 2,
			"vitesse": "moderee",
			"frequence": "basse",
			"animeEnMouvement": true,
			"animeALArret": false,
			"directionFixe": false,
			"traversable": false,
			"auDessusDeTout": false
		}
		]
	},
	{
		"id": 2,
		"nom": "crabe",
		"x": 14,
		"y": 6,
		"pages": [
		{
			"conditions": [
			{
				"nom": "Parler"
			}
			],
			"commandes": [
			],
			"image": "crabe2 character",
			"animationInitiale": 2,
			"vitesse": "moderee",
			"frequence": "basse",
			"animeEnMouvement": true,
			"animeALArret": false,
			"directionFixe": false,
			"traversable": false,
			"auDessusDeTout": false
		}
		]
	},
	{
		"id": 3,
		"nom": "Pancarte",
		"x": 10,
		"y": 13,
		"pages": [
		{
			"conditions": [
			{
				"nom": "Parler"
			}
			],
			"commandes": [
			{
				"nom": "ConditionDirection",
				"idEventConcerne": 0,
				"direction": 3,
				"numero": 0
			},
			{
				"nom": "ModifierInterrupteur",
				"numeroInterrupteur": 12,
				"valeur": true
			},
			{
				"nom": "Message",
				"texte": "TOUR TAMBOUR"
			},
			{
				"nom": "Message",
				"texte": "Donjon bonus disponible dans le DLC."
			},
			{
				"nom": "Attendre",
				"nombreDeFrames": 8
			},
			{
				"nom": "ConditionFin",
				"numero": 0
			},
			{
				"nom": "ModifierInterrupteur",
				"numeroInterrupteur": 12,
				"valeur": false
			}
			],
			"vitesse": "moderee",
			"frequence": "basse",
			"animeEnMouvement": false,
			"animeALArret": false,
			"directionFixe": false,
			"traversable": false,
			"auDessusDeTout": false
		}
		]
	},
	{
		"id": 4,
		"nom": "blocage",
		"x": 9,
		"y": 10,
		"pages": [
		{
			"conditions": [
			{
				"nom": "Parler"
			}
			],
			"commandes": [
			],
			"image": "blocage character",
			"vitesse": "moderee",
			"frequence": "basse",
			"animeEnMouvement": false,
			"animeALArret": false,
			"directionFixe": true,
			"traversable": false,
			"auDessusDeTout": false
		}
		]
	}
	]
}
