{
	"nom": "essai",
	"tileset": "Foret",
	"largeur": 20,
	"hauteur": 15,
	"musique": {
		"nomFichierSonore": "",
		"volume": 1.00,
		"tempo": 1.00
	},
	"fondSonore": {
		"nomFichierSonore": "",
		"volume": 0.80,
		"tempo": 1.00
	},
	"couche0": [
	[0809,0809,0809,0809,0809,0809,0809,0809,0809,0809,0809,0809,0809,0809,0809,0809,0809,0809,0809,0809],
	[0809,0809,0809,0809,0809,0809,0809,0800,0801,0801,0801,0801,0801,0801,0801,0801,0801,0802,0809,0809],
	[0809,0809,0809,0800,0801,0801,0801,0017,0009,0880,0880,0880,0880,0880,0880,0880,0013,0810,0809,0809],
	[0809,0809,0809,0808,0009,0880,0880,0880,0891,0884,0884,0884,0884,0884,0884,0884,0881,0810,0809,0809],
	[0809,0809,0809,0808,0888,0884,0884,0884,0884,0884,0884,0884,0884,0884,0884,0884,0881,0810,0809,0809],
	[0809,0800,0801,0017,0888,0884,0884,0884,0884,0884,0884,0884,0884,0884,0884,0884,0881,0810,0809,0809],
	[0809,0808,0009,0880,0891,0884,0884,0884,0884,0884,0884,0884,0884,0884,0884,0884,0881,0810,0809,0809],
	[0809,0808,0888,0884,0884,0884,0884,0884,0884,0884,0884,0884,0884,0884,0884,0884,0881,0810,0809,0809],
	[0809,0808,0888,0884,0884,0884,0884,0884,0884,0884,0884,0884,0884,0884,0884,0884,0881,0810,0809,0809],
	[0809,0808,0888,0884,0884,0884,0884,0884,0884,0884,0884,0884,0884,0884,0882,0889,0054,0810,0809,0809],
	[0809,0808,0888,0884,0884,0884,0884,0884,0884,0884,0884,0884,0884,0884,0881,0053,0817,0818,0809,0809],
	[0809,0808,0888,0884,0884,0884,0884,0884,0884,0884,0884,0884,0882,0889,0054,0810,0809,0809,0809,0809],
	[0809,0808,0048,0889,0889,0889,0889,0889,0889,0889,0889,0889,0054,0053,0817,0818,0809,0809,0809,0809],
	[0809,0816,0817,0817,0817,0817,0817,0817,0817,0817,0817,0817,0817,0818,0809,0809,0809,0809,0809,0809],
	[0809,0809,0809,0809,0809,0809,0809,0809,0809,0809,0809,0809,0809,0809,0809,0809,0809,0809,0809,0809]
	],
	"couche1": [
	[-001,-001,-001,-001,-001,-001,-001,-001,-001,-001,-001,-001,-001,-001,-001,-001,-001,-001,-001,-001],
	[-001,-001,-001,-001,-001,-001,-001,-001,-001,-001,0248,0249,0250,-001,-001,-001,-001,-001,-001,-001],
	[-001,-001,-001,-001,-001,-001,-001,-001,-001,-001,0256,0257,0258,-001,-001,-001,-001,-001,-001,-001],
	[-001,-001,-001,-001,-001,-001,-001,-001,-001,-001,0264,0265,0266,-001,-001,-001,-001,-001,-001,-001],
	[-001,-001,-001,-001,-001,-001,-001,-001,-001,-001,-001,-001,-001,-001,-001,-001,-001,-001,-001,-001],
	[-001,-001,-001,-001,0248,0249,0250,-001,-001,-001,-001,-001,-001,-001,-001,-001,-001,-001,-001,-001],
	[-001,-001,-001,-001,0256,0257,0258,-001,-001,0248,0249,0250,-001,-001,-001,-001,-001,-001,-001,-001],
	[-001,-001,-001,-001,0264,0265,0266,-001,-001,0256,0257,0258,-001,-001,-001,-001,-001,-001,-001,-001],
	[-001,-001,-001,-001,-001,-001,-001,-001,-001,0264,0265,0266,-001,-001,-001,-001,-001,-001,-001,-001],
	[-001,-001,-001,-001,-001,0248,0249,0250,-001,-001,-001,-001,-001,-001,-001,-001,-001,-001,-001,-001],
	[-001,-001,-001,-001,-001,0256,0257,0258,-001,-001,-001,-001,-001,-001,-001,-001,-001,-001,-001,-001],
	[-001,-001,-001,-001,-001,0264,0265,0266,-001,-001,-001,-001,-001,-001,-001,-001,-001,-001,-001,-001],
	[-001,-001,-001,-001,-001,-001,-001,-001,-001,-001,-001,-001,-001,-001,-001,-001,-001,-001,-001,-001],
	[-001,-001,-001,-001,-001,-001,-001,-001,-001,-001,-001,-001,-001,-001,-001,-001,-001,-001,-001,-001],
	[-001,-001,-001,-001,-001,-001,-001,-001,-001,-001,-001,-001,-001,-001,-001,-001,-001,-001,-001,-001]
	],
	"couche2": [
	[-001,-001,-001,-001,-001,-001,-001,-001,-001,-001,-001,-001,-001,-001,-001,-001,-001,-001,-001,-001],
	[-001,-001,-001,-001,-001,-001,-001,-001,-001,-001,-001,-001,-001,-001,-001,-001,-001,-001,-001,-001],
	[-001,-001,-001,-001,-001,-001,-001,-001,-001,-001,-001,-001,-001,-001,-001,-001,-001,-001,-001,-001],
	[-001,-001,-001,-001,-001,-001,-001,-001,-001,-001,-001,-001,-001,-001,-001,-001,-001,-001,-001,-001],
	[-001,-001,-001,-001,-001,-001,-001,-001,-001,-001,-001,-001,-001,-001,-001,-001,-001,-001,-001,-001],
	[-001,-001,-001,-001,-001,-001,-001,-001,-001,-001,-001,-001,-001,-001,-001,-001,-001,-001,-001,-001],
	[-001,-001,-001,-001,-001,-001,-001,-001,-001,-001,-001,-001,-001,-001,-001,-001,-001,-001,-001,-001],
	[-001,-001,-001,-001,-001,-001,-001,-001,-001,-001,-001,-001,-001,-001,-001,-001,-001,-001,-001,-001],
	[-001,-001,-001,-001,-001,-001,-001,-001,-001,-001,-001,-001,-001,-001,-001,-001,-001,-001,-001,-001],
	[-001,-001,-001,-001,-001,-001,-001,-001,-001,-001,-001,-001,-001,-001,-001,-001,-001,-001,-001,-001],
	[-001,-001,-001,-001,-001,-001,-001,-001,-001,-001,-001,-001,-001,-001,-001,-001,-001,-001,-001,-001],
	[-001,-001,-001,-001,-001,-001,-001,-001,-001,-001,-001,-001,-001,-001,-001,-001,-001,-001,-001,-001],
	[-001,-001,-001,-001,-001,-001,-001,-001,-001,-001,-001,-001,-001,-001,-001,-001,-001,-001,-001,-001],
	[-001,-001,-001,-001,-001,-001,-001,-001,-001,-001,-001,-001,-001,-001,-001,-001,-001,-001,-001,-001],
	[-001,-001,-001,-001,-001,-001,-001,-001,-001,-001,-001,-001,-001,-001,-001,-001,-001,-001,-001,-001]
	],
	"events": [
	{
		"id": 1,
		"nom": "Clone[341][028]",
		"x": 7,
		"y": 4
	},
	{
		"id": 2,
		"nom": "Clone[341][028]",
		"x": 3,
		"y": 7
	},
	{
		"id": 3,
		"nom": "Clone[341][028]",
		"x": 15,
		"y": 8
	}
	]
}
