{
	"nom": "Maison de la crique",
	"tileset": "Maison",
	"largeur": 21,
	"hauteur": 15,
	"musique": {
		"nomFichierSonore": "Maison 2.ogg",
		"volume": 1.00,
		"tempo": 1.00
	},
	"fondSonore": {
		"nomFichierSonore": "001-Wind01.ogg",
		"volume": 0.00,
		"tempo": 1.00
	},
	"couche0": [
	[0017,0017,0017,0017,0017,0017,0017,0017,0017,0017,0017,0017,0017,0017,0017,0017,0017,0017,0017,0017,0017],
	[0017,0017,0017,0017,0017,0017,0017,0017,0017,0017,0017,0017,0017,0017,0017,0017,0017,0017,0017,0017,0017],
	[0017,0017,0017,0340,0341,0308,0309,0308,0309,0308,0309,0308,0309,0308,0309,0342,0343,0017,0017,0017,0017],
	[0017,0017,0017,0348,0349,0316,0317,0316,0317,0316,0317,0316,0317,0316,0317,0350,0351,0017,0017,0017,0017],
	[0017,0017,0017,0324,0325,0000,0000,0000,0000,0000,0000,0000,0000,0000,0000,0310,0311,0017,0017,0017,0017],
	[0017,0017,0017,0332,0333,0000,0000,0000,0000,0000,0000,0000,0000,0000,0000,0318,0319,0017,0017,0017,0017],
	[0017,0017,0017,0324,0325,0000,0000,0000,0000,0000,0000,0000,0000,0000,0000,0310,0311,0017,0017,0017,0017],
	[0017,0017,0017,0332,0333,0000,0000,0000,0000,0000,-008,-008,-008,-008,0000,0318,0319,0017,0017,0017,0017],
	[0017,0017,0017,0324,0325,0000,0000,0000,0000,0000,-008,-008,-008,-008,0000,0310,0311,0017,0017,0017,0017],
	[0017,0017,0017,0332,0333,0000,0000,0000,0000,0000,-008,-008,-008,-008,0000,0318,0319,0017,0017,0017,0017],
	[0017,0017,0017,0324,0325,0000,0000,0000,0000,0000,0000,0000,0000,0000,0000,0310,0311,0017,0017,0017,0017],
	[0017,0017,0017,0356,0357,0326,0327,0326,0327,0326,0327,0023,0327,0326,0327,0358,0359,0017,0017,0017,0017],
	[0017,0017,0017,0364,0365,0334,0335,0334,0335,0334,0335,0000,0335,0334,0335,0366,0367,0017,0017,0017,0017],
	[0017,0017,0017,0017,0017,0017,0017,0017,0017,0017,0017,0017,0017,0017,0017,0017,0017,0017,0017,0017,0017],
	[0017,0017,0017,0017,0017,0017,0017,0017,0017,0017,0017,0017,0017,0017,0017,0017,0017,0017,0017,0017,0017]
	],
	"couche1": [
	[-001,-001,-001,-001,-001,-001,-001,-001,-001,-001,-001,-001,-001,-001,-001,-001,-001,-001,-001,-001,-001],
	[-001,-001,-001,-001,-001,-001,-001,-001,-001,-001,-001,-001,-001,-001,-001,-001,-001,-001,-001,-001,-001],
	[-001,-001,-001,-001,-001,0028,0029,0512,0513,0514,0050,0003,0004,-001,-001,-001,-001,-001,-001,-001,-001],
	[-001,-001,-001,-001,-001,0036,0037,0520,0521,0522,0058,0011,0012,0030,0031,-001,-001,-001,-001,-001,-001],
	[-001,-001,-001,-001,-001,0044,0045,0528,0529,0530,-001,0019,0020,0038,0039,-001,-001,-001,-001,-001,-001],
	[-001,-001,-001,-001,-001,-001,-001,-001,-001,-001,-001,-001,-001,0046,0047,-001,-001,-001,-001,-001,-001],
	[-001,-001,-001,0082,0083,-001,0005,0006,0007,-001,-001,-001,-001,-001,-001,0080,0081,-001,-001,-001,-001],
	[-001,-001,-001,0090,0091,-001,0013,0014,0015,-001,-001,-001,-001,-001,-001,0088,0089,-001,-001,-001,-001],
	[-001,-001,-001,0098,0099,-001,-001,0002,-001,-001,-001,-001,-001,-001,-001,0096,0097,-001,-001,-001,-001],
	[-001,-001,-001,-001,-001,-001,-001,-001,-001,-001,-001,-001,-001,-001,-001,-001,-001,-001,-001,-001,-001],
	[-001,-001,-001,-001,-001,-001,-001,-001,-001,-001,-001,-001,-001,-001,-001,-001,-001,-001,-001,-001,-001],
	[-001,-001,-001,-001,-001,-001,0067,0068,0069,-001,0384,0385,0386,-001,-001,-001,-001,-001,-001,-001,-001],
	[-001,-001,-001,-001,-001,-001,0075,0076,0077,-001,0392,0393,0394,-001,-001,-001,-001,-001,-001,-001,-001],
	[-001,-001,-001,-001,-001,-001,-001,-001,-001,-001,-001,-001,-001,-001,-001,-001,-001,-001,-001,-001,-001],
	[-001,-001,-001,-001,-001,-001,-001,-001,-001,-001,-001,-001,-001,-001,-001,-001,-001,-001,-001,-001,-001]
	],
	"couche2": [
	[-001,-001,-001,-001,-001,-001,-001,-001,-001,-001,-001,-001,-001,-001,-001,-001,-001,-001,-001,-001,-001],
	[-001,-001,-001,-001,-001,-001,-001,-001,-001,-001,-001,-001,-001,-001,-001,-001,-001,-001,-001,-001,-001],
	[-001,-001,-001,-001,-001,-001,-001,-001,-001,-001,-001,-001,-001,-001,-001,-001,-001,-001,-001,-001,-001],
	[-001,-001,-001,-001,-001,-001,-001,-001,-001,-001,-001,-001,-001,-001,-001,-001,-001,-001,-001,-001,-001],
	[-001,-001,-001,-001,-001,-001,-001,-001,-001,-001,-001,-001,-001,-001,-001,-001,-001,-001,-001,-001,-001],
	[-001,-001,-001,-001,-001,-001,-001,-001,-001,-001,-001,-001,-001,-001,-001,-001,-001,-001,-001,-001,-001],
	[-001,-001,-001,-001,-001,-001,-001,-001,-001,-001,-001,-001,-001,-001,-001,-001,-001,-001,-001,-001,-001],
	[-001,-001,-001,-001,-001,-001,-001,-001,-001,-001,-001,-001,-001,-001,-001,-001,-001,-001,-001,-001,-001],
	[-001,-001,-001,-001,-001,-001,-001,-001,-001,-001,-001,-001,-001,-001,-001,-001,-001,-001,-001,-001,-001],
	[-001,-001,-001,-001,-001,-001,-001,-001,-001,-001,-001,-001,-001,-001,-001,-001,-001,-001,-001,-001,-001],
	[-001,-001,-001,-001,-001,-001,-001,-001,-001,-001,-001,-001,-001,-001,-001,-001,-001,-001,-001,-001,-001],
	[-001,-001,-001,-001,-001,-001,-001,-001,-001,-001,-001,-001,-001,-001,-001,-001,-001,-001,-001,-001,-001],
	[-001,-001,-001,-001,-001,-001,-001,-001,-001,-001,-001,-001,-001,-001,-001,-001,-001,-001,-001,-001,-001],
	[-001,-001,-001,-001,-001,-001,-001,-001,-001,-001,-001,-001,-001,-001,-001,-001,-001,-001,-001,-001,-001],
	[-001,-001,-001,-001,-001,-001,-001,-001,-001,-001,-001,-001,-001,-001,-001,-001,-001,-001,-001,-001,-001]
	],
	"events": [
	{
		"id": 5,
		"nom": "EV005",
		"x": 11,
		"y": 12,
		"pages": [
		{
			"conditions": [
			{
				"nom": "ArriveeAuContact"
			}
			],
			"commandes": [
			{
				"nom": "ChangerDeMap",
				"variable": false,
				"numeroNouvelleMap": 507,
				"xDebutHeros": 74,
				"yDebutHeros": 79
			}
			],
			"vitesse": "moderee",
			"frequence": "basse",
			"animeEnMouvement": true,
			"animeALArret": false,
			"directionFixe": false,
			"traversable": false,
			"auDessusDeTout": false
		}
		]
	},
	{
		"id": 6,
		"nom": "feu (8)",
		"x": 8,
		"y": 3,
		"pages": [
		{
			"conditions": [
			{
				"nom": "Parler"
			}
			],
			"commandes": [
			],
			"image": "feu character",
			"vitesse": "tres rapide",
			"frequence": "la plus haute",
			"animeEnMouvement": false,
			"animeALArret": true,
			"directionFixe": true,
			"traversable": false,
			"auDessusDeTout": false
		}
		]
	},
	{
		"id": 1,
		"nom": "Clone[341][004]",
		"x": 6,
		"y": 10
	},
	{
		"id": 2,
		"nom": "Clone[341][004]",
		"x": 5,
		"y": 10
	},
	{
		"id": 3,
		"nom": "Clone[341][004]",
		"x": 14,
		"y": 6
	},
	{
		"id": 4,
		"nom": "Plante en pot",
		"x": 7,
		"y": 6,
		"pages": [
		{
			"conditions": [
			{
				"nom": "Parler"
			}
			],
			"commandes": [
			],
			"image": "plante en pot character",
			"directionInitiale": 3,
			"vitesse": "moderee",
			"frequence": "basse",
			"animeEnMouvement": false,
			"animeALArret": false,
			"directionFixe": true,
			"traversable": false,
			"auDessusDeTout": false
		}
		]
	}
	]
}
