{
	"nom": "Sanctuaire de Taiyou",
	"tileset": "Zone Enneigée",
	"largeur": 21,
	"hauteur": 30,
	"musique": {
		"nomFichierSonore": "",
		"volume": 1.00,
		"tempo": 1.00
	},
	"fondSonore": {
		"nomFichierSonore": "",
		"volume": 0.80,
		"tempo": 1.00
	},
	"couche0": [
	[0184,0024,0024,0000,0030,0030,0179,0170,0171,0189,0190,0168,0169,0170,0177,0024,0024,0000,0030,0030,0188],
	[0184,0024,0024,0000,0030,0021,0011,0013,0188,0168,0189,0190,0184,0009,0011,0017,0024,0000,0030,0030,0188],
	[0184,0024,0024,0000,0021,0011,0013,0030,0179,0170,0170,0170,0177,0024,0009,0011,0017,0000,0030,0030,0188],
	[0177,0024,0024,0000,0189,0190,0030,0021,0011,0011,0011,0011,0011,0017,0024,0189,0190,0000,0030,0030,0179],
	[0011,0017,0024,0000,0000,0000,0021,0011,0011,0011,0011,0011,0011,0011,0017,0000,0000,0000,0030,0021,0011],
	[0016,0011,0017,0000,0000,0009,0011,0011,0011,0011,0011,0011,0011,0011,0011,0022,0000,0000,0021,0011,0022],
	[0024,0016,0011,0011,0011,0017,0009,0011,0011,0011,0011,0011,0011,0011,0022,0021,0011,0011,0011,0022,0030],
	[0032,0024,0016,0011,0011,0011,0017,0009,0011,0011,0003,0011,0011,0022,0021,0011,0011,0011,0022,0030,0030],
	[0024,0032,0024,0016,0011,0011,0011,0017,0000,0000,0000,0000,0000,0021,0011,0011,0011,0022,0030,0030,0030],
	[0017,0024,0024,0024,-006,-006,-006,-006,0000,0000,0000,0000,0000,-006,-006,-006,-006,0030,0030,0030,0021],
	[0011,0017,0024,0024,-006,-006,-006,-006,0000,0000,0000,0000,0000,-006,-006,-006,-006,0030,0030,0021,0011],
	[0190,0000,0024,0024,-006,-006,-006,-006,0000,0000,0000,0000,0000,-006,-006,-006,-006,0030,0030,0000,0189],
	[0000,0000,0024,0024,-006,-006,-006,-006,-006,-006,0000,-006,-006,-006,-006,-006,-006,0030,0030,0000,0000],
	[0000,0000,0024,0024,-006,-006,-006,-006,-006,-006,0000,-006,-006,-006,-006,-006,-006,0030,0030,0000,0000],
	[0058,0049,0024,0024,-006,-006,-006,-006,-006,-006,0000,-006,-006,-006,-006,-006,-006,0030,0030,0053,0059],
	[0049,0024,0024,0024,-006,-006,-006,-006,-006,-006,0000,-006,-006,-006,-006,-006,-006,0030,0030,0030,0053],
	[0024,0024,0024,0024,-006,-006,-006,-006,-006,-006,0000,-006,-006,-006,-006,-006,-006,0030,0030,0030,0030],
	[0024,0024,0024,0024,-006,-006,-006,-006,-006,-006,0000,-006,-006,-006,-006,-006,-006,0030,0030,0030,0030],
	[0017,0024,0024,0024,-006,-006,-006,-006,-006,-006,0000,-006,-006,-006,-006,-006,-006,0030,0030,0030,0021],
	[0011,0017,0024,0024,-006,-006,-006,0189,0190,0000,0000,0000,0005,0000,-006,-006,-006,0030,0030,0021,0011],
	[0011,0011,0017,0024,-006,-006,-006,0000,0000,0000,0000,0000,0000,0000,0000,0000,0000,0030,0021,0011,0011],
	[0011,0011,0011,0017,0000,0000,0000,0000,0000,0000,0000,0000,0000,0000,-006,-006,0000,0021,0011,0011,0011],
	[0000,0000,0000,0000,0000,-006,-006,0053,0058,0058,0058,0058,0058,0049,-006,-006,0000,0000,0000,0000,0000],
	[0000,0000,0000,0000,0000,-006,-006,0030,0053,0058,0058,0058,0049,0024,-006,-006,0000,0000,0000,0000,0000],
	[0058,0058,0058,0058,0058,0058,0058,0054,0030,0000,0000,0052,0024,0048,0058,0058,0058,0058,0058,0058,0058],
	[0058,0058,0058,0058,0058,0058,0058,0058,0054,0008,0000,0000,0048,0058,0058,0058,0058,0058,0058,0058,0058],
	[0058,0058,0058,0058,0058,0058,0058,0058,0058,0058,0051,0058,0058,0058,0058,0058,0058,0058,0058,0058,0058],
	[0058,0058,0058,0058,0058,0058,0058,0058,0058,0058,0058,0058,0058,0058,0058,0058,0058,0058,0058,0058,0058],
	[0058,0058,0058,0058,0058,0058,0058,0058,0058,0058,0058,0058,0058,0058,0058,0058,0058,0058,0058,0058,0058],
	[0058,0058,0058,0058,0058,0058,0058,0058,0058,0058,0058,0058,0058,0058,0058,0058,0058,0058,0058,0058,0058]
	],
	"couche1": [
	[-001,-001,-001,-001,-001,-001,-001,-001,-001,-001,0181,0182,-001,-001,-001,-001,-001,-001,-001,-001,-001],
	[-001,-001,-001,-001,0173,0174,-001,-001,-001,-001,-001,-001,-001,-001,-001,0173,0174,-001,-001,-001,-001],
	[-001,-001,-001,-001,0181,0182,-001,-001,-001,-001,-001,-001,-001,-001,-001,0181,0182,-001,-001,-001,-001],
	[-001,-001,-001,-001,-001,-001,-001,-001,-001,-001,-001,-001,-001,-001,-001,-001,-001,-001,-001,-001,-001],
	[-001,-001,-001,-001,-001,-001,-001,-001,-001,-001,-001,-001,-001,-001,-001,-001,-001,-001,-001,-001,-001],
	[-001,-001,-001,-001,-001,-001,-001,-001,-001,-001,-001,-001,-001,-001,-001,-001,-001,-001,-001,-001,-001],
	[-001,-001,-001,-001,-001,-001,-001,-001,-001,-001,-001,-001,-001,-001,-001,-001,-001,-001,-001,-001,-001],
	[-001,-001,-001,-001,-001,-001,-001,-001,-001,0063,0004,0063,-001,-001,-001,-001,-001,-001,-001,-001,-001],
	[-001,-001,-001,-001,-001,-001,-001,-001,-001,0071,-001,0071,-001,-001,-001,-001,-001,-001,-001,-001,-001],
	[0174,-001,-001,-001,-001,-001,-001,-001,0063,-001,-001,-001,0063,-001,-001,-001,-001,-001,-001,-001,0173],
	[0182,-001,-001,-001,-001,-001,-001,-001,0071,0063,-001,0063,0071,-001,-001,-001,-001,-001,-001,-001,0181],
	[-001,-001,-001,-001,-001,-001,-001,-001,-001,0071,-001,0071,-001,-001,-001,-001,-001,-001,-001,-001,-001],
	[-001,-001,-001,-001,-001,-001,-001,-001,-001,-001,-001,-001,-001,-001,-001,-001,-001,-001,-001,-001,-001],
	[-001,-001,-001,-001,-001,-001,-001,-001,-001,-001,-001,-001,-001,-001,-001,-001,-001,-001,-001,-001,-001],
	[-001,-001,-001,-001,-001,-001,-001,-001,-001,-001,-001,-001,-001,-001,-001,-001,-001,-001,-001,-001,-001],
	[-001,-001,-001,-001,-001,-001,-001,-001,-001,-001,-001,-001,-001,-001,-001,-001,-001,-001,-001,-001,-001],
	[-001,-001,-001,-001,-001,-001,-001,-001,-001,-001,-001,-001,-001,-001,-001,-001,-001,-001,-001,-001,-001],
	[-001,-001,-001,-001,-001,-001,-001,0173,0174,-001,-001,-001,-001,-001,-001,-001,-001,-001,-001,-001,-001],
	[-001,-001,-001,-001,-001,-001,-001,0181,0182,-001,-001,-001,-001,-001,-001,-001,-001,-001,-001,-001,-001],
	[-001,-001,-001,-001,-001,-001,-001,-001,-001,-001,-001,-001,-001,-001,-001,-001,-001,-001,-001,-001,-001],
	[-001,-001,-001,-001,-001,-001,-001,-001,-001,-001,-001,-001,-001,-001,-001,-001,-001,-001,-001,-001,-001],
	[-001,-001,-001,-001,-001,-001,-001,-001,-001,-001,-001,-001,-001,-001,-001,-001,-001,-001,-001,-001,-001],
	[-001,-001,-001,-001,-001,-001,-001,-001,-001,-001,-004,-001,-001,-001,-001,-001,-001,-001,-001,-001,-001],
	[-001,-001,-001,-001,-001,-001,-001,-001,-001,-001,-004,0044,-001,-001,-001,-001,-001,-001,-001,-001,-001],
	[-001,-001,-001,-001,-001,-001,-001,-001,-001,-001,-001,-001,-001,-001,-001,-001,-001,-001,-001,-001,-001],
	[-001,-001,-001,-001,-001,-001,-001,-001,-001,-001,-001,-001,-001,-001,-001,-001,-001,-001,-001,-001,-001],
	[-001,-001,-001,-001,-001,-001,-001,-001,-001,-001,0050,-001,-001,-001,-001,-001,-001,-001,-001,-001,-001],
	[-001,-001,-001,-001,-001,-001,-001,-001,-001,-001,-001,-001,-001,-001,-001,-001,-001,-001,-001,-001,-001],
	[-001,-001,-001,-001,-001,-001,-001,-001,-001,-001,-001,-001,-001,-001,-001,-001,-001,-001,-001,-001,-001],
	[-001,-001,-001,-001,-001,-001,-001,-001,-001,-001,-001,-001,-001,-001,-001,-001,-001,-001,-001,-001,-001]
	],
	"couche2": [
	[-001,-001,-001,-001,-001,-001,-001,-001,-001,-001,-001,-001,-001,-001,-001,-001,-001,-001,-001,-001,-001],
	[-001,-001,-001,-001,-001,-001,-001,-001,-001,-001,-001,-001,-001,-001,-001,-001,-001,-001,-001,-001,-001],
	[-001,-001,-001,-001,-001,-001,-001,-001,-001,-001,-001,-001,-001,-001,-001,-001,-001,-001,-001,-001,-001],
	[-001,-001,-001,-001,-001,-001,-001,-001,-001,-001,-001,-001,-001,-001,-001,-001,-001,-001,-001,-001,-001],
	[-001,-001,-001,-001,-001,-001,-001,-001,-001,-001,-001,-001,-001,-001,-001,-001,-001,-001,-001,-001,-001],
	[-001,-001,-001,-001,-001,-001,-001,-001,-001,-001,-001,-001,-001,-001,-001,-001,-001,-001,-001,-001,-001],
	[-001,-001,-001,-001,-001,-001,-001,-001,-001,-001,-001,-001,-001,-001,-001,-001,-001,-001,-001,-001,-001],
	[-001,-001,-001,-001,-001,-001,-001,-001,-001,-001,-001,-001,-001,-001,-001,-001,-001,-001,-001,-001,-001],
	[-001,-001,-001,-001,-001,-001,-001,-001,-001,-001,-001,-001,-001,-001,-001,-001,-001,-001,-001,-001,-001],
	[-001,-001,-001,-001,-001,-001,-001,-001,-001,-001,-001,-001,-001,-001,-001,-001,-001,-001,-001,-001,-001],
	[-001,-001,-001,-001,-001,-001,-001,-001,-001,-001,-001,-001,-001,-001,-001,-001,-001,-001,-001,-001,-001],
	[-001,-001,-001,-001,-001,-001,-001,-001,-001,-001,-001,-001,-001,-001,-001,-001,-001,-001,-001,-001,-001],
	[-001,-001,-001,-001,-001,-001,-001,-001,-001,-001,-001,-001,-001,-001,-001,-001,-001,-001,-001,-001,-001],
	[-001,-001,-001,-001,-001,-001,-001,-001,-001,-001,-001,-001,-001,-001,-001,-001,-001,-001,-001,-001,-001],
	[-001,-001,-001,-001,-001,-001,-001,-001,-001,-001,-001,-001,-001,-001,-001,-001,-001,-001,-001,-001,-001],
	[-001,-001,-001,-001,-001,-001,-001,-001,-001,-001,-001,-001,-001,-001,-001,-001,-001,-001,-001,-001,-001],
	[-001,-001,-001,-001,-001,-001,-001,-001,-001,-001,-001,-001,-001,-001,-001,-001,-001,-001,-001,-001,-001],
	[-001,-001,-001,-001,-001,-001,-001,-001,-001,-001,-001,-001,-001,-001,-001,-001,-001,-001,-001,-001,-001],
	[-001,-001,-001,-001,-001,-001,-001,-001,-001,-001,-001,-001,-001,-001,-001,-001,-001,-001,-001,-001,-001],
	[-001,-001,-001,-001,-001,-001,-001,-001,-001,-001,-001,-001,-001,-001,-001,-001,-001,-001,-001,-001,-001],
	[-001,-001,-001,-001,-001,-001,-001,-001,-001,-001,-001,-001,-001,-001,-001,-001,-001,-001,-001,-001,-001],
	[-001,-001,-001,-001,-001,-001,-001,-001,-001,-001,-001,-001,-001,-001,-001,-001,-001,-001,-001,-001,-001],
	[-001,-001,-001,-001,-001,-001,-001,-001,-001,-001,-001,-001,-001,-001,-001,-001,-001,-001,-001,-001,-001],
	[-001,-001,-001,-001,-001,-001,-001,-001,-001,-001,-001,-001,-001,-001,-001,-001,-001,-001,-001,-001,-001],
	[-001,-001,-001,-001,-001,-001,-001,-001,-001,-001,-001,-001,-001,-001,-001,-001,-001,-001,-001,-001,-001],
	[-001,-001,-001,-001,-001,-001,-001,-001,-001,-001,-001,-001,-001,-001,-001,-001,-001,-001,-001,-001,-001],
	[-001,-001,-001,-001,-001,-001,-001,-001,-001,-001,-001,-001,-001,-001,-001,-001,-001,-001,-001,-001,-001],
	[-001,-001,-001,-001,-001,-001,-001,-001,-001,-001,-001,-001,-001,-001,-001,-001,-001,-001,-001,-001,-001],
	[-001,-001,-001,-001,-001,-001,-001,-001,-001,-001,-001,-001,-001,-001,-001,-001,-001,-001,-001,-001,-001],
	[-001,-001,-001,-001,-001,-001,-001,-001,-001,-001,-001,-001,-001,-001,-001,-001,-001,-001,-001,-001,-001]
	],
	"events": [
	{
		"id": 1,
		"nom": "EV001",
		"x": 10,
		"y": 26,
		"pages": [
		{
			"conditions": [
			{
				"nom": "ArriveeAuContact"
			}
			],
			"commandes": [
			{
				"nom": "ChangerDeMap",
				"variable": false,
				"numeroNouvelleMap": 520,
				"xDebutHeros": 31,
				"yDebutHeros": 2
			}
			],
			"vitesse": "moderee",
			"frequence": "basse",
			"animeEnMouvement": true,
			"animeALArret": false,
			"directionFixe": false,
			"traversable": false,
			"auDessusDeTout": false
		}
		]
	},
	{
		"id": 2,
		"nom": "Pancarte",
		"x": 12,
		"y": 19,
		"pages": [
		{
			"conditions": [
			{
				"nom": "Parler"
			}
			],
			"commandes": [
			{
				"nom": "ConditionDirection",
				"idEventConcerne": 0,
				"direction": 3,
				"numero": 0
			},
			{
				"nom": "ModifierInterrupteur",
				"numeroInterrupteur": 12,
				"valeur": true
			},
			{
				"nom": "Message",
				"texte": "GLACIER D'IVOIRE\\n/\\ Sanctuaire de Taiyô\\nV Village viking jaune"
			},
			{
				"nom": "Attendre",
				"nombreDeFrames": 8
			},
			{
				"nom": "ConditionSinon",
				"numero": 0
			},
			{
				"nom": "ConditionFin",
				"numero": 0
			},
			{
				"nom": "ModifierInterrupteur",
				"numeroInterrupteur": 12,
				"valeur": false
			}
			],
			"vitesse": "moderee",
			"frequence": "basse",
			"animeEnMouvement": false,
			"animeALArret": false,
			"directionFixe": false,
			"traversable": false,
			"auDessusDeTout": false
		}
		]
	},
	{
		"id": 3,
		"nom": "EV003",
		"x": 10,
		"y": 7,
		"pages": [
		{
			"conditions": [
			{
				"nom": "ArriveeAuContact"
			}
			],
			"commandes": [
			{
				"nom": "ChangerDeMap",
				"variable": false,
				"numeroNouvelleMap": 593,
				"xDebutHeros": 10,
				"yDebutHeros": 13
			}
			],
			"vitesse": "moderee",
			"frequence": "basse",
			"animeEnMouvement": true,
			"animeALArret": false,
			"directionFixe": false,
			"traversable": false,
			"auDessusDeTout": false
		}
		]
	}
	]
}
