{
	"nom": "Station AGV (Marche)",
	"tileset": "Ventre",
	"largeur": 21,
	"hauteur": 15,
	"musique": {
		"nomFichierSonore": "Rue Marchande.ogg",
		"volume": 1.00,
		"tempo": 1.00
	},
	"fondSonore": {
		"nomFichierSonore": "019-People01.ogg",
		"volume": 0.60,
		"tempo": 1.00
	},
	"couche0": [
	[0809,0809,0809,0809,0809,0809,0809,0809,0809,0809,0809,0809,0809,0809,0809,0809,0809,0809,0809,0809,0809],
	[0809,0809,0809,0809,0809,0800,0801,0801,0801,0801,0801,0801,0801,0801,0801,0801,0801,0802,0809,0809,0809],
	[0809,0809,0809,0809,0809,0808,0016,0011,0011,0011,0011,0011,0011,0011,0011,0011,0022,0810,0809,0809,0809],
	[0809,0809,0809,0809,0809,0808,-003,-003,-003,-003,-003,-003,-003,-003,-003,-003,-003,0810,0809,0809,0809],
	[0809,0809,0809,0809,0809,0808,0048,0059,0059,0059,0049,0000,0053,0059,0059,0059,0054,0810,0809,0809,0809],
	[0809,0809,0809,0800,0801,0017,0016,0011,0011,0011,0017,0000,0021,0011,0011,0011,0022,0810,0809,0809,0809],
	[0801,0801,0801,0017,0016,0011,0017,0000,0000,0000,-007,-007,-007,0005,0052,0008,0038,0810,0809,0809,0809],
	[0011,0011,0011,0011,0017,0000,0000,0000,0000,0000,-007,-007,-007,0000,0000,0000,0038,0810,0809,0809,0809],
	[-007,-007,-007,-007,-007,-007,-007,-007,-007,-007,-007,-007,-007,0000,0000,0000,0038,0810,0809,0809,0809],
	[-007,-007,-007,-007,-007,-007,-007,-007,-007,-007,-007,-007,-007,0008,0000,0000,0038,0810,0809,0809,0809],
	[0059,0060,0060,0060,0060,0060,0060,0060,0060,0060,0060,0060,0060,0060,0060,0060,0054,0810,0809,0809,0809],
	[0817,0817,0817,0817,0817,0817,0817,0817,0817,0817,0817,0817,0817,0817,0817,0817,0817,0818,0809,0809,0809],
	[0809,0809,0809,0809,0809,0809,0809,0809,0809,0809,0809,0809,0809,0809,0809,0809,0809,0809,0809,0809,0809],
	[0809,0809,0809,0809,0809,0809,0809,0809,0809,0809,0809,0809,0809,0809,0809,0809,0809,0809,0809,0809,0809],
	[0809,0809,0809,0809,0809,0809,0809,0809,0809,0809,0809,0809,0809,0809,0809,0809,0809,0809,0809,0809,0809]
	],
	"couche1": [
	[-001,-001,-001,-001,-001,-001,-001,-001,-001,-001,-001,-001,-001,-001,-001,-001,-001,-001,-001,-001,-001],
	[-001,-001,-001,-001,-001,-001,-001,-001,-001,-001,-001,-001,-001,-001,-001,-001,-001,-001,-001,-001,-001],
	[-001,-001,-001,-001,-001,-001,-001,-001,-001,-001,-001,-001,-001,-001,-001,-001,-001,-001,-001,-001,-001],
	[-001,-001,-001,-001,-001,-001,0033,-001,-001,-001,-001,-001,-001,-001,-001,-001,0045,-001,-001,-001,-001],
	[-001,-001,-001,-001,-001,-001,-001,-001,-001,-001,-001,-001,-001,-001,-001,-001,-001,-001,-001,-001,-001],
	[-001,-001,-001,-001,-001,-001,-001,-001,-001,-001,-001,-001,-001,-001,0044,-001,-001,-001,-001,-001,-001],
	[-001,-001,-001,-001,-001,-001,-001,0925,0926,0927,-001,-001,-001,-001,-001,-001,-001,-001,-001,-001,-001],
	[-001,-001,-001,-001,-001,-001,-001,0933,0932,0935,-001,-001,-001,-001,-001,-001,-001,-001,-001,-001,-001],
	[-001,-001,-001,-001,-001,-001,-001,-001,-001,-001,-001,-001,-001,-001,-001,-001,-001,-001,-001,-001,-001],
	[-001,-001,-001,-001,-001,-001,-001,-001,-001,-001,-001,-001,-001,-001,-001,-001,-001,-001,-001,-001,-001],
	[-001,-001,-001,-001,-001,-001,-001,-001,-001,-001,-001,-001,-001,-001,-001,-001,-001,-001,-001,-001,-001],
	[-001,-001,-001,-001,-001,-001,-001,-001,-001,-001,-001,-001,-001,-001,-001,-001,-001,-001,-001,-001,-001],
	[-001,-001,-001,-001,-001,-001,-001,-001,-001,-001,-001,-001,-001,-001,-001,-001,-001,-001,-001,-001,-001],
	[-001,-001,-001,-001,-001,-001,-001,-001,-001,-001,-001,-001,-001,-001,-001,-001,-001,-001,-001,-001,-001],
	[-001,-001,-001,-001,-001,-001,-001,-001,-001,-001,-001,-001,-001,-001,-001,-001,-001,-001,-001,-001,-001]
	],
	"couche2": [
	[-001,-001,-001,-001,-001,-001,-001,-001,-001,-001,-001,-001,-001,-001,-001,-001,-001,-001,-001,-001,-001],
	[-001,-001,-001,-001,-001,-001,-001,-001,-001,-001,-001,-001,-001,-001,-001,-001,-001,-001,-001,-001,-001],
	[-001,-001,-001,-001,-001,-001,-001,-001,-001,-001,-001,-001,-001,-001,-001,-001,-001,-001,-001,-001,-001],
	[-001,-001,-001,-001,-001,-001,-001,0832,0833,0834,-001,-001,-001,-001,-001,-001,-001,-001,-001,-001,-001],
	[-001,-001,-001,-001,-001,-001,0859,0840,0841,0842,0860,-001,-001,-001,-001,-001,-001,-001,-001,-001,-001],
	[-001,-001,-001,-001,-001,-001,0859,0848,0849,0850,0860,-001,-001,-001,-001,-001,-001,-001,-001,-001,-001],
	[-001,-001,-001,-001,-001,-001,-001,0856,0857,0858,-001,-001,-001,-001,-001,-001,-001,-001,-001,-001,-001],
	[-001,-001,-001,-001,-001,-001,-001,-001,0934,-001,-001,-001,-001,-001,-001,-001,-001,-001,-001,-001,-001],
	[-001,-001,-001,-001,-001,-001,-001,-001,-001,-001,-001,-001,-001,-001,-001,-001,-001,-001,-001,-001,-001],
	[-001,-001,-001,-001,-001,-001,-001,-001,-001,-001,-001,-001,-001,-001,-001,-001,-001,-001,-001,-001,-001],
	[-001,-001,-001,-001,-001,-001,-001,-001,-001,-001,-001,-001,-001,-001,-001,-001,-001,-001,-001,-001,-001],
	[-001,-001,-001,-001,-001,-001,-001,-001,-001,-001,-001,-001,-001,-001,-001,-001,-001,-001,-001,-001,-001],
	[-001,-001,-001,-001,-001,-001,-001,-001,-001,-001,-001,-001,-001,-001,-001,-001,-001,-001,-001,-001,-001],
	[-001,-001,-001,-001,-001,-001,-001,-001,-001,-001,-001,-001,-001,-001,-001,-001,-001,-001,-001,-001,-001],
	[-001,-001,-001,-001,-001,-001,-001,-001,-001,-001,-001,-001,-001,-001,-001,-001,-001,-001,-001,-001,-001]
	],
	"events": [
	{
		"id": 5,
		"nom": "station AGV connue",
		"x": 12,
		"y": 1,
		"pages": [
		{
			"conditions": [
			],
			"commandes": [
			{
				"nom": "ModifierInterrupteur",
				"numeroInterrupteur": 77,
				"valeur": true
			},
			{
				"nom": "ModifierVariable",
				"numeroVariable": 127,
				"operationAFaire": "rendre egal a",
				"valeurADonner": 10,
				"operationAFaire2": "valeur brute"
			},
			{
				"nom": "SupprimerEvent"
			}
			],
			"vitesse": "moderee",
			"frequence": "basse",
			"animeEnMouvement": true,
			"animeALArret": false,
			"directionFixe": false,
			"traversable": false,
			"auDessusDeTout": false
		}
		]
	},
	{
		"id": 11,
		"nom": "Enseigne",
		"x": 6,
		"y": 7,
		"pages": [
		{
			"conditions": [
			{
				"nom": "Parler"
			}
			],
			"commandes": [
			],
			"image": "enseignes character",
			"directionInitiale": 2,
			"animationInitiale": 1,
			"vitesse": "moderee",
			"frequence": "basse",
			"animeEnMouvement": false,
			"animeALArret": false,
			"directionFixe": true,
			"traversable": true,
			"auDessusDeTout": true
		}
		]
	},
	{
		"id": 6,
		"nom": "Clone[582][5]",
		"x": 8,
		"y": 7
	},
	{
		"id": 1,
		"nom": "Clone[341][001]",
		"x": 10,
		"y": 6
	},
	{
		"id": 12,
		"nom": "Pancarte",
		"x": 13,
		"y": 6,
		"pages": [
		{
			"conditions": [
			{
				"nom": "Parler"
			}
			],
			"commandes": [
			{
				"nom": "ConditionDirection",
				"idEventConcerne": 0,
				"direction": 3,
				"numero": 0
			},
			{
				"nom": "ModifierInterrupteur",
				"numeroInterrupteur": 12,
				"valeur": true
			},
			{
				"nom": "Message",
				"texte": "Station AGV"
			},
			{
				"nom": "Message",
				"texte": "(Artère à Grande Vitesse)"
			},
			{
				"nom": "Message",
				"texte": "Oblitérez votre ticket et faites vous propulser \\ndans le réseau Kujirien."
			},
			{
				"nom": "Attendre",
				"nombreDeFrames": 8
			},
			{
				"nom": "ConditionFin",
				"numero": 0
			},
			{
				"nom": "ModifierInterrupteur",
				"numeroInterrupteur": 12,
				"valeur": false
			}
			],
			"vitesse": "moderee",
			"frequence": "basse",
			"animeEnMouvement": false,
			"animeALArret": false,
			"directionFixe": false,
			"traversable": false,
			"auDessusDeTout": false
		}
		]
	},
	{
		"id": 7,
		"nom": "Clone[341][007]",
		"x": 5,
		"y": 7
	},
	{
		"id": 2,
		"nom": "EV002",
		"x": 0,
		"y": 8,
		"pages": [
		{
			"conditions": [
			{
				"nom": "ArriveeAuContact"
			}
			],
			"commandes": [
			{
				"nom": "ChangerDeMap",
				"variable": false,
				"numeroNouvelleMap": 188,
				"xDebutHeros": 34,
				"yDebutHeros": 8
			}
			],
			"vitesse": "moderee",
			"frequence": "basse",
			"animeEnMouvement": true,
			"animeALArret": false,
			"directionFixe": false,
			"traversable": false,
			"auDessusDeTout": false
		}
		]
	},
	{
		"id": 8,
		"nom": "EV008",
		"x": 0,
		"y": 9,
		"pages": [
		{
			"conditions": [
			{
				"nom": "ArriveeAuContact"
			}
			],
			"commandes": [
			{
				"nom": "ChangerDeMap",
				"variable": false,
				"numeroNouvelleMap": 188,
				"xDebutHeros": 34,
				"yDebutHeros": 9
			}
			],
			"vitesse": "moderee",
			"frequence": "basse",
			"animeEnMouvement": true,
			"animeALArret": false,
			"directionFixe": false,
			"traversable": false,
			"auDessusDeTout": false
		}
		]
	},
	{
		"id": 3,
		"nom": "Clone[582][8]",
		"x": 11,
		"y": 3
	},
	{
		"id": 9,
		"nom": "Clone[582][6]",
		"x": 11,
		"y": 5
	},
	{
		"id": 4,
		"nom": "Clone[16][18]",
		"x": 9,
		"y": 3
	},
	{
		"id": 10,
		"nom": "nom station",
		"x": 11,
		"y": 1,
		"pages": [
		{
			"conditions": [
			{
				"nom": "Parler"
			}
			],
			"commandes": [
			],
			"image": "metro nom character",
			"directionInitiale": 2,
			"vitesse": "moderee",
			"frequence": "basse",
			"animeEnMouvement": false,
			"animeALArret": false,
			"directionFixe": true,
			"traversable": false,
			"auDessusDeTout": false
		}
		]
	}
	]
}
