{
	"nom": "Station AGV (marais)",
	"tileset": "Marais",
	"largeur": 21,
	"hauteur": 26,
	"musique": {
		"nomFichierSonore": "Marais.mp3",
		"volume": 1.00,
		"tempo": 1.00
	},
	"fondSonore": {
		"nomFichierSonore": "006-Rain02.ogg",
		"volume": 0.80,
		"tempo": 1.00
	},
	"couche0": [
	[0809,0809,0809,0809,0809,0809,0809,0890,0890,0885,0885,0888,0888,0809,0809,0809,0809,0809,0809,0809,0809],
	[0809,0809,0809,0809,0809,0809,0809,0890,0890,0885,0885,0888,0888,0809,0809,0809,0809,0809,0809,0809,0809],
	[0809,0809,0809,0891,0897,0897,0897,0898,0890,0885,0885,0888,0896,0897,0909,0897,0897,0892,0809,0809,0809],
	[0809,0809,0809,0890,0891,0897,0897,0897,0898,0885,0885,0896,0897,0897,0917,0897,0892,0888,0809,0809,0809],
	[0809,0809,0809,0890,0890,-008,-008,-008,0885,0885,0885,0885,0885,0885,0885,0885,0888,0895,0809,0809,0809],
	[0809,0809,0809,0890,0890,-008,-008,-008,0885,0885,0885,0885,0885,0885,0885,0885,0888,0888,0809,0809,0809],
	[0809,0809,0809,0890,0903,-008,-008,-008,-008,-008,-008,-008,-008,-008,0885,0885,0895,0888,0809,0809,0809],
	[0809,0809,0809,0890,0890,-008,-008,-008,-008,-008,-008,-008,-008,-008,0885,0885,0888,0888,0809,0809,0809],
	[0809,0809,0809,0903,0890,-008,-008,-008,-008,-008,-008,-008,-008,-008,0885,0885,0888,0888,0809,0809,0809],
	[0809,0809,0809,0890,0899,0881,0059,0059,0059,0059,0059,0059,0059,0059,0881,0881,0900,0888,0809,0809,0809],
	[0809,0809,0809,0899,0882,0016,0011,0011,0011,0011,0011,0011,0011,0022,0889,0889,0889,0888,0809,0809,0809],
	[0809,0809,0809,0809,0890,-003,-003,-003,-003,-003,-003,-003,-003,-003,0889,0889,0889,0888,0809,0809,0809],
	[0809,0809,0809,0891,0898,0048,0059,0059,0049,0001,0053,0059,0059,0054,0889,0889,0889,0888,0809,0809,0809],
	[0809,0809,0809,0890,0016,0011,0011,0011,0017,0001,0021,0011,0011,0011,0897,0897,0892,0888,0809,0809,0809],
	[0809,0809,0809,0890,0024,-002,-002,-002,0001,0001,0005,0001,0001,0001,0001,0001,0888,0888,0809,0809,0809],
	[0809,0809,0809,0890,0024,-002,-002,-002,0001,0001,0001,0001,0001,0001,0001,0001,0888,0888,0809,0809,0809],
	[0809,0809,0809,0890,0024,-002,-002,-002,0001,0001,0001,0001,0001,0001,0001,0001,0888,0888,0809,0809,0809],
	[0809,0809,0809,0890,0024,-002,-002,-002,-002,-002,0001,0001,0001,0001,0001,0001,0888,0888,0809,0809,0809],
	[0809,0809,0809,0890,0057,0059,0049,-002,-002,-002,-002,-002,0001,0001,0001,0001,0888,0888,0809,0809,0809],
	[0809,0809,0809,0899,0817,0049,0057,0059,0049,-002,-002,-002,0001,0001,0001,0001,0888,0888,0809,0809,0809],
	[0809,0809,0809,0809,0809,0816,0817,0049,0057,0059,0059,0059,0059,0059,0881,0881,0900,0888,0809,0809,0809],
	[0809,0809,0809,0809,0809,0809,0809,0816,0817,0817,0817,0817,0817,0817,0817,0881,0881,0900,0809,0809,0809],
	[0809,0809,0809,0809,0809,0809,0809,0809,0809,0809,0809,0809,0809,0809,0809,0809,0809,0809,0809,0809,0809],
	[0809,0809,0809,0809,0809,0809,0809,0809,0809,0809,0809,0809,0809,0809,0809,0809,0809,0809,0809,0809,0809],
	[0809,0809,0809,0809,0809,0809,0809,0809,0809,0809,0809,0809,0809,0809,0809,0809,0809,0809,0809,0809,0809],
	[0809,0809,0809,0809,0809,0809,0809,0809,0809,0809,0809,0809,0809,0809,0809,0809,0809,0809,0809,0809,0809]
	],
	"couche1": [
	[-001,-001,-001,-001,-001,-001,-001,-001,-001,-001,-001,-001,-001,-001,-001,-001,-001,-001,-001,-001,-001],
	[-001,-001,-001,-001,-001,-001,-001,-001,-001,-001,-001,-001,-001,-001,-001,-001,-001,-001,-001,-001,-001],
	[-001,-001,-001,-001,-001,-001,-001,-001,-001,-001,-001,-001,-001,-001,-001,-001,-001,-001,-001,-001,-001],
	[-001,-001,-001,-001,-001,0188,-001,-001,-001,-001,-001,-001,-001,-001,-001,-001,-001,-001,-001,-001,-001],
	[-001,-001,-001,-001,-001,0196,0180,-001,-001,-001,-001,-001,-001,-001,-001,-001,-001,-001,-001,-001,-001],
	[-001,-001,-001,-001,-001,-001,0300,0305,0306,0307,0317,0318,0319,-001,-001,-001,-001,-001,-001,-001,-001],
	[-001,-001,-001,-001,-001,-001,0312,0313,0314,0315,0325,0326,0327,-001,-001,-001,-001,-001,-001,-001,-001],
	[-001,-001,-001,-001,-001,-001,0320,0321,0322,0323,0308,0334,0300,-001,-001,-001,-001,-001,-001,-001,-001],
	[-001,-001,-001,-001,-001,-001,0328,0329,0330,0331,-001,-001,-001,-001,-001,-001,-001,-001,-001,-001,-001],
	[-001,-001,-001,-001,-001,-001,0910,-001,-001,-001,-001,-001,-001,0883,-001,-004,-001,-001,-001,-001,-001],
	[-001,-001,-001,-001,-001,-001,-001,-001,-001,-001,-001,-001,-001,-001,-001,-001,0156,-001,-001,-001,-001],
	[-001,-001,-001,-001,-001,0033,-001,-001,-001,-001,-001,-001,-001,0045,0156,-001,-001,-001,-001,-001,-001],
	[-001,-001,-001,-001,-001,-001,-001,-001,-001,-001,-001,-001,-001,-001,-001,-001,-001,-001,-001,-001,-001],
	[-001,-001,-001,-001,-001,-001,0188,-001,-001,-001,-001,-001,-001,-001,-001,-005,-001,-001,-001,-001,-001],
	[-001,-001,-001,-001,-001,-001,0196,-001,-001,-001,-001,0925,0926,0927,-001,-001,-001,-001,-001,-001,-001],
	[-001,-001,-001,-001,-001,-001,-001,-001,-001,-001,-001,0933,0932,0935,-001,-001,-001,-001,-001,-001,-001],
	[-001,-001,-001,-001,-001,-001,0308,-001,-001,-001,-001,-001,-001,-001,-001,-001,-001,-001,-001,-001,-001],
	[-001,-001,-001,-001,-001,-001,-001,0180,-001,-001,-001,-001,-001,-001,-001,-001,-001,-001,-001,-001,-001],
	[-001,-001,-001,-001,-001,-001,-001,-001,-001,-001,0300,-001,-001,-001,-001,-001,-001,-001,-001,-001,-001],
	[-001,-001,-001,-001,0910,-001,-001,-001,-001,-001,-001,-001,-001,-001,-001,-001,-001,-001,-001,-001,-001],
	[-001,-001,-001,-001,-001,-001,-001,-001,-001,-001,-001,-001,-001,0883,-001,-001,-001,-001,-001,-001,-001],
	[-001,-001,-001,-001,-001,-001,-001,-001,-001,-001,-001,-001,-001,-001,0883,-001,-001,-001,-001,-001,-001],
	[-001,-001,-001,-001,-001,-001,-001,-001,-001,-001,-001,-001,-001,-001,-001,-001,-001,-001,-001,-001,-001],
	[-001,-001,-001,-001,-001,-001,-001,-001,-001,-001,-001,-001,-001,-001,-001,-001,-001,-001,-001,-001,-001],
	[-001,-001,-001,-001,-001,-001,-001,-001,-001,-001,-001,-001,-001,-001,-001,-001,-001,-001,-001,-001,-001],
	[-001,-001,-001,-001,-001,-001,-001,-001,-001,-001,-001,-001,-001,-001,-001,-001,-001,-001,-001,-001,-001]
	],
	"couche2": [
	[-001,-001,-001,-001,-001,-001,-001,-001,-001,-001,-001,-001,-001,-001,-001,-001,-001,-001,-001,-001,-001],
	[-001,-001,-001,-001,-001,-001,-001,-001,-001,-001,-001,-001,-001,-001,-001,-001,-001,-001,-001,-001,-001],
	[-001,-001,-001,-001,-001,-001,-001,-001,-001,-001,-001,-001,-001,-001,-001,-001,-001,-001,-001,-001,-001],
	[-001,-001,-001,-001,-001,-001,-001,-001,-001,-001,-001,-001,-001,-001,-001,-001,-001,-001,-001,-001,-001],
	[-001,-001,-001,-001,-001,-001,-001,-001,-001,-001,-001,-001,-001,-001,-001,-001,-001,-001,-001,-001,-001],
	[-001,-001,-001,-001,-001,-001,-001,-001,-001,-001,-001,-001,-001,-001,-001,-001,-001,-001,-001,-001,-001],
	[-001,-001,-001,-001,-001,-001,-001,-001,-001,-001,-001,-001,-001,-001,-001,-001,-001,-001,-001,-001,-001],
	[-001,-001,-001,-001,-001,-001,-001,-001,-001,-001,-001,-001,-001,-001,-001,-001,-001,-001,-001,-001,-001],
	[-001,-001,-001,-001,-001,-001,-001,-001,-001,-001,-001,-001,-001,-001,-001,-001,-001,-001,-001,-001,-001],
	[-001,-001,-001,-001,-001,-001,-001,-001,-001,-001,-001,-001,-001,-001,-001,-001,-001,-001,-001,-001,-001],
	[-001,-001,-001,-001,-001,-001,-001,-001,-001,-001,-001,-001,-001,-001,-001,-001,-001,-001,-001,-001,-001],
	[-001,-001,-001,-001,-001,-001,-001,-001,-001,-001,-001,0832,0833,0834,-001,-001,-001,-001,-001,-001,-001],
	[-001,-001,-001,-001,-001,-001,-001,-001,-001,-001,0859,0840,0841,0842,0860,-001,-001,-001,-001,-001,-001],
	[-001,-001,-001,-001,-001,-001,-001,-001,-001,-001,0859,0848,0849,0850,0860,-001,-001,-001,-001,-001,-001],
	[-001,-001,-001,-001,-001,-001,-001,-001,-001,-001,-001,0856,0857,0858,-001,-001,-001,-001,-001,-001,-001],
	[-001,-001,-001,-001,-001,-001,-001,-001,-001,-001,-001,-001,0934,-001,-001,-001,-001,-001,-001,-001,-001],
	[-001,-001,-001,-001,-001,-001,-001,-001,-001,-001,-001,-001,-001,-001,-001,-001,-001,-001,-001,-001,-001],
	[-001,-001,-001,-001,-001,-001,-001,-001,-001,-001,-001,-001,-001,-001,-001,-001,-001,-001,-001,-001,-001],
	[-001,-001,-001,-001,-001,-001,-001,-001,-001,-001,-001,-001,-001,-001,-001,-001,-001,-001,-001,-001,-001],
	[-001,-001,-001,-001,-001,-001,-001,-001,-001,-001,-001,-001,-001,-001,-001,-001,-001,-001,-001,-001,-001],
	[-001,-001,-001,-001,-001,-001,-001,-001,-001,-001,-001,-001,-001,-001,-001,-001,-001,-001,-001,-001,-001],
	[-001,-001,-001,-001,-001,-001,-001,-001,-001,-001,-001,-001,-001,-001,-001,-001,-001,-001,-001,-001,-001],
	[-001,-001,-001,-001,-001,-001,-001,-001,-001,-001,-001,-001,-001,-001,-001,-001,-001,-001,-001,-001,-001],
	[-001,-001,-001,-001,-001,-001,-001,-001,-001,-001,-001,-001,-001,-001,-001,-001,-001,-001,-001,-001,-001],
	[-001,-001,-001,-001,-001,-001,-001,-001,-001,-001,-001,-001,-001,-001,-001,-001,-001,-001,-001,-001,-001],
	[-001,-001,-001,-001,-001,-001,-001,-001,-001,-001,-001,-001,-001,-001,-001,-001,-001,-001,-001,-001,-001]
	],
	"events": [
	{
		"id": 5,
		"nom": "Pancarte",
		"x": 10,
		"y": 14,
		"pages": [
		{
			"conditions": [
			{
				"nom": "Parler"
			}
			],
			"commandes": [
			{
				"nom": "ConditionDirection",
				"idEventConcerne": 0,
				"direction": 3,
				"numero": 0
			},
			{
				"nom": "ModifierInterrupteur",
				"numeroInterrupteur": 12,
				"valeur": true
			},
			{
				"nom": "Message",
				"texte": "Station AGV"
			},
			{
				"nom": "Message",
				"texte": "(Artère à Grande Vitesse)"
			},
			{
				"nom": "Message",
				"texte": "Oblitérez votre ticket et faites vous propulser \\ndans le réseau Kujirien."
			},
			{
				"nom": "Attendre",
				"nombreDeFrames": 8
			},
			{
				"nom": "ConditionFin",
				"numero": 0
			},
			{
				"nom": "ModifierInterrupteur",
				"numeroInterrupteur": 12,
				"valeur": false
			}
			],
			"vitesse": "moderee",
			"frequence": "basse",
			"animeEnMouvement": false,
			"animeALArret": false,
			"directionFixe": false,
			"traversable": false,
			"auDessusDeTout": false
		}
		]
	},
	{
		"id": 11,
		"nom": "Clone[341][028]",
		"x": 13,
		"y": 6
	},
	{
		"id": 6,
		"nom": "Clone[341][007]",
		"x": 15,
		"y": 17
	},
	{
		"id": 12,
		"nom": "Clone[341][028]",
		"x": 7,
		"y": 4
	},
	{
		"id": 1,
		"nom": "Clone[582][8]",
		"x": 9,
		"y": 11
	},
	{
		"id": 7,
		"nom": "brouillard de forêt",
		"x": 12,
		"y": 2,
		"pages": [
		{
			"conditions": [
			],
			"commandes": [
			{
				"nom": "ModifierMeteo",
				"type": "pluie",
				"intensite": 2
			},
			{
				"nom": "EffacerImage",
				"numero": 3
			},
			{
				"nom": "ModifierBrouillard",
				"opacite": 25,
				"modeDeFusion": "normal",
				"defilementX": -20,
				"defilementY": 105,
				"zoom": 200,
				"nuance": 0,
				"nomImage": "essai pluie brouillard"
			},
			{
				"nom": "ModifierTonDeLEcran",
				"rouge": 115,
				"vert": 140,
				"bleu": 127,
				"gris": 0,
				"dureeTransition": 0
			},
			{
				"nom": "SupprimerEvent"
			}
			],
			"vitesse": "moderee",
			"frequence": "basse",
			"animeEnMouvement": true,
			"animeALArret": false,
			"directionFixe": false,
			"traversable": false,
			"auDessusDeTout": false
		}
		]
	},
	{
		"id": 13,
		"nom": "Clone[341][061]",
		"x": 8,
		"y": 4
	},
	{
		"id": 2,
		"nom": "station AGV connue",
		"x": 10,
		"y": 10,
		"pages": [
		{
			"conditions": [
			],
			"commandes": [
			{
				"nom": "ModifierInterrupteur",
				"numeroInterrupteur": 74,
				"valeur": true
			},
			{
				"nom": "SupprimerEvent"
			}
			],
			"vitesse": "moderee",
			"frequence": "basse",
			"animeEnMouvement": true,
			"animeALArret": false,
			"directionFixe": false,
			"traversable": false,
			"auDessusDeTout": false
		}
		]
	},
	{
		"id": 8,
		"nom": "EV008",
		"x": 9,
		"y": 0,
		"pages": [
		{
			"conditions": [
			{
				"nom": "ArriveeAuContact"
			}
			],
			"commandes": [
			{
				"nom": "ChangerDeMap",
				"variable": false,
				"numeroNouvelleMap": 135,
				"xDebutHeros": 19,
				"yDebutHeros": 30
			}
			],
			"vitesse": "moderee",
			"frequence": "basse",
			"animeEnMouvement": true,
			"animeALArret": false,
			"directionFixe": false,
			"traversable": false,
			"auDessusDeTout": false
		}
		]
	},
	{
		"id": 14,
		"nom": "Clone[341][061]",
		"x": 14,
		"y": 14
	},
	{
		"id": 3,
		"nom": "Clone[16][18]",
		"x": 7,
		"y": 11
	},
	{
		"id": 9,
		"nom": "EV009",
		"x": 10,
		"y": 0,
		"pages": [
		{
			"conditions": [
			{
				"nom": "ArriveeAuContact"
			}
			],
			"commandes": [
			{
				"nom": "ChangerDeMap",
				"variable": false,
				"numeroNouvelleMap": 135,
				"xDebutHeros": 20,
				"yDebutHeros": 30
			}
			],
			"vitesse": "moderee",
			"frequence": "basse",
			"animeEnMouvement": true,
			"animeALArret": false,
			"directionFixe": false,
			"traversable": false,
			"auDessusDeTout": false
		}
		]
	},
	{
		"id": 4,
		"nom": "Clone[582][5]",
		"x": 12,
		"y": 15
	},
	{
		"id": 15,
		"nom": "Clone[582][6]",
		"x": 9,
		"y": 13
	},
	{
		"id": 10,
		"nom": "Clone[341][028]",
		"x": 5,
		"y": 14
	}
	]
}
