{
	"nom": "Station AGV (Moldo)",
	"tileset": "Ventre",
	"largeur": 21,
	"hauteur": 19,
	"musique": {
		"nomFichierSonore": "Nouveaux Chemins.ogg",
		"volume": 1.00,
		"tempo": 1.00
	},
	"fondSonore": {
		"nomFichierSonore": "012-Waterfall02.ogg",
		"volume": 0.50,
		"tempo": 1.00
	},
	"couche0": [
	[0809,0809,0809,0809,0809,0809,0809,0809,0809,0809,0809,0809,0809,0809,0809,0809,0809,0809,0809,0809,0809],
	[0809,0809,0809,0809,0809,0809,0809,0809,0809,0809,0809,0809,0809,0809,0809,0809,0809,0809,0809,0809,0809],
	[0800,0801,0801,0801,0801,0801,0802,0809,0809,0809,0809,0809,0809,0809,0809,0809,0809,0809,0809,0809,0809],
	[0808,0009,0010,0010,0010,0022,0810,0809,0809,0809,0809,0809,0809,0809,0809,0809,0809,0809,0809,0809,0809],
	[0808,0024,0000,0000,0000,0030,0810,0809,0809,0809,0809,0809,0809,0809,0809,0809,0809,0809,0809,0809,0809],
	[0808,0024,0000,0000,0000,0030,0810,0809,0800,0801,0801,0801,0801,0801,0801,0801,0801,0801,0801,0801,0802],
	[0808,0024,0000,0000,0000,0030,0193,0801,0194,0009,0010,0010,0010,0010,0010,0010,0010,0010,0010,0022,0810],
	[0808,0024,0000,0000,0000,0021,0010,0013,0000,0024,0016,0011,0011,0011,0011,0011,0011,0011,0022,0030,0810],
	[0194,0024,0000,0000,0000,0000,0000,0021,0010,0017,-003,-003,-003,-003,-003,-003,-003,-003,-003,0030,0193],
	[0010,0017,0008,0000,0000,0000,0000,0016,0011,0022,0048,0059,0059,0049,0000,0053,0059,0059,0054,0021,0011],
	[0011,0011,0011,0011,0011,0011,0011,0017,0005,0021,0011,0011,0011,0017,0000,0021,0011,0011,0011,0011,0011],
	[0000,0000,0000,0000,0000,0000,0000,0000,0000,0000,0000,0000,0000,0000,0000,0000,0000,0000,0000,0000,0000],
	[0059,0059,0059,0059,0059,0059,0059,0059,0059,0059,0059,0059,0059,0059,0059,0059,0059,0059,0059,0059,0059],
	[0059,0059,0059,0059,0059,0059,0059,0059,0059,0059,0059,0059,0059,0059,0059,0059,0059,0059,0059,0059,0059],
	[0817,0817,0817,0817,0817,0817,0817,0817,0817,0817,0817,0817,0817,0817,0817,0817,0817,0817,0817,0817,0817],
	[0809,0809,0809,0809,0809,0809,0809,0809,0809,0809,0809,0809,0809,0809,0809,0809,0809,0809,0809,0809,0809],
	[0809,0809,0809,0809,0809,0809,0809,0809,0809,0809,0809,0809,0809,0809,0809,0809,0809,0809,0809,0809,0809],
	[0809,0809,0809,0809,0809,0809,0809,0809,0809,0809,0809,0809,0809,0809,0809,0809,0809,0809,0809,0809,0809],
	[0809,0809,0809,0809,0809,0809,0809,0809,0809,0809,0809,0809,0809,0809,0809,0809,0809,0809,0809,0809,0809]
	],
	"couche1": [
	[-001,-001,-001,-001,-001,-001,-001,-001,-001,-001,-001,-001,-001,-001,-001,-001,-001,-001,-001,-001,-001],
	[-001,-001,-001,-001,-001,-001,-001,-001,-001,-001,-001,-001,-001,-001,-001,-001,-001,-001,-001,-001,-001],
	[-001,-001,-001,-001,-001,-001,-001,-001,-001,-001,-001,-001,-001,-001,-001,-001,-001,-001,-001,-001,-001],
	[-001,-001,-001,-001,-001,-001,-001,-001,-001,-001,-001,-001,-001,-001,-001,-001,-001,-001,-001,-001,-001],
	[-001,-001,-001,-001,-001,-001,-001,-001,-001,-001,-001,-001,-001,-001,-001,-001,-001,-001,-001,-001,-001],
	[-001,-001,0925,0926,0927,-001,-001,-001,-001,-001,-001,-001,-001,-001,-001,-001,-001,-001,-001,-001,-001],
	[-001,-001,0933,0932,0935,-001,-001,-001,-001,-001,-001,-001,-001,-001,-001,-001,-001,-001,-001,-001,-001],
	[-001,-001,-001,-001,-001,0070,0071,-001,-001,-001,-001,-001,-001,-001,-001,-001,-001,-001,-001,-001,-001],
	[-001,-001,-001,-001,-001,0078,0079,-001,-001,-001,0033,-001,-001,-001,-001,-001,-001,-001,0045,-001,-001],
	[-001,-001,-001,-001,-001,0086,0087,-001,-001,-001,-001,-001,-001,-001,-001,-001,-001,-001,-001,-001,-001],
	[-001,-001,-001,-005,-001,-001,-001,-001,-001,-001,-001,-001,-001,-001,-001,-001,-001,-001,-001,-001,-001],
	[-001,-001,-001,-001,-001,-001,-001,-001,-001,-001,-001,-001,-001,-001,-001,-001,-001,-001,-001,-001,-001],
	[-001,-001,-001,-001,-001,-001,-001,-001,-001,-001,-001,-001,-001,-001,-001,-001,-001,-001,-001,-001,-001],
	[-001,-001,-001,-001,-001,-001,-001,-001,-001,-001,-001,-001,-001,-001,-001,-001,-001,-001,-001,-001,-001],
	[-001,-001,-001,-001,-001,-001,-001,-001,-001,-001,-001,-001,-001,-001,-001,-001,-001,-001,-001,-001,-001],
	[-001,-001,-001,-001,-001,-001,-001,-001,-001,-001,-001,-001,-001,-001,-001,-001,-001,-001,-001,-001,-001],
	[-001,-001,-001,-001,-001,-001,-001,-001,-001,-001,-001,-001,-001,-001,-001,-001,-001,-001,-001,-001,-001],
	[-001,-001,-001,-001,-001,-001,-001,-001,-001,-001,-001,-001,-001,-001,-001,-001,-001,-001,-001,-001,-001],
	[-001,-001,-001,-001,-001,-001,-001,-001,-001,-001,-001,-001,-001,-001,-001,-001,-001,-001,-001,-001,-001]
	],
	"couche2": [
	[-001,-001,-001,-001,-001,-001,-001,-001,-001,-001,-001,-001,-001,-001,-001,-001,-001,-001,-001,-001,-001],
	[-001,-001,-001,-001,-001,-001,-001,-001,-001,-001,-001,-001,-001,-001,-001,-001,-001,-001,-001,-001,-001],
	[-001,-001,0832,0833,0834,-001,-001,-001,-001,-001,-001,-001,-001,-001,-001,-001,-001,-001,-001,-001,-001],
	[-001,0859,0840,0841,0842,0860,-001,-001,-001,-001,-001,-001,-001,-001,-001,-001,-001,-001,-001,-001,-001],
	[-001,0859,0848,0849,0850,0860,-001,-001,-001,-001,-001,-001,-001,-001,-001,-001,-001,-001,-001,-001,-001],
	[-001,-001,0856,0857,0858,-001,-001,-001,-001,-001,-001,-001,-001,-001,-001,-001,-001,-001,-001,-001,-001],
	[-001,-001,-001,0934,-001,-001,-001,-001,-001,-001,-001,-001,-001,-001,-001,-001,-001,-001,-001,-001,-001],
	[-001,-001,-001,-001,-001,-001,-001,-001,-001,-001,-001,-001,-001,-001,-001,-001,-001,-001,-001,-001,-001],
	[-001,-001,-001,-001,-001,-001,-001,-001,-001,-001,-001,-001,-001,-001,-001,-001,-001,-001,-001,-001,-001],
	[-001,-001,-001,-001,-001,-001,-001,-001,-001,-001,-001,-001,-001,-001,-001,-001,-001,-001,-001,-001,-001],
	[-001,-001,-001,-001,-001,-001,-001,-001,-001,-001,-001,-001,-001,-001,-001,-001,-001,-001,-001,-001,-001],
	[-001,-001,-001,-001,-001,-001,-001,-001,-001,-001,-001,-001,-001,-001,-001,-001,-001,-001,-001,-001,-001],
	[-001,-001,-001,-001,-001,-001,-001,-001,-001,-001,-001,-001,-001,-001,-001,-001,-001,-001,-001,-001,-001],
	[-001,-001,-001,-001,-001,-001,-001,-001,-001,-001,-001,-001,-001,-001,-001,-001,-001,-001,-001,-001,-001],
	[-001,-001,-001,-001,-001,-001,-001,-001,-001,-001,-001,-001,-001,-001,-001,-001,-001,-001,-001,-001,-001],
	[-001,-001,-001,-001,-001,-001,-001,-001,-001,-001,-001,-001,-001,-001,-001,-001,-001,-001,-001,-001,-001],
	[-001,-001,-001,-001,-001,-001,-001,-001,-001,-001,-001,-001,-001,-001,-001,-001,-001,-001,-001,-001,-001],
	[-001,-001,-001,-001,-001,-001,-001,-001,-001,-001,-001,-001,-001,-001,-001,-001,-001,-001,-001,-001,-001],
	[-001,-001,-001,-001,-001,-001,-001,-001,-001,-001,-001,-001,-001,-001,-001,-001,-001,-001,-001,-001,-001]
	],
	"events": [
	{
		"id": 5,
		"nom": "Pancarte",
		"x": 8,
		"y": 10,
		"pages": [
		{
			"conditions": [
			{
				"nom": "Parler"
			}
			],
			"commandes": [
			{
				"nom": "ConditionDirection",
				"idEventConcerne": 0,
				"direction": 3,
				"numero": 0
			},
			{
				"nom": "ModifierInterrupteur",
				"numeroInterrupteur": 12,
				"valeur": true
			},
			{
				"nom": "Commentaire",
				"texte": "(en) HSA station \"Moldo river\""
			},
			{
				"nom": "Message",
				"texte": "Station AGV \"fleuve Moldo\""
			},
			{
				"nom": "Commentaire",
				"texte": "(en) (High Speed Artery)"
			},
			{
				"nom": "Message",
				"texte": "(Artère à Grande Vitesse)"
			},
			{
				"nom": "Commentaire",
				"texte": "(en) Obliterate your ticket and get propelled \\ninto the Kujirian network."
			},
			{
				"nom": "Message",
				"texte": "Oblitérez votre ticket et faites vous propulser \\ndans le réseau Kujirien."
			},
			{
				"nom": "Attendre",
				"nombreDeFrames": 8
			},
			{
				"nom": "ConditionFin",
				"numero": 0
			},
			{
				"nom": "ModifierInterrupteur",
				"numeroInterrupteur": 12,
				"valeur": false
			}
			],
			"vitesse": "moderee",
			"frequence": "basse",
			"animeEnMouvement": false,
			"animeALArret": false,
			"directionFixe": false,
			"traversable": false,
			"auDessusDeTout": false
		}
		]
	},
	{
		"id": 11,
		"nom": "nom station",
		"x": 14,
		"y": 6,
		"pages": [
		{
			"conditions": [
			{
				"nom": "Parler"
			}
			],
			"commandes": [
			],
			"image": "metro nom character",
			"directionInitiale": 2,
			"animationInitiale": 2,
			"vitesse": "moderee",
			"frequence": "basse",
			"animeEnMouvement": false,
			"animeALArret": false,
			"directionFixe": true,
			"traversable": false,
			"auDessusDeTout": false
		}
		]
	},
	{
		"id": 6,
		"nom": "Clone[582][6]",
		"x": 14,
		"y": 10
	},
	{
		"id": 1,
		"nom": "EV001",
		"x": 20,
		"y": 11,
		"pages": [
		{
			"conditions": [
			{
				"nom": "ArriveeAuContact"
			}
			],
			"commandes": [
			{
				"nom": "ArreterChronometre"
			},
			{
				"nom": "ModifierVariable",
				"numeroVariable": 81,
				"operationAFaire": "rendre egal a",
				"valeurADonner": 0,
				"operationAFaire2": "valeur brute"
			},
			{
				"nom": "ChangerDeMap",
				"variable": false,
				"numeroNouvelleMap": 612,
				"xDebutHeros": 1,
				"yDebutHeros": 9
			}
			],
			"vitesse": "moderee",
			"frequence": "basse",
			"animeEnMouvement": true,
			"animeALArret": false,
			"directionFixe": false,
			"traversable": false,
			"auDessusDeTout": false
		}
		]
	},
	{
		"id": 12,
		"nom": "Enseigne",
		"x": 5,
		"y": 6,
		"pages": [
		{
			"conditions": [
			{
				"nom": "Parler"
			}
			],
			"commandes": [
			],
			"image": "enseignes character",
			"directionInitiale": 2,
			"animationInitiale": 1,
			"vitesse": "moderee",
			"frequence": "basse",
			"animeEnMouvement": false,
			"animeALArret": false,
			"directionFixe": true,
			"traversable": true,
			"auDessusDeTout": true
		}
		]
	},
	{
		"id": 7,
		"nom": "Clone[16][18]",
		"x": 12,
		"y": 8
	},
	{
		"id": 2,
		"nom": "EV002",
		"x": 0,
		"y": 11,
		"pages": [
		{
			"conditions": [
			{
				"nom": "ArriveeAuContact"
			}
			],
			"commandes": [
			{
				"nom": "ChangerDeMap",
				"variable": false,
				"numeroNouvelleMap": 130,
				"xDebutHeros": 34,
				"yDebutHeros": 25
			}
			],
			"vitesse": "moderee",
			"frequence": "basse",
			"animeEnMouvement": true,
			"animeALArret": false,
			"directionFixe": false,
			"traversable": false,
			"auDessusDeTout": false
		}
		]
	},
	{
		"id": 13,
		"nom": "Clone[341][007]",
		"x": 6,
		"y": 8
	},
	{
		"id": 8,
		"nom": "station AGV connue",
		"x": 15,
		"y": 6,
		"pages": [
		{
			"conditions": [
			],
			"commandes": [
			{
				"nom": "ModifierInterrupteur",
				"numeroInterrupteur": 72,
				"valeur": true
			},
			{
				"nom": "ModifierVariable",
				"numeroVariable": 127,
				"operationAFaire": "rendre egal a",
				"valeurADonner": 4,
				"operationAFaire2": "valeur brute"
			},
			{
				"nom": "SupprimerEvent"
			}
			],
			"vitesse": "moderee",
			"frequence": "basse",
			"animeEnMouvement": true,
			"animeALArret": false,
			"directionFixe": false,
			"traversable": false,
			"auDessusDeTout": false
		}
		]
	},
	{
		"id": 3,
		"nom": "Clone[582][5]",
		"x": 3,
		"y": 6
	},
	{
		"id": 9,
		"nom": "Clone[341][007]",
		"x": 5,
		"y": 8
	},
	{
		"id": 4,
		"nom": "Clone[582][8]",
		"x": 14,
		"y": 8
	}
	]
}
