{
	"nom": "chasseur (interieur)",
	"tileset": "Maison",
	"largeur": 21,
	"hauteur": 15,
	"musique": {
		"nomFichierSonore": "Maison 2.ogg",
		"volume": 1.00,
		"tempo": 1.00
	},
	"fondSonore": {
		"nomFichierSonore": "013-Fire01.ogg",
		"volume": 0.80,
		"tempo": 1.00
	},
	"couche0": [
	[0017,0017,0017,0017,0017,0017,0017,0017,0017,0017,0017,0017,0017,0017,0017,0017,0017,0017,0017,0017,0017],
	[0017,0017,0017,0017,0017,0017,0017,0017,0017,0340,0341,0309,0308,0309,0308,0309,0308,0309,0308,0342,0343],
	[0017,0017,0017,0017,0017,0017,0017,0017,0017,0348,0349,0317,0316,0317,0316,0317,0316,0317,0316,0350,0351],
	[0340,0341,0308,0309,0308,0309,0308,0342,0343,0324,0325,0000,0000,0000,0000,0000,0000,0000,0000,0318,0319],
	[0348,0349,0316,0317,0316,0317,0316,0350,0351,0332,0333,0000,0000,-008,-008,-008,-008,-008,0000,0310,0311],
	[0324,0325,0000,0000,0000,0000,0000,0388,0389,0390,0391,0000,0000,-008,-008,-008,-008,-008,0000,0318,0319],
	[0332,0333,0000,0000,0000,0000,0000,0396,0397,0398,0399,0000,0000,-008,-008,-008,-008,-008,0000,0310,0311],
	[0324,0325,0000,0000,0000,0000,0000,0000,0000,0000,0000,0000,0000,0000,0000,0000,0000,0000,0000,0318,0319],
	[0332,0333,0000,0000,0000,0000,0000,0372,0373,0374,0375,0000,0000,0000,0000,0000,0000,0000,0000,0310,0311],
	[0324,0325,0000,0000,0000,0000,0000,0380,0381,0382,0383,0000,0000,0000,0000,0000,0000,0000,0000,0318,0319],
	[0356,0357,0326,0327,0023,0326,0327,0358,0359,0332,0333,0000,0000,0000,0000,0000,0000,0000,0000,0310,0311],
	[0364,0365,0334,0335,0335,0334,0335,0366,0367,0324,0325,0000,0000,0000,0000,0000,0000,0000,0000,0318,0319],
	[0017,0017,0017,0017,0017,0017,0017,0017,0017,0356,0357,0326,0327,0326,0327,0326,0327,0326,0327,0358,0359],
	[0017,0017,0017,0017,0017,0017,0017,0017,0017,0364,0365,0334,0335,0334,0335,0334,0335,0334,0335,0366,0367],
	[0017,0017,0017,0017,0017,0017,0017,0017,0017,0017,0017,0017,0017,0017,0017,0017,0017,0017,0017,0017,0017]
	],
	"couche1": [
	[-001,-001,-001,-001,-001,-001,-001,-001,-001,-001,-001,-001,-001,-001,-001,-001,-001,-001,-001,-001,-001],
	[-001,-001,-001,-001,-001,-001,-001,-001,-001,-001,-001,0028,0029,-001,-001,0512,0513,0514,-001,-001,-001],
	[-001,-001,-001,-001,-001,-001,-001,-001,-001,-001,-001,0036,0037,-001,-001,0520,0521,0522,0048,-001,-001],
	[-001,-001,-001,0064,0065,0066,0050,-001,-001,-001,-001,0044,0045,-001,-001,0528,0529,0530,0056,-001,-001],
	[-001,-001,-001,0072,0073,0074,0058,-001,-001,-001,-001,-001,-001,-001,-001,-001,-001,-001,0539,0540,-001],
	[-001,-001,-001,-001,-001,-001,-001,-001,-001,-001,-001,-001,-001,-001,-001,-001,-001,-001,0547,0548,-001],
	[0082,0083,-001,-001,-001,-001,-001,-001,-001,-001,-001,-001,-001,-001,-001,-001,-001,-001,-001,0080,0081],
	[0090,0091,-001,-001,-001,-001,-001,-001,-001,-001,-001,-001,-001,-001,-001,-001,-001,-001,-001,0088,0089],
	[0098,0099,-001,-001,-001,-001,-001,-001,-001,-001,-001,-001,-001,0005,0006,0007,-001,-001,-001,0096,0097],
	[-001,-001,-001,-001,-001,-001,-001,-001,-001,-001,-001,-001,-001,0013,0014,0015,0002,-001,-001,-001,-001],
	[-001,-001,-001,0384,0385,0386,-001,-001,-001,-001,-001,-001,-001,-001,0002,-001,-001,-001,-001,-001,-001],
	[-001,-001,-001,0392,0393,0394,-001,-001,-001,-001,-001,-001,-001,-001,-001,-001,-001,-001,-001,-001,-001],
	[-001,-001,-001,-001,-001,-001,-001,-001,-001,-001,-001,0552,0553,0554,-001,-001,0552,0553,0554,-001,-001],
	[-001,-001,-001,-001,-001,-001,-001,-001,-001,-001,-001,0560,0561,0562,-001,-001,0560,0561,0562,-001,-001],
	[-001,-001,-001,-001,-001,-001,-001,-001,-001,-001,-001,-001,-001,-001,-001,-001,-001,-001,-001,-001,-001]
	],
	"couche2": [
	[-001,-001,-001,-001,-001,-001,-001,-001,-001,-001,-001,-001,-001,-001,-001,-001,-001,-001,-001,-001,-001],
	[-001,-001,-001,-001,-001,-001,-001,-001,-001,-001,-001,-001,-001,-001,-001,-001,-001,-001,-001,-001,-001],
	[-001,-001,-001,-001,-001,-001,-001,-001,-001,-001,-001,-001,-001,0536,0537,0538,-001,-001,-001,-001,-001],
	[-001,-001,-001,-001,-001,-001,-001,-001,-001,-001,-001,-001,-001,0544,0545,0546,-001,-001,-001,-001,-001],
	[-001,-001,-001,-001,-001,-001,-001,-001,-001,-001,-001,-001,-001,-001,-001,-001,-001,-001,-001,-001,-001],
	[-001,-001,0030,0031,0002,-001,-001,-001,-001,-001,-001,-001,-001,-001,-001,-001,-001,-001,-001,-001,-001],
	[-001,-001,0038,0039,-001,-001,-001,-001,-001,-001,-001,-001,-001,-001,-001,-001,-001,-001,-001,-001,-001],
	[-001,-001,0046,0047,-001,-001,-001,-001,-001,-001,-001,-001,-001,-001,-001,-001,-001,-001,-001,-001,-001],
	[-001,-001,-001,-001,-001,-001,-001,-001,-001,-001,-001,-001,-001,-001,-001,-001,-001,-001,-001,-001,-001],
	[-001,-001,-001,-001,-001,-001,-001,-001,-001,-001,-001,-001,-001,-001,-001,-001,-001,-001,-001,-001,-001],
	[-001,-001,-001,-001,-001,-001,-001,-001,-001,-001,-001,-001,-001,-001,-001,-001,-001,-001,-001,-001,-001],
	[-001,-001,-001,-001,-001,-001,-001,-001,-001,-001,-001,-001,-001,-001,-001,-001,-001,-001,-001,-001,-001],
	[-001,-001,-001,-001,-001,-001,-001,-001,-001,-001,-001,-001,-001,-001,-001,-001,-001,-001,-001,-001,-001],
	[-001,-001,-001,-001,-001,-001,-001,-001,-001,-001,-001,-001,-001,-001,-001,-001,-001,-001,-001,-001,-001],
	[-001,-001,-001,-001,-001,-001,-001,-001,-001,-001,-001,-001,-001,-001,-001,-001,-001,-001,-001,-001,-001]
	],
	"events": [
	{
		"id": 5,
		"nom": "Clone[341][004]",
		"x": 18,
		"y": 11
	},
	{
		"id": 6,
		"nom": "Clone[341][004]",
		"x": 18,
		"y": 10
	},
	{
		"id": 1,
		"nom": "EV001",
		"x": 14,
		"y": 8,
		"pages": [
		{
			"conditions": [
			{
				"nom": "Parler"
			}
			],
			"commandes": [
			],
			"image": "plante en pot character",
			"directionInitiale": 2,
			"vitesse": "moderee",
			"frequence": "basse",
			"animeEnMouvement": false,
			"animeALArret": false,
			"directionFixe": true,
			"traversable": false,
			"auDessusDeTout": false
		}
		]
	},
	{
		"id": 7,
		"nom": "Clone[341][004]",
		"x": 11,
		"y": 4
	},
	{
		"id": 2,
		"nom": "feu (8)",
		"x": 16,
		"y": 2,
		"pages": [
		{
			"conditions": [
			{
				"nom": "Parler"
			}
			],
			"commandes": [
			],
			"image": "feu character",
			"vitesse": "tres rapide",
			"frequence": "la plus haute",
			"animeEnMouvement": false,
			"animeALArret": true,
			"directionFixe": true,
			"traversable": false,
			"auDessusDeTout": false
		}
		]
	},
	{
		"id": 8,
		"nom": "Clone[341][165]",
		"x": 18,
		"y": 6
	},
	{
		"id": 3,
		"nom": "Clone[341][004]",
		"x": 6,
		"y": 9
	},
	{
		"id": 9,
		"nom": "EV009",
		"x": 4,
		"y": 11,
		"pages": [
		{
			"conditions": [
			{
				"nom": "ArriveeAuContact"
			}
			],
			"commandes": [
			{
				"nom": "ChangerDeMap",
				"variable": false,
				"numeroNouvelleMap": 612,
				"xDebutHeros": 23,
				"yDebutHeros": 14
			}
			],
			"vitesse": "moderee",
			"frequence": "basse",
			"animeEnMouvement": true,
			"animeALArret": false,
			"directionFixe": false,
			"traversable": false,
			"auDessusDeTout": false
		}
		]
	},
	{
		"id": 4,
		"nom": "Clone[341][004]",
		"x": 2,
		"y": 9
	}
	]
}
