{
	"nom": "Salle 21 (miroirs)",
	"tileset": "Sanctuaire de Taiyou",
	"largeur": 21,
	"hauteur": 15,
	"musique": {
		"nomFichierSonore": "",
		"volume": 1.00,
		"tempo": 1.00
	},
	"fondSonore": {
		"nomFichierSonore": "",
		"volume": 0.80,
		"tempo": 1.00
	},
	"couche0": [
	[0036,0037,0016,0017,0018,0038,0039,0001,0001,0036,0037,0005,0004,0005,0004,0005,0038,0039,0001,0001,0001],
	[0044,0045,0024,0025,0026,0046,0047,0001,0001,0044,0045,0013,0012,0013,0012,0013,0046,0047,0001,0001,0001],
	[0020,0021,0000,0000,0000,0144,0145,0004,0004,0146,0147,-002,-002,-002,-002,-002,0144,0145,0004,0005,0004],
	[0028,0029,0000,0000,0000,0152,0153,0012,0012,0154,0155,-002,-002,-002,-002,-002,0152,0153,0012,0013,0012],
	[0020,0021,0000,0000,0000,0000,0000,0000,0000,0000,0000,-002,-002,0000,-002,0000,0000,0000,0000,0000,-002],
	[0028,0029,0000,0000,0000,0000,0000,0000,0000,0000,0000,-002,-002,-002,-002,-002,0000,0000,0000,0000,-002],
	[0020,0021,0000,0000,0000,0000,0000,0000,0000,0000,0000,0000,-002,0000,-002,-004,0000,0000,0000,0000,-002],
	[0028,0029,0000,0000,0128,0129,0022,0130,0131,-004,-004,-002,-002,-002,-002,-002,-002,0000,0000,0000,0000],
	[0020,0021,0000,0000,0136,0137,0030,0138,0139,-002,-002,-002,-002,-002,0000,-002,-002,0000,0000,0000,-002],
	[0146,0147,-008,-008,0144,0145,0004,0146,0147,-002,-002,-002,-002,-002,-002,-002,-002,0000,0000,0000,-002],
	[0154,0155,-008,-008,0152,0153,0012,0154,0155,-004,-002,-002,-002,-002,-002,-002,-004,0000,0000,0000,-002],
	[-008,-008,-008,-008,-008,0000,0000,0000,0000,0000,0000,0000,-002,-002,0000,-002,0000,0000,0000,0000,-002],
	[-008,-008,-008,-008,-008,0000,0000,0000,0000,0000,-002,-002,-002,-002,-002,-002,-002,0000,0000,0000,-002],
	[0130,0131,-008,-008,0128,0129,0022,0023,0022,0023,0022,0023,0022,0023,0022,0023,0022,0023,0022,0023,0022],
	[0138,0139,-008,-008,0136,0137,0030,0031,0030,0031,0030,0031,0030,0031,0030,0031,0030,0031,0030,0031,0030]
	],
	"couche1": [
	[-001,-001,-001,-001,-001,-001,-001,-001,-001,-001,-001,-001,-001,-001,-001,-001,-001,-001,-001,-001,-001],
	[-001,-001,-001,-001,-001,-001,-001,-001,-001,-001,-001,-001,-001,-001,-001,-001,-001,-001,-001,-001,-001],
	[-001,-001,-001,-001,-001,-001,-001,-001,-001,-001,-001,-001,-001,-001,-001,-001,-001,-001,-001,-001,-001],
	[-001,-001,-001,-001,-001,-001,-001,-001,-001,-001,-001,-001,-001,-001,-001,-001,-001,-001,-001,-001,-001],
	[-001,-001,-001,-001,-001,-001,-001,-001,-001,-001,-001,-001,-001,-001,-001,-001,-001,-001,-001,-001,-001],
	[-001,-001,-001,-001,-001,-001,-001,-001,-001,-001,-001,-001,-001,-001,-001,-001,-001,-001,-001,-001,-001],
	[-001,-001,-001,-001,-001,-001,-001,-001,-001,-001,-001,-001,-001,-001,-001,-001,-001,-001,-001,-001,-001],
	[-001,-001,-001,-001,-001,-001,-001,-001,-001,-001,-001,-001,-001,-001,-001,-001,-001,-001,-001,-001,-001],
	[-001,-001,-001,-001,-001,-001,-001,-001,-001,-001,-001,-001,-001,-001,-001,-001,-001,-001,-001,-001,-001],
	[-001,-001,-001,-001,-001,-001,-001,-001,-001,-001,-001,-001,-001,-001,-001,-001,-001,-001,-001,-001,-001],
	[-001,-001,-001,-001,-001,-001,-001,-001,-001,-001,-001,-001,-001,-001,-001,-001,-001,-001,-001,-001,-001],
	[-001,-001,-001,-001,-001,-001,-001,-001,-001,-001,-001,-001,-001,-001,-001,-001,-001,-001,-001,-001,-001],
	[-001,-001,-001,-001,-001,-001,-001,-001,-001,-001,-001,-001,-001,-001,-001,-001,-001,-001,-001,-001,-001],
	[-001,-001,-001,-001,-001,-001,-001,-001,-001,-001,-001,-001,-001,-001,-001,-001,-001,-001,-001,-001,-001],
	[-001,-001,-001,-001,-001,-001,-001,-001,-001,-001,-001,-001,-001,-001,-001,-001,-001,-001,-001,-001,-001]
	],
	"couche2": [
	[-001,-001,-001,-001,-001,-001,-001,-001,-001,-001,-001,-001,-001,-001,-001,-001,-001,-001,-001,-001,-001],
	[-001,-001,-001,-001,-001,-001,-001,-001,-001,-001,-001,-001,-001,-001,-001,-001,-001,-001,-001,-001,-001],
	[-001,-001,-001,-001,-001,-001,-001,-001,-001,-001,-001,-001,-001,-001,-001,-001,-001,-001,-001,-001,-001],
	[-001,-001,-001,-001,-001,-001,-001,-001,-001,-001,-001,-001,-001,-001,-001,-001,-001,-001,-001,-001,-001],
	[-001,-001,-001,-001,-001,-001,-001,-001,-001,-001,-001,-001,-001,-001,-001,-001,-001,-001,-001,-001,-001],
	[-001,-001,-001,-001,-001,-001,-001,-001,-001,-001,-001,-001,-001,-001,-001,-001,-001,-001,-001,-001,-001],
	[-001,-001,-001,-001,-001,-001,-001,-001,-001,-001,-001,-001,-001,-001,-001,-001,-001,-001,-001,-001,-001],
	[-001,-001,-001,-001,-001,-001,-001,-001,-001,-001,-001,-001,-001,-001,-001,-001,-001,-001,-001,-001,-001],
	[-001,-001,-001,-001,-001,-001,-001,-001,-001,-001,-001,-001,-001,-001,-001,-001,-001,-001,-001,-001,-001],
	[-001,-001,-001,-001,-001,-001,-001,-001,-001,-001,-001,-001,-001,-001,-001,-001,-001,-001,-001,-001,-001],
	[-001,-001,-001,-001,-001,-001,-001,-001,-001,-001,-001,-001,-001,-001,-001,-001,-001,-001,-001,-001,-001],
	[-001,-001,-001,-001,-001,-001,-001,-001,-001,-001,-001,-001,-001,-001,-001,-001,-001,-001,-001,-001,-001],
	[-001,-001,-001,-001,-001,-001,-001,-001,-001,-001,-001,-001,-001,-001,-001,-001,-001,-001,-001,-001,-001],
	[-001,-001,-001,-001,-001,-001,-001,-001,-001,-001,-001,-001,-001,-001,-001,-001,-001,-001,-001,-001,-001],
	[-001,-001,-001,-001,-001,-001,-001,-001,-001,-001,-001,-001,-001,-001,-001,-001,-001,-001,-001,-001,-001]
	],
	"events": [
	{
		"id": 5,
		"nom": "Clone[341][172]",
		"x": 11,
		"y": 6
	},
	{
		"id": 16,
		"nom": "EV016",
		"x": 2,
		"y": 14,
		"pages": [
		{
			"conditions": [
			{
				"nom": "ArriveeAuContact"
			}
			],
			"commandes": [
			{
				"nom": "ChangerDeMap",
				"variable": false,
				"numeroNouvelleMap": 632,
				"xDebutHeros": 2,
				"yDebutHeros": 1
			}
			],
			"vitesse": "moderee",
			"frequence": "basse",
			"animeEnMouvement": true,
			"animeALArret": false,
			"directionFixe": false,
			"traversable": false,
			"auDessusDeTout": false
		}
		]
	},
	{
		"id": 11,
		"nom": "EV011",
		"x": 0,
		"y": 12,
		"pages": [
		{
			"conditions": [
			{
				"nom": "ArriveeAuContact"
			}
			],
			"commandes": [
			{
				"nom": "ChangerDeMap",
				"variable": false,
				"numeroNouvelleMap": 614,
				"xDebutHeros": 19,
				"yDebutHeros": 12
			}
			],
			"vitesse": "moderee",
			"frequence": "basse",
			"animeEnMouvement": true,
			"animeALArret": false,
			"directionFixe": false,
			"traversable": false,
			"auDessusDeTout": false
		}
		]
	},
	{
		"id": 6,
		"nom": "Clone[341][172]",
		"x": 13,
		"y": 4
	},
	{
		"id": 17,
		"nom": "EV017",
		"x": 20,
		"y": 7,
		"pages": [
		{
			"conditions": [
			{
				"nom": "ArriveeAuContact"
			}
			],
			"commandes": [
			{
				"nom": "ChangerDeMap",
				"variable": false,
				"numeroNouvelleMap": 634,
				"xDebutHeros": 1,
				"yDebutHeros": 7
			}
			],
			"vitesse": "moderee",
			"frequence": "basse",
			"animeEnMouvement": true,
			"animeALArret": false,
			"directionFixe": false,
			"traversable": false,
			"auDessusDeTout": false
		}
		]
	},
	{
		"id": 1,
		"nom": "Clone[341][171]",
		"x": 11,
		"y": 11
	},
	{
		"id": 12,
		"nom": "Clone[572][13]",
		"x": 8,
		"y": 8
	},
	{
		"id": 7,
		"nom": "Clone[341][171]",
		"x": 10,
		"y": 4
	},
	{
		"id": 2,
		"nom": "Clone[341][172]",
		"x": 14,
		"y": 11
	},
	{
		"id": 13,
		"nom": "Clone[572][14]",
		"x": 13,
		"y": 13
	},
	{
		"id": 8,
		"nom": "Clone[341][171]",
		"x": 15,
		"y": 4
	},
	{
		"id": 3,
		"nom": "Clone[341][171]",
		"x": 14,
		"y": 8
	},
	{
		"id": 14,
		"nom": "EV014",
		"x": 3,
		"y": 14,
		"pages": [
		{
			"conditions": [
			{
				"nom": "ArriveeAuContact"
			}
			],
			"commandes": [
			{
				"nom": "ChangerDeMap",
				"variable": false,
				"numeroNouvelleMap": 632,
				"xDebutHeros": 3,
				"yDebutHeros": 1
			}
			],
			"vitesse": "moderee",
			"frequence": "basse",
			"animeEnMouvement": true,
			"animeALArret": false,
			"directionFixe": false,
			"traversable": false,
			"auDessusDeTout": false
		}
		]
	},
	{
		"id": 9,
		"nom": "Clone[341][171]",
		"x": 16,
		"y": 11
	},
	{
		"id": 4,
		"nom": "Clone[341][172]",
		"x": 13,
		"y": 6
	},
	{
		"id": 15,
		"nom": "Clone[341][172]",
		"x": 10,
		"y": 11
	},
	{
		"id": 10,
		"nom": "EV010",
		"x": 0,
		"y": 11,
		"pages": [
		{
			"conditions": [
			{
				"nom": "ArriveeAuContact"
			}
			],
			"commandes": [
			{
				"nom": "ChangerDeMap",
				"variable": false,
				"numeroNouvelleMap": 614,
				"xDebutHeros": 19,
				"yDebutHeros": 11
			}
			],
			"vitesse": "moderee",
			"frequence": "basse",
			"animeEnMouvement": true,
			"animeALArret": false,
			"directionFixe": false,
			"traversable": false,
			"auDessusDeTout": false
		}
		]
	}
	]
}
