{
	"nom": "Salle 11 (loupe)",
	"tileset": "Sanctuaire de Taiyou",
	"largeur": 21,
	"hauteur": 15,
	"musique": {
		"nomFichierSonore": "",
		"volume": 1.00,
		"tempo": 1.00
	},
	"fondSonore": {
		"nomFichierSonore": "",
		"volume": 0.80,
		"tempo": 1.00
	},
	"couche0": [
	[0001,0001,0001,0001,0001,0001,0001,0001,0001,0001,0001,0001,0001,0001,0001,0001,0001,0001,0001,0001,0001],
	[0001,0001,0036,0037,0005,0004,0005,0004,0005,0004,0005,0004,0005,0004,0005,0004,0005,0004,0005,0004,0005],
	[0001,0001,0044,0045,0013,0012,0013,0012,0013,0012,0013,0012,0013,0012,0013,0012,0013,0012,0013,0012,0013],
	[0001,0001,0020,0021,0036,0037,0005,0004,0005,0038,0039,0000,0000,0000,0036,0037,0005,0004,0005,0038,0039],
	[0001,0001,0028,0029,0044,0045,0013,0012,0013,0046,0047,0000,0000,0000,0044,0045,0013,0012,0013,0046,0047],
	[0001,0001,0020,0021,0020,0021,0000,0000,0000,0006,0007,0000,0000,0000,0020,0021,0000,0000,0173,0006,0007],
	[0001,0001,0028,0029,0028,0029,0000,0000,0000,0144,0145,0005,0004,0005,0146,0147,0000,0000,0000,0014,0015],
	[0001,0001,0020,0021,0020,0021,0000,0000,0000,0152,0153,0013,0012,0013,0154,0155,0000,0000,0000,0006,0007],
	[0001,0001,0028,0029,0028,0029,0000,0000,0000,0000,0173,0000,0000,0000,0000,0000,0000,0000,0000,0014,0015],
	[0001,0001,0020,0021,0020,0021,0000,0000,0000,0000,0000,0093,0094,0095,0000,0000,0000,-004,-007,0168,0169],
	[0001,0001,0028,0029,0028,0029,0000,0000,0000,0000,0000,0101,0102,0103,0000,0000,0000,-004,-007,0014,0015],
	[0001,0001,0020,0021,0020,0021,0000,0000,0000,0000,0000,0109,0110,0111,0000,0000,0173,-004,-007,0006,0007],
	[0001,0001,0028,0029,0028,0029,0000,0000,0000,0000,0000,0000,0000,0000,0000,0000,0000,0000,-007,0014,0015],
	[0001,0001,0020,0021,0052,0053,0022,0023,0022,0023,0022,0023,0022,0023,0022,0023,0022,0023,0022,0054,0055],
	[0001,0001,0028,0029,0060,0061,0030,0031,0030,0031,0030,0031,0030,0031,0030,0031,0030,0031,0030,0062,0063]
	],
	"couche1": [
	[-001,-001,-001,-001,-001,-001,-001,-001,-001,-001,-001,-001,-001,-001,-001,-001,-001,-001,-001,-001,-001],
	[-001,-001,-001,-001,-001,-001,-001,-001,-001,-001,-001,-001,-001,-001,-001,-001,-001,-001,-001,-001,-001],
	[-001,-001,-001,-001,-001,-001,-001,-001,-001,-001,-001,-001,-001,-001,-001,-001,-001,-001,-001,-001,-001],
	[-001,-001,-001,-001,-001,-001,-001,-001,-001,-001,-001,-001,-001,-001,-001,-001,-001,-001,-001,-001,-001],
	[-001,-001,-001,-001,-001,-001,-001,0075,-001,-001,-001,-001,-001,-001,-001,-001,-001,0091,0165,-001,-001],
	[-001,-001,-001,-001,-001,-001,0084,0083,-001,-001,-001,-001,-001,-001,-001,-001,-001,0099,-001,-001,-001],
	[-001,-001,-001,-001,-001,-001,-001,-001,-001,-001,-001,-001,-005,-001,-001,-001,-001,-001,-001,-001,-001],
	[-001,-001,-001,-001,-001,-001,-001,-001,-001,-001,0165,-001,-005,-001,0091,-001,-001,-001,-001,-001,-001],
	[-001,-001,-001,-001,-001,-001,-001,-001,-001,-001,-001,-001,-001,-001,0099,-001,-001,-001,-001,-001,-001],
	[-001,-001,-001,-001,-001,-001,-001,-001,-001,-001,-001,-001,-001,-001,-001,-001,-001,-001,-001,-001,-001],
	[-001,-001,-001,-001,-001,-001,-001,0091,-001,-001,-001,-001,-001,-001,-001,-001,0165,-001,-001,-001,-001],
	[-001,-001,-001,-001,-001,-001,-001,0099,-001,-001,-001,-001,-001,-001,-001,-001,-001,-001,-001,-001,-001],
	[-001,-001,-001,-001,-001,-001,-001,-001,-001,-001,-001,-001,-001,-001,-001,-001,-001,-001,-001,-001,-001],
	[-001,-001,-001,-001,-001,-001,-001,-001,-001,-001,-001,-001,-001,-001,-001,-001,-001,-001,-001,-001,-001],
	[-001,-001,-001,-001,-001,-001,-001,-001,-001,-001,-001,-001,-001,-001,-001,-001,-001,-001,-001,-001,-001]
	],
	"couche2": [
	[-001,-001,-001,-001,-001,-001,-001,-001,-001,-001,-001,-001,-001,-001,-001,-001,-001,-001,-001,-001,-001],
	[-001,-001,-001,-001,-001,-001,-001,-001,-001,-001,-001,-001,-001,-001,-001,-001,-001,-001,-001,-001,-001],
	[-001,-001,-001,-001,-001,-001,-001,-001,-001,-001,-001,-001,-001,-001,-001,-001,-001,-001,-001,-001,-001],
	[-001,-001,-001,-001,-001,-001,-001,-001,-001,-001,-001,-001,-001,-001,-001,-001,-001,-001,-001,-001,-001],
	[-001,-001,-001,-001,-001,-001,-001,-001,-001,-001,-001,-001,-001,-001,-001,-001,-001,-001,-001,-001,-001],
	[-001,-001,-001,-001,-001,-001,-001,-001,-001,-001,-001,-001,-001,-001,-001,-001,-001,-001,-001,-001,-001],
	[-001,-001,-001,-001,-001,-001,-001,-001,-001,-001,-001,-001,-001,-001,-001,-001,-001,-001,-001,-001,-001],
	[-001,-001,-001,-001,-001,-001,-001,-001,-001,-001,-001,-001,-001,-001,-001,-001,-001,-001,-001,-001,-001],
	[-001,-001,-001,-001,-001,-001,-001,-001,-001,-001,-001,-001,-001,-001,-001,-001,-001,-001,-001,-001,-001],
	[-001,-001,-001,-001,-001,-001,-001,-001,-001,-001,-001,-001,-001,-001,-001,-001,-001,-001,-001,-001,-001],
	[-001,-001,-001,-001,-001,-001,-001,-001,-001,-001,-001,-001,-001,-001,-001,-001,-001,-001,-001,-001,-001],
	[-001,-001,-001,-001,-001,-001,-001,-001,-001,-001,-001,-001,-001,-001,-001,-001,-001,-001,-001,-001,-001],
	[-001,-001,-001,-001,-001,-001,-001,-001,-001,-001,-001,-001,-001,-001,-001,-001,-001,-001,-001,-001,-001],
	[-001,-001,-001,-001,-001,-001,-001,-001,-001,-001,-001,-001,-001,-001,-001,-001,-001,-001,-001,-001,-001],
	[-001,-001,-001,-001,-001,-001,-001,-001,-001,-001,-001,-001,-001,-001,-001,-001,-001,-001,-001,-001,-001]
	],
	"events": [
	{
		"id": 5,
		"nom": "Clone[572][5]",
		"x": 8,
		"y": 7
	},
	{
		"id": 11,
		"nom": "Clone[572][5]",
		"x": 9,
		"y": 12
	},
	{
		"id": 6,
		"nom": "Clone[341][004]",
		"x": 17,
		"y": 5
	},
	{
		"id": 1,
		"nom": "statue",
		"x": 13,
		"y": 3,
		"pages": [
		{
			"conditions": [
			{
				"nom": "Parler"
			}
			],
			"commandes": [
			],
			"image": "mammouth statue character",
			"directionInitiale": 2,
			"vitesse": "moderee",
			"frequence": "basse",
			"animeEnMouvement": false,
			"animeALArret": false,
			"directionFixe": true,
			"traversable": false,
			"auDessusDeTout": false
		}
		]
	},
	{
		"id": 7,
		"nom": "Clone[572][5]",
		"x": 6,
		"y": 9
	},
	{
		"id": 2,
		"nom": "statue",
		"x": 11,
		"y": 3,
		"pages": [
		{
			"conditions": [
			{
				"nom": "Parler"
			}
			],
			"commandes": [
			],
			"image": "mammouth statue character",
			"directionInitiale": 1,
			"vitesse": "moderee",
			"frequence": "basse",
			"animeEnMouvement": false,
			"animeALArret": false,
			"directionFixe": true,
			"traversable": false,
			"auDessusDeTout": false
		}
		]
	},
	{
		"id": 8,
		"nom": "Clone[341][004]",
		"x": 16,
		"y": 5
	},
	{
		"id": 3,
		"nom": "EV003",
		"x": 20,
		"y": 9,
		"pages": [
		{
			"conditions": [
			{
				"nom": "ArriveeAuContact"
			}
			],
			"commandes": [
			{
				"nom": "ChangerDeMap",
				"variable": false,
				"numeroNouvelleMap": 625,
				"xDebutHeros": 1,
				"yDebutHeros": 9
			}
			],
			"vitesse": "moderee",
			"frequence": "basse",
			"animeEnMouvement": true,
			"animeALArret": false,
			"directionFixe": false,
			"traversable": false,
			"auDessusDeTout": false
		}
		]
	},
	{
		"id": 9,
		"nom": "Clone[572][5]",
		"x": 18,
		"y": 8
	},
	{
		"id": 4,
		"nom": "EV004",
		"x": 20,
		"y": 8,
		"pages": [
		{
			"conditions": [
			{
				"nom": "Parler"
			}
			],
			"commandes": [
			],
			"image": 7,
			"vitesse": "moderee",
			"frequence": "basse",
			"animeEnMouvement": false,
			"animeALArret": false,
			"directionFixe": false,
			"traversable": false,
			"auDessusDeTout": true
		}
		]
	},
	{
		"id": 10,
		"nom": "Clone[572][7]",
		"x": 8,
		"y": 12
	}
	]
}
