{
	"nom": "Salle 13 (trefles et cubes)",
	"tileset": "Sanctuaire de Taiyou",
	"largeur": 21,
	"hauteur": 15,
	"couche0": [
	[0001,0001,0001,0001,0001,0036,0037,0005,0004,0005,0004,0005,0004,0005,0004,0005,0004,0005,0004,0038,0039],
	[0001,0001,0001,0001,0001,0044,0045,0013,0012,0013,0012,0013,0012,0013,0012,0013,0012,0013,0012,0046,0047],
	[0001,0001,0001,0001,0001,0020,0021,-007,-007,-007,-007,-007,-007,-007,-007,-007,-007,-007,-007,0006,0007],
	[0001,0001,0001,0001,0001,0028,0029,-007,-007,0076,-007,-007,-007,-007,-007,-007,0076,-007,-007,0014,0015],
	[0001,0001,0001,0001,0001,0020,0021,-007,-007,-007,-007,-007,0076,-007,-007,-007,-007,0076,-007,0006,0007],
	[0001,0001,0001,0001,0001,0028,0029,-007,-007,-007,-007,-007,-007,-007,-007,-007,-007,-007,-007,0014,0015],
	[0001,0001,0001,0001,0001,0020,0021,-007,-007,-007,-007,-007,-007,-007,-007,-007,-007,0076,-007,0006,0007],
	[0001,0001,0001,0001,0001,0028,0029,-007,-007,0076,-007,-007,0076,-007,-007,-007,-007,0076,-007,0014,0015],
	[0001,0001,0001,0001,0001,0020,0021,-007,-007,-007,-007,-007,-007,-007,-007,-007,-007,-007,-007,0006,0007],
	[0036,0037,0004,0005,0004,0146,0147,-007,-007,-007,-007,-007,-007,-007,-007,-007,-007,-007,-007,0014,0015],
	[0044,0045,0012,0013,0012,0154,0155,0076,0076,0076,0076,0128,0129,0023,0130,0131,-007,-004,-004,0050,0051],
	[0028,0029,0076,0076,0076,0076,0076,0076,0076,0076,0076,0136,0137,0031,0138,0139,-007,0076,0076,0058,0059],
	[0020,0021,0076,0076,0076,0076,0076,0076,0076,0076,0076,0006,0007,0001,0020,0021,-007,-004,-004,0066,0067],
	[0028,0029,0076,0076,0076,0128,0129,0022,0032,0033,0034,0054,0055,0001,0052,0053,0022,0023,0022,0054,0055],
	[0020,0021,0076,0076,0076,0136,0137,0030,0040,0041,0042,0062,0063,0001,0060,0061,0030,0031,0030,0062,0063]
	],
	"couche1": [
	[-001,-001,-001,-001,-001,-001,-001,-001,-001,-001,-001,-001,-001,-001,-001,-001,-001,-001,-001,-001,-001],
	[-001,-001,-001,-001,-001,-001,-001,-001,-001,-001,-001,-001,-001,-001,-001,-001,-001,-001,-001,-001,-001],
	[-001,-001,-001,-001,-001,-001,-001,-001,-001,-001,-001,-001,-001,-001,-001,-001,-001,-001,-001,-001,-001],
	[-001,-001,-001,-001,-001,-001,-001,-001,-001,-001,-001,-001,-001,-001,-001,-001,-001,-001,-001,-001,-001],
	[-001,-001,-001,-001,-001,-001,-001,-001,-001,-001,-001,-001,-001,-001,-001,-001,-001,-001,-001,-001,-001],
	[-001,-001,-001,-001,-001,-001,-001,-001,-001,-001,-001,-001,-001,-001,-001,-001,-001,-001,-001,-001,-001],
	[-001,-001,-001,-001,-001,-001,-001,-001,-001,-001,-001,-001,-001,-001,-001,-001,-001,-001,-001,-001,-001],
	[-001,-001,-001,-001,-001,-001,-001,-001,-001,-001,-001,-001,-001,-001,-001,-001,-001,-001,-001,-001,-001],
	[-001,-001,-001,-001,-001,-001,-001,-001,-001,-001,-001,-001,-001,-001,-001,-001,-001,-001,-001,-001,-001],
	[-001,-001,-001,-001,-001,-001,-001,-001,-001,-001,-001,-001,-001,-001,-001,-001,-001,-001,-001,-001,-001],
	[-001,-001,-001,-001,-001,-001,-001,-001,0140,-001,-001,-001,-001,-001,-001,-001,-001,-001,-001,-001,-001],
	[-001,-001,-001,-001,-001,-001,-001,0125,-001,0141,0117,-001,-001,-001,-001,-001,-001,-001,-001,-001,-001],
	[-001,-001,0140,-001,-001,-001,0125,-001,-001,-001,0125,-001,-001,0117,-001,-001,-001,-001,-001,-001,-001],
	[-001,-001,-001,0141,-001,-001,-001,-001,-001,-001,-001,-001,-001,0125,-001,-001,-001,-001,-001,-001,-001],
	[-001,-001,0140,-001,-001,-001,-001,-001,-001,-001,-001,-001,-001,-001,-001,-001,-001,-001,-001,-001,-001]
	],
	"couche2": [
	[-001,-001,-001,-001,-001,-001,-001,-001,-001,-001,-001,-001,-001,-001,-001,-001,-001,-001,-001,-001,-001],
	[-001,-001,-001,-001,-001,-001,-001,-001,-001,-001,-001,-001,-001,-001,-001,-001,-001,-001,-001,-001,-001],
	[-001,-001,-001,-001,-001,-001,-001,-001,-001,-001,-001,-001,-001,-001,-001,-001,-001,-001,-001,-001,-001],
	[-001,-001,-001,-001,-001,-001,-001,-001,-001,-001,-001,-001,-001,-001,-001,-001,-001,-001,-001,-001,-001],
	[-001,-001,-001,-001,-001,-001,-001,-001,-001,-001,-001,-001,-001,-001,-001,-001,-001,-001,-001,-001,-001],
	[-001,-001,-001,-001,-001,-001,-001,-001,-001,-001,-001,-001,-001,-001,-001,-001,-001,-001,-001,-001,-001],
	[-001,-001,-001,-001,-001,-001,-001,-001,-001,-001,-001,-001,-001,-001,-001,-001,-001,-001,-001,-001,-001],
	[-001,-001,-001,-001,-001,-001,-001,-001,-001,-001,-001,-001,-001,-001,-001,-001,-001,-001,-001,-001,-001],
	[-001,-001,-001,-001,-001,-001,-001,-001,-001,-001,-001,-001,-001,-001,-001,-001,-001,-001,-001,-001,-001],
	[-001,-001,-001,-001,-001,-001,-001,-001,-001,-001,-001,-001,-001,-001,-001,-001,-001,-001,-001,-001,-001],
	[-001,-001,-001,-001,-001,-001,-001,-001,-001,-001,-001,-001,-001,-001,-001,-001,-001,-001,-001,-001,-001],
	[-001,-001,-001,-001,-001,-001,-001,-001,-001,-001,-001,-001,-001,-001,-001,-001,-001,-001,-001,-001,-001],
	[-001,-001,-001,-001,-001,-001,-001,-001,-001,-001,-001,-001,-001,-001,-001,-001,-001,-001,-001,-001,-001],
	[-001,-001,-001,-001,-001,-001,-001,-001,-001,-001,-001,-001,-001,-001,-001,-001,-001,-001,-001,-001,-001],
	[-001,-001,-001,-001,-001,-001,-001,-001,-001,-001,-001,-001,-001,-001,-001,-001,-001,-001,-001,-001,-001]
	],
	"events": [
	{
		"id": 5,
		"nom": "Clone[572][5]",
		"x": 9,
		"y": 3
	},
	{
		"id": 11,
		"nom": "EV011",
		"x": 4,
		"y": 14,
		"pages": [
		{
			"conditions": [
			{
				"nom": "ArriveeAuContact"
			}
			],
			"commandes": [
			{
				"nom": "ChangerDeMap",
				"variable": false,
				"numeroNouvelleMap": 601,
				"xDebutHeros": 4,
				"yDebutHeros": 1
			}
			],
			"vitesse": "moderee",
			"frequence": "basse",
			"animeEnMouvement": true,
			"animeALArret": false,
			"directionFixe": false,
			"traversable": false,
			"auDessusDeTout": false
		}
		]
	},
	{
		"id": 6,
		"nom": "Clone[572][5]",
		"x": 17,
		"y": 4
	},
	{
		"id": 1,
		"nom": "Clone[572][7]",
		"x": 9,
		"y": 7
	},
	{
		"id": 12,
		"nom": "EV012",
		"x": 9,
		"y": 14,
		"pages": [
		{
			"conditions": [
			{
				"nom": "ArriveeAuContact"
			}
			],
			"commandes": [
			{
				"nom": "ChangerDeMap",
				"variable": false,
				"numeroNouvelleMap": 601,
				"xDebutHeros": 9,
				"yDebutHeros": 1
			}
			],
			"vitesse": "moderee",
			"frequence": "basse",
			"animeEnMouvement": true,
			"animeALArret": false,
			"directionFixe": false,
			"traversable": false,
			"auDessusDeTout": false
		}
		]
	},
	{
		"id": 7,
		"nom": "Clone[572][9]",
		"x": 12,
		"y": 6
	},
	{
		"id": 2,
		"nom": "Clone[572][7]",
		"x": 12,
		"y": 7
	},
	{
		"id": 13,
		"nom": "EV013",
		"x": 20,
		"y": 11,
		"pages": [
		{
			"conditions": [
			{
				"nom": "ArriveeAuContact"
			}
			],
			"commandes": [
			{
				"nom": "ChangerDeMap",
				"variable": false,
				"numeroNouvelleMap": 629,
				"xDebutHeros": 1,
				"yDebutHeros": 11
			}
			],
			"vitesse": "moderee",
			"frequence": "basse",
			"animeEnMouvement": true,
			"animeALArret": false,
			"directionFixe": false,
			"traversable": false,
			"auDessusDeTout": false
		}
		]
	},
	{
		"id": 8,
		"nom": "Clone[572][9]",
		"x": 14,
		"y": 2
	},
	{
		"id": 3,
		"nom": "Clone[572][7]",
		"x": 12,
		"y": 4
	},
	{
		"id": 14,
		"nom": "Clone[341][0057]",
		"x": 19,
		"y": 11
	},
	{
		"id": 9,
		"nom": "EV009",
		"x": 2,
		"y": 14,
		"pages": [
		{
			"conditions": [
			{
				"nom": "ArriveeAuContact"
			}
			],
			"commandes": [
			{
				"nom": "ChangerDeMap",
				"variable": false,
				"numeroNouvelleMap": 601,
				"xDebutHeros": 2,
				"yDebutHeros": 1
			}
			],
			"vitesse": "moderee",
			"frequence": "basse",
			"animeEnMouvement": true,
			"animeALArret": false,
			"directionFixe": false,
			"traversable": false,
			"auDessusDeTout": false
		}
		]
	},
	{
		"id": 4,
		"nom": "Clone[572][7]",
		"x": 16,
		"y": 3
	},
	{
		"id": 10,
		"nom": "EV010",
		"x": 3,
		"y": 14,
		"pages": [
		{
			"conditions": [
			{
				"nom": "ArriveeAuContact"
			}
			],
			"commandes": [
			{
				"nom": "ChangerDeMap",
				"variable": false,
				"numeroNouvelleMap": 601,
				"xDebutHeros": 3,
				"yDebutHeros": 1
			}
			],
			"vitesse": "moderee",
			"frequence": "basse",
			"animeEnMouvement": true,
			"animeALArret": false,
			"directionFixe": false,
			"traversable": false,
			"auDessusDeTout": false
		}
		]
	}
	]
}
