{
	"nom": "Salle 14",
	"tileset": "Sanctuaire de Taiyou",
	"largeur": 21,
	"hauteur": 15,
	"musique": {
		"nomFichierSonore": "",
		"volume": 1.00,
		"tempo": 1.00
	},
	"fondSonore": {
		"nomFichierSonore": "",
		"volume": 0.80,
		"tempo": 1.00
	},
	"couche0": [
	[0020,0021,0036,0037,0004,0005,0038,0039,0036,0037,0004,0005,0004,0005,0004,0005,0004,0005,0004,0005,0004],
	[0028,0029,0044,0045,0012,0013,0046,0047,0044,0045,0012,0013,0012,0013,0012,0013,0012,0013,0012,0013,0012],
	[0020,0021,0020,0021,-002,-002,0006,0007,0020,0021,0000,0000,0000,0000,0000,0000,0000,0000,0000,0000,0000],
	[0028,0029,0028,0029,-002,-002,0014,0015,0028,0029,0000,0000,0000,0000,0000,0000,0000,0000,0000,0000,0000],
	[0020,0021,0020,0021,-002,-002,0006,0007,0020,0021,0000,0000,0000,0000,0000,0000,0000,0000,0000,0000,0000],
	[0028,0029,0028,0029,-002,-002,0014,0015,0028,0029,0000,0000,0000,0000,0000,0000,0000,0000,0000,0000,0000],
	[0020,0021,0020,0021,0000,0000,0050,0051,0048,0049,0000,0000,0000,0000,0000,0000,0000,0000,0000,0000,0000],
	[0028,0029,0028,0029,0000,0000,0058,0059,0056,0057,0000,0000,0000,0000,0000,0000,0000,0000,0000,0000,0000],
	[0020,0021,0020,0021,0000,0000,0066,0067,0064,0065,0000,0000,0000,0000,0000,0000,0000,0000,0000,0000,0000],
	[0146,0147,0052,0053,0022,0022,0054,0055,0028,0029,0000,0000,0000,0000,0000,0000,0000,0000,0000,0000,0000],
	[0154,0155,0060,0061,0030,0030,0062,0063,0020,0021,0000,0000,0000,0000,0000,0000,0000,0000,0000,0000,0000],
	[0000,0000,0000,0000,0117,0000,0000,0117,0028,0029,0117,0000,0117,0000,0117,0000,0117,0000,0117,0000,0117],
	[0130,0131,0000,0125,0000,0125,0000,0125,0020,0021,0125,0000,0000,0125,0000,0125,0000,0125,0000,0125,0000],
	[0138,0053,0022,0023,0022,0022,0130,0131,0052,0053,0023,0022,0023,0022,0023,0022,0023,0022,0023,0022,0023],
	[0060,0061,0030,0031,0030,0030,0138,0139,0060,0061,0031,0030,0031,0030,0031,0030,0031,0030,0031,0030,0031]
	],
	"couche1": [
	[-001,-001,-001,-001,-001,-001,-001,-001,-001,-001,-001,-001,-001,-001,-001,-001,-001,-001,-001,-001,-001],
	[-001,-001,-001,-001,-001,-001,-001,-001,-001,-001,-001,-001,-001,-001,-001,-001,-001,-001,-001,-001,-001],
	[-001,-001,-001,-001,-001,-001,-001,-001,-001,-001,-001,-001,-001,-001,-001,-001,-001,-001,-001,-001,-001],
	[-001,-001,-001,-001,-001,-001,-001,-001,-001,-001,-001,-001,-001,-001,-001,-001,-001,-001,-001,-001,-001],
	[-001,-001,-001,-001,-001,-001,-001,-001,-001,-001,-001,-001,-001,-001,-001,-001,-001,-001,-001,-001,-001],
	[-001,-001,-001,-001,-001,-001,-001,-001,-001,-001,-001,-001,-001,-001,-001,-001,-001,-001,-001,-001,-001],
	[-001,-001,-001,-001,-001,-001,-001,-001,-001,-001,-001,-001,-001,-001,-001,-001,-001,-001,-001,-001,-001],
	[-001,-001,-001,-001,-001,-001,-001,-001,-001,-001,-001,-001,-001,-001,-001,-001,-001,-001,-001,-001,-001],
	[-001,-001,-001,-001,-001,-001,-001,-001,-001,-001,-001,-001,-001,-001,-001,-001,-001,-001,-001,-001,-001],
	[-001,-001,-001,-001,-001,-003,-001,-001,-001,-001,-001,-001,-001,-001,-001,-001,-001,-001,-001,-001,-001],
	[-001,-001,-001,0091,-001,-003,0165,-001,-001,-001,-001,-001,-001,-001,-001,-001,-001,-001,-001,-001,-001],
	[-001,-001,-001,0099,-001,-001,0173,-001,-001,-001,-001,-001,-001,-001,-001,-001,-001,-001,-001,-001,-001],
	[-001,-001,-001,-001,-001,-001,-001,-001,-001,-001,-001,-001,-001,-001,-001,-001,-001,-001,-001,-001,-001],
	[-001,-001,-001,-001,-001,-001,-001,-001,-001,-001,-001,-001,-001,-001,-001,-001,-001,-001,-001,-001,-001],
	[-001,-001,-001,-001,-001,-001,-001,-001,-001,-001,-001,-001,-001,-001,-001,-001,-001,-001,-001,-001,-001]
	],
	"couche2": [
	[-001,-001,-001,-001,-001,-001,-001,-001,-001,-001,-001,-001,-001,-001,-001,-001,-001,-001,-001,-001,-001],
	[-001,-001,-001,-001,-001,-001,-001,-001,-001,-001,-001,-001,-001,-001,-001,-001,-001,-001,-001,-001,-001],
	[-001,-001,-001,-001,-001,-001,-001,-001,-001,-001,-001,-001,-001,-001,-001,-001,-001,-001,-001,-001,-001],
	[-001,-001,-001,-001,-001,-001,-001,-001,-001,-001,-001,-001,-001,-001,-001,-001,-001,-001,-001,-001,-001],
	[-001,-001,-001,-001,-001,-001,-001,-001,-001,-001,-001,-001,-001,-001,-001,-001,-001,-001,-001,-001,-001],
	[-001,-001,-001,-001,-001,-001,-001,-001,-001,-001,-001,-001,-001,-001,-001,-001,-001,-001,-001,-001,-001],
	[-001,-001,-001,-001,-001,-001,-001,-001,-001,-001,-001,-001,-001,-001,-001,-001,-001,-001,-001,-001,-001],
	[-001,-001,-001,-001,-001,-001,-001,-001,-001,-001,-001,-001,-001,-001,-001,-001,-001,-001,-001,-001,-001],
	[-001,-001,-001,-001,-001,-001,-001,-001,-001,-001,-001,-001,-001,-001,-001,-001,-001,-001,-001,-001,-001],
	[-001,-001,-001,-001,-001,-001,-001,-001,-001,-001,-001,-001,-001,-001,-001,-001,-001,-001,-001,-001,-001],
	[-001,-001,-001,-001,-001,-001,-001,-001,-001,-001,-001,-001,-001,-001,-001,-001,-001,-001,-001,-001,-001],
	[-001,-001,-001,-001,-001,-001,-001,-001,-001,-001,-001,-001,-001,-001,-001,-001,-001,-001,-001,-001,-001],
	[-001,-001,-001,-001,-001,-001,-001,-001,-001,-001,-001,-001,-001,-001,-001,-001,-001,-001,-001,-001,-001],
	[-001,-001,-001,-001,-001,-001,-001,-001,-001,-001,-001,-001,-001,-001,-001,-001,-001,-001,-001,-001,-001],
	[-001,-001,-001,-001,-001,-001,-001,-001,-001,-001,-001,-001,-001,-001,-001,-001,-001,-001,-001,-001,-001]
	],
	"events": [
	{
		"id": 1,
		"nom": "Clone[572][11]",
		"x": 5,
		"y": 1
	},
	{
		"id": 2,
		"nom": "EV002",
		"x": 0,
		"y": 11,
		"pages": [
		{
			"conditions": [
			{
				"nom": "ArriveeAuContact"
			}
			],
			"commandes": [
			{
				"nom": "ChangerDeMap",
				"variable": false,
				"numeroNouvelleMap": 627,
				"xDebutHeros": 19,
				"yDebutHeros": 11
			}
			],
			"vitesse": "moderee",
			"frequence": "basse",
			"animeEnMouvement": true,
			"animeALArret": false,
			"directionFixe": false,
			"traversable": false,
			"auDessusDeTout": false
		}
		]
	}
	]
}
