{
	"nom": "Vers le 1er mammouth",
	"tileset": "Zone Enneigée",
	"largeur": 21,
	"hauteur": 25,
	"musique": {
		"nomFichierSonore": "",
		"volume": 1.00,
		"tempo": 1.00
	},
	"fondSonore": {
		"nomFichierSonore": "",
		"volume": 0.80,
		"tempo": 1.00
	},
	"couche0": [
	[0030,0188,0168,0168,0168,0184,0000,0188,0189,0190,0168,0168,0168,0168,0168,0184,0024,0024,0000,0030,0030],
	[0030,0188,0168,0189,0190,0184,0000,0188,0168,0168,0168,0168,0168,0168,0168,0184,0024,0024,0000,0030,0030],
	[0030,0179,0170,0170,0170,0177,0000,0179,0170,0170,0170,0170,0180,0168,0168,0184,0024,0024,0000,0030,0030],
	[0021,0010,0010,0010,0010,0010,0018,0010,0010,0010,0010,0022,0179,0170,0170,0177,0024,0024,0000,0030,0030],
	[0010,0010,0010,0010,0010,0010,0018,0010,0010,0010,0022,0021,0010,0022,0189,0190,0024,0024,0000,0030,0030],
	[0011,0010,0010,0010,0010,0010,0018,0010,0010,0022,0021,0010,0022,0021,0022,0000,0024,0024,0000,0030,0030],
	[0190,0000,0000,0000,0000,0000,0000,0052,0000,0021,0010,0022,0021,0022,0030,0000,0024,0024,0000,0030,0030],
	[0000,0000,0000,0000,0000,0000,0000,0000,0000,0000,0000,0021,0022,0030,0030,0016,0017,0024,0000,0030,0030],
	[0000,0000,0000,0000,0000,0000,0000,0000,0000,0000,0000,0000,0030,0030,0030,0024,0016,0017,0000,0030,0030],
	[0059,0059,0059,0059,0059,0058,0058,0058,0058,0049,0000,0000,0030,0030,0030,0024,0024,0000,0000,0030,0030],
	[0058,0058,0058,0058,0058,0058,0058,0049,0000,0024,0000,0000,0030,0030,0030,0024,0024,0000,0053,0054,0030],
	[0195,0202,0202,0202,0202,0202,0193,0024,0009,0017,0000,0008,0030,0030,0021,0017,0024,0000,0030,0000,0021],
	[0179,0170,0170,0170,0170,0170,0177,0024,0024,0009,0012,0013,0030,0021,0010,0010,0017,0000,0021,0010,0010],
	[0010,0010,0010,0010,0010,0010,0010,0017,0024,0024,0000,0030,0021,0010,0010,0010,0010,0010,0010,0010,0022],
	[0011,0011,0010,0010,0010,0010,0010,0010,0017,0024,0000,0021,0010,0010,0010,0010,0010,0010,0010,0022,0030],
	[0011,0011,0010,0010,0010,0010,0010,0010,0010,0017,0000,0000,0189,0190,0189,0190,0000,0000,0000,0030,0030],
	[0011,0011,0011,0022,0000,0000,0000,0000,0000,0000,0000,0000,0000,0189,0190,0000,0000,0000,0000,0030,0030],
	[0000,0000,0000,0021,0011,0022,0000,0000,0000,0000,0000,0000,0000,0000,0000,0000,0000,0000,0053,0054,0030],
	[0000,0000,0000,0000,0000,0030,0189,0190,0000,0000,0000,0000,0000,0000,0000,0000,0000,0008,0030,0000,0030],
	[0058,0058,0058,0058,0058,0054,0053,0058,0058,0058,0058,0058,0058,0058,0058,0058,0058,0058,0054,0053,0054],
	[0058,0058,0058,0058,0058,0058,0061,0053,0058,0058,0058,0058,0058,0058,0058,0058,0058,0058,0058,0054,0053],
	[0058,0058,0058,0058,0058,0058,0058,0061,0000,0053,0058,0058,0058,0058,0058,0058,0058,0058,0058,0058,0054],
	[0058,0058,0058,0058,0058,0058,0058,0058,0058,0061,0000,0000,0053,0058,0058,0058,0058,0058,0058,0058,0058],
	[0058,0058,0058,0058,0058,0058,0058,0058,0058,0058,0058,0058,0061,0000,0053,0058,0058,0058,0058,0058,0058],
	[0058,0058,0058,0058,0058,0058,0058,0058,0058,0058,0058,0058,0058,0058,0061,0195,0202,0202,0202,0202,0202]
	],
	"couche1": [
	[-001,-001,-001,0181,0182,-001,-001,-001,-001,-001,-001,-001,-001,-001,-001,-001,-001,-001,-001,-001,-001],
	[-001,-001,-001,-001,-001,-001,-001,-001,-001,-001,-001,-001,-001,-001,-001,-001,-001,-001,-001,-001,-001],
	[-001,-001,-001,-001,-001,-001,-001,-001,-001,-001,-001,-001,-001,-001,-001,-001,-001,-001,-001,-001,-001],
	[-001,-001,-001,-001,-001,-001,-001,-001,-001,-001,-001,-001,-001,-001,0181,0182,-001,-001,-001,-001,-001],
	[-001,-001,-001,-001,-001,-001,-001,-001,-001,-001,-001,-001,-001,-001,-001,-001,-001,-001,-001,-001,-001],
	[0182,-001,-001,0123,-001,-001,-001,0044,-001,-001,-001,-001,-001,-001,-001,-001,-001,-001,-001,-001,-001],
	[-001,-001,-001,0131,0139,-001,-001,-001,-001,-001,-001,-001,-001,-001,-001,-001,-001,-001,-001,-001,-001],
	[-001,-001,0139,-001,-001,-001,-001,-001,-001,-001,0139,0123,-001,-001,-001,-001,-001,-001,-001,-001,-001],
	[-001,-001,-001,-001,-001,-001,-001,-001,-001,-001,-001,0131,-001,-001,-001,-001,-001,-001,-001,-001,-001],
	[-001,-001,-001,-001,-001,-001,-001,-001,-001,-001,-001,0139,-001,-001,-001,-001,-001,-001,-001,-001,-001],
	[-001,-001,-001,-001,-001,-001,-001,-001,-001,-001,-001,-001,-001,-001,-001,-001,-001,-001,-001,0124,-001],
	[-001,-001,-001,-001,-001,-001,-001,-001,-001,-001,-001,-001,-001,-001,-001,-001,-001,-001,-001,0132,-001],
	[-001,-001,-001,-001,-001,-001,-001,-001,-001,-001,-005,-001,-001,-001,-001,-001,-001,-001,-001,-001,-001],
	[-001,-001,-001,-001,-001,-001,-001,-001,-001,-001,-001,-001,-001,-001,-001,-001,-001,-005,-001,-001,-001],
	[-001,-001,-001,-001,-001,-001,-001,-001,-001,-001,-001,-001,0181,0182,0181,0182,-001,-005,-001,-001,-001],
	[-001,-001,-001,-001,-001,-001,-001,-001,-001,-001,-001,-001,-001,-001,-001,-001,-001,-001,-001,-001,-001],
	[-001,-001,-001,-001,-001,-001,-001,-001,-001,-001,-001,-001,-001,-001,-001,-001,-001,-001,-001,-001,-001],
	[-001,-001,0139,-001,-005,-001,0181,0182,0123,-001,-001,-001,-001,-001,-001,-001,-001,-001,-001,-001,-001],
	[-001,-001,-001,-001,-001,-001,-001,-001,0131,0139,-001,-001,-001,-001,-001,-001,-001,-001,-001,-001,-001],
	[-001,-001,-001,-001,-001,-001,-001,-001,-001,-001,-001,-001,-001,-001,-001,-001,-001,-001,-001,-001,-001],
	[-001,-001,-001,-001,-001,-001,-001,-001,-001,-001,-001,-001,-001,-001,-001,-001,-001,-001,-001,-001,-001],
	[-001,-001,-001,-001,-001,-001,-001,-001,-001,-001,-001,-001,-001,-001,-001,-001,-001,-001,-001,-001,-001],
	[-001,-001,-001,-001,-001,-001,-001,-001,-001,-001,-001,-001,-001,-001,-001,-001,-001,-001,-001,-001,-001],
	[-001,-001,-001,-001,-001,-001,-001,-001,-001,-001,-001,-001,-001,-001,-001,-001,-001,-001,-001,-001,-001],
	[-001,-001,-001,-001,-001,-001,-001,-001,-001,-001,-001,-001,-001,-001,-001,-001,-001,-001,-001,-001,-001]
	],
	"couche2": [
	[-001,-001,-001,-001,-001,-001,-001,-001,-001,-001,-001,-001,-001,-001,-001,-001,-001,-001,-001,-001,-001],
	[-001,-001,-001,-001,-001,-001,-001,-001,-001,-001,-001,-001,-001,-001,-001,-001,-001,-001,-001,-001,-001],
	[-001,-001,-001,-001,-001,-001,-001,-001,-001,-001,-001,-001,-001,-001,-001,-001,-001,-001,-001,-001,-001],
	[-001,-001,-001,-001,-001,-001,-001,-001,-001,-001,-001,-001,-001,-001,-001,-001,-001,-001,-001,-001,-001],
	[-001,-001,-001,-001,-001,-001,-001,-001,-001,-001,-001,-001,-001,-001,-001,-001,-001,-001,-001,-001,-001],
	[-001,-001,-001,-001,-001,-001,-001,-001,-001,-001,-001,-001,-001,-001,-001,-001,-001,-001,-001,-001,-001],
	[-001,-001,-001,-001,-001,-001,-001,-001,-001,-001,-001,-001,-001,-001,-001,-001,-001,-001,-001,-001,-001],
	[-001,-001,-001,-001,-001,-001,-001,-001,-001,-001,-001,-001,-001,-001,-001,-001,-001,-001,-001,-001,-001],
	[-001,-001,-001,-001,-001,-001,-001,-001,-001,-001,-001,-001,-001,-001,-001,-001,-001,-001,-001,-001,-001],
	[-001,-001,-001,-001,-001,-001,-001,-001,-001,-001,-001,-001,-001,-001,-001,-001,-001,-001,-001,-001,-001],
	[-001,-001,-001,-001,-001,-001,-001,-001,-001,-001,-001,-001,-001,-001,-001,-001,-001,-001,-001,-001,-001],
	[-001,-001,-001,-001,-001,-001,-001,-001,-001,-001,-001,-001,-001,-001,-001,-001,-001,-001,-001,-001,-001],
	[-001,-001,-001,-001,-001,-001,-001,-001,-001,-001,-001,-001,-001,-001,-001,-001,-001,-001,-001,-001,-001],
	[-001,-001,-001,-001,-001,-001,-001,-001,-001,-001,-001,-001,-001,-001,-001,-001,-001,-001,-001,-001,-001],
	[-001,-001,-001,-001,-001,-001,-001,-001,-001,-001,-001,-001,-001,-001,-001,-001,-001,-001,-001,-001,-001],
	[-001,-001,-001,-001,-001,-001,-001,-001,-001,-001,-001,-001,-001,0181,0182,-001,-001,-001,-001,-001,-001],
	[-001,-001,-001,-001,-001,-001,-001,-001,-001,-001,-001,-001,-001,-001,-001,-001,-001,-001,-001,-001,-001],
	[-001,-001,-001,-001,-001,-001,-001,-001,-001,-001,-001,-001,-001,-001,-001,-001,-001,-001,-001,-001,-001],
	[-001,-001,-001,-001,-001,-001,-001,-001,-001,-001,-001,-001,-001,-001,-001,-001,-001,-001,-001,-001,-001],
	[-001,-001,-001,-001,-001,-001,-001,-001,-001,-001,-001,-001,-001,-001,-001,-001,-001,-001,-001,-001,-001],
	[-001,-001,-001,-001,-001,-001,-001,-001,-001,-001,-001,-001,-001,-001,-001,-001,-001,-001,-001,-001,-001],
	[-001,-001,-001,-001,-001,-001,-001,-001,-001,-001,-001,-001,-001,-001,-001,-001,-001,-001,-001,-001,-001],
	[-001,-001,-001,-001,-001,-001,-001,-001,-001,-001,-001,-001,-001,-001,-001,-001,-001,-001,-001,-001,-001],
	[-001,-001,-001,-001,-001,-001,-001,-001,-001,-001,-001,-001,-001,-001,-001,-001,-001,-001,-001,-001,-001],
	[-001,-001,-001,-001,-001,-001,-001,-001,-001,-001,-001,-001,-001,-001,-001,-001,-001,-001,-001,-001,-001]
	],
	"events": [
	{
		"id": 5,
		"nom": "EV005",
		"x": 18,
		"y": 0,
		"pages": [
		{
			"conditions": [
			{
				"nom": "ArriveeAuContact"
			}
			],
			"commandes": [
			{
				"nom": "ChangerDeMap",
				"variable": false,
				"numeroNouvelleMap": 500,
				"xDebutHeros": 19,
				"yDebutHeros": 38
			}
			],
			"vitesse": "moderee",
			"frequence": "basse",
			"animeEnMouvement": true,
			"animeALArret": false,
			"directionFixe": false,
			"traversable": false,
			"auDessusDeTout": false
		}
		]
	},
	{
		"id": 11,
		"nom": "Clone[21][6]",
		"x": 10,
		"y": 18
	},
	{
		"id": 6,
		"nom": "Clone[341][113]",
		"x": 10,
		"y": 13
	},
	{
		"id": 12,
		"nom": "Clone[21][6]",
		"x": 12,
		"y": 16
	},
	{
		"id": 1,
		"nom": "EV001",
		"x": 0,
		"y": 17,
		"pages": [
		{
			"conditions": [
			{
				"nom": "ArriveeAuContact"
			}
			],
			"commandes": [
			{
				"nom": "ChangerDeMap",
				"variable": false,
				"numeroNouvelleMap": 597,
				"xDebutHeros": 19,
				"yDebutHeros": 22
			}
			],
			"vitesse": "moderee",
			"frequence": "basse",
			"animeEnMouvement": true,
			"animeALArret": false,
			"directionFixe": false,
			"traversable": false,
			"auDessusDeTout": false
		}
		]
	},
	{
		"id": 7,
		"nom": "Clone[341][113]",
		"x": 6,
		"y": 7
	},
	{
		"id": 2,
		"nom": "EV002",
		"x": 0,
		"y": 18,
		"pages": [
		{
			"conditions": [
			{
				"nom": "ArriveeAuContact"
			}
			],
			"commandes": [
			{
				"nom": "ChangerDeMap",
				"variable": false,
				"numeroNouvelleMap": 597,
				"xDebutHeros": 19,
				"yDebutHeros": 23
			}
			],
			"vitesse": "moderee",
			"frequence": "basse",
			"animeEnMouvement": true,
			"animeALArret": false,
			"directionFixe": false,
			"traversable": false,
			"auDessusDeTout": false
		}
		]
	},
	{
		"id": 8,
		"nom": "Clone[341][113]",
		"x": 5,
		"y": 8
	},
	{
		"id": 14,
		"nom": "activer le verglas",
		"x": 0,
		"y": 14,
		"pages": [
		{
			"conditions": [
			],
			"commandes": [
			{
				"nom": "ModifierMeteo",
				"type": "neige",
				"intensite": 9
			},
			{
				"nom": "ModifierInterrupteur",
				"numeroInterrupteur": 36,
				"valeur": false
			},
			{
				"nom": "AppelerPageCommune",
				"numeroPageCommune": 55
			},
			{
				"nom": "SupprimerEvent"
			}
			],
			"vitesse": "tres rapide",
			"frequence": "la plus haute",
			"animeEnMouvement": false,
			"animeALArret": false,
			"directionFixe": false,
			"traversable": true,
			"auDessusDeTout": false
		}
		]
	},
	{
		"id": 3,
		"nom": "EV003",
		"x": 0,
		"y": 7,
		"pages": [
		{
			"conditions": [
			{
				"nom": "ArriveeAuContact"
			}
			],
			"commandes": [
			{
				"nom": "ChangerDeMap",
				"variable": false,
				"numeroNouvelleMap": 597,
				"xDebutHeros": 19,
				"yDebutHeros": 12
			}
			],
			"vitesse": "moderee",
			"frequence": "basse",
			"animeEnMouvement": true,
			"animeALArret": false,
			"directionFixe": false,
			"traversable": false,
			"auDessusDeTout": false
		}
		]
	},
	{
		"id": 9,
		"nom": "Clone[341][113]",
		"x": 17,
		"y": 15
	},
	{
		"id": 4,
		"nom": "EV004",
		"x": 0,
		"y": 8,
		"pages": [
		{
			"conditions": [
			{
				"nom": "ArriveeAuContact"
			}
			],
			"commandes": [
			{
				"nom": "ChangerDeMap",
				"variable": false,
				"numeroNouvelleMap": 597,
				"xDebutHeros": 19,
				"yDebutHeros": 13
			}
			],
			"vitesse": "moderee",
			"frequence": "basse",
			"animeEnMouvement": true,
			"animeALArret": false,
			"directionFixe": false,
			"traversable": false,
			"auDessusDeTout": false
		}
		]
	},
	{
		"id": 10,
		"nom": "EV010",
		"x": 6,
		"y": 0,
		"pages": [
		{
			"conditions": [
			{
				"nom": "ArriveeAuContact"
			}
			],
			"commandes": [
			{
				"nom": "ChangerDeMap",
				"variable": false,
				"numeroNouvelleMap": 648,
				"xDebutHeros": 14,
				"yDebutHeros": 13
			}
			],
			"vitesse": "moderee",
			"frequence": "basse",
			"animeEnMouvement": true,
			"animeALArret": false,
			"directionFixe": false,
			"traversable": false,
			"auDessusDeTout": false
		}
		]
	}
	]
}
