{
	"nom": "Vers le 2e mammouth",
	"tileset": "Zone Enneigée",
	"largeur": 30,
	"hauteur": 20,
	"couche0": [
	[0172,0172,0172,0172,0172,0172,0172,0172,0172,0172,0172,0172,0172,0172,0172,0172,0172,0172,0172,0172,0172,0172,0172,0172,0172,0172,0172,0172,0172,0172],
	[0172,0172,0172,0172,0172,0172,0172,0172,0172,0172,0172,0172,0172,0172,0172,0172,0172,0172,0172,0172,0172,0172,0172,0172,0172,0172,0172,0172,0172,0172],
	[0172,0172,0172,0172,0172,0172,0172,0172,0172,0172,0172,0172,0172,0172,0172,0172,0172,0172,0172,0172,0172,0172,0172,0172,0172,0172,0172,0172,0172,0172],
	[0172,0172,0172,0172,0172,0172,0172,0172,0172,0172,0172,0172,0172,0172,0172,0172,0172,0172,0172,0172,0172,0172,0172,0172,0172,0172,0172,0172,0172,0172],
	[0172,0172,0172,0172,0172,0172,0172,0172,0172,0172,0172,0172,0172,0172,0172,0172,0172,0172,0172,0172,0172,0172,0172,0172,0172,0172,0172,0172,0172,0172],
	[0172,0172,0172,0172,0172,0172,0172,0172,0172,0172,0172,0172,0172,0172,0172,0172,0172,0172,0172,0172,0172,0172,0172,0172,0172,0172,0172,0172,0172,0172],
	[0172,0172,0172,0172,0172,0172,0172,0172,0172,0172,0172,0172,0172,0172,0172,0172,0172,0172,0172,0172,0172,0172,0172,0172,0172,0172,0172,0172,0172,0172],
	[0172,0172,0172,0172,0172,0172,0172,0176,0170,0170,0170,0170,0170,0170,0170,0170,0170,0170,0170,0170,0170,0170,0170,0170,0180,0172,0172,0172,0172,0172],
	[0172,0172,0172,0172,0172,0172,0172,0184,0009,0010,0010,0010,0010,0010,0010,0010,0010,0010,0010,0010,0010,0010,0010,0022,0188,0172,0172,0172,0172,0172],
	[0172,0172,0172,0172,0172,0172,0176,0177,0024,0000,0189,0190,0009,0010,0010,0010,0010,0010,0010,0010,0003,0010,0022,0030,0188,0172,0172,0172,0172,0172],
	[0172,0172,0172,0172,0172,0172,0184,0009,0017,0189,0190,0009,0017,0020,0020,0020,0189,0190,0020,0020,0020,0020,0030,0030,0188,0172,0172,0172,0172,0172],
	[0172,0172,0172,0172,0172,0172,0184,0024,0009,0010,0010,0017,0020,0020,0020,0020,0020,0020,0020,0020,0020,0020,0030,0030,0188,0172,0172,0172,0172,0172],
	[0172,0172,0172,0172,0172,0172,0184,0024,0024,0020,0020,0189,0190,0020,0020,0020,0020,0020,0020,0020,0189,0190,0030,0030,0188,0172,0172,0172,0172,0172],
	[0172,0172,0172,0172,0172,0172,0184,0024,0024,0020,0020,0020,0020,0020,0020,0020,0053,0058,0042,0058,0058,0058,0054,0030,0188,0172,0172,0172,0172,0172],
	[0172,0172,0172,0172,0172,0172,0184,0024,0024,0020,0020,0020,0020,0020,0008,0053,0054,0000,0000,0000,0053,0058,0058,0054,0188,0172,0172,0172,0172,0172],
	[0172,0172,0172,0172,0172,0172,0184,0024,0024,0020,0020,0020,0053,0058,0058,0054,0189,0190,0000,0000,0030,0195,0202,0202,0196,0172,0172,0172,0172,0172],
	[0172,0172,0172,0172,0172,0172,0184,0024,0024,0020,0053,0058,0054,0000,0053,0058,0058,0058,0049,0000,0030,0188,0172,0172,0172,0172,0172,0172,0172,0172],
	[0172,0172,0172,0172,0172,0172,0184,0024,0024,0020,0030,0053,0058,0058,0054,0195,0202,0193,0024,0000,0030,0188,0172,0172,0172,0172,0172,0172,0172,0172],
	[0172,0172,0172,0172,0172,0172,0184,0024,0024,0020,0030,0030,0195,0202,0202,0196,0172,0184,0041,0000,0030,0188,0172,0172,0172,0172,0172,0172,0172,0172],
	[0172,0172,0172,0172,0172,0172,0184,0024,0024,0020,0030,0030,0188,0172,0172,0172,0172,0184,0024,0000,0030,0188,0172,0172,0172,0172,0172,0172,0172,0172]
	],
	"couche1": [
	[-001,-001,-001,-001,-001,-001,-001,-001,-001,-001,-001,-001,-001,-001,-001,-001,-001,-001,-001,-001,-001,-001,-001,-001,-001,-001,-001,-001,-001,-001],
	[-001,-001,-001,-001,-001,-001,-001,-001,-001,-001,-001,-001,-001,-001,-001,-001,-001,-001,-001,-001,-001,-001,-001,-001,-001,-001,-001,-001,-001,-001],
	[-001,-001,-001,-001,-001,-001,-001,-001,-001,-001,-001,-001,-001,-001,-001,-001,-001,-001,-001,-001,-001,-001,-001,-001,-001,-001,-001,-001,-001,-001],
	[-001,-001,-001,-001,-001,-001,-001,-001,-001,-001,-001,-001,-001,-001,-001,-001,-001,-001,-001,-001,-001,-001,-001,-001,-001,-001,-001,-001,-001,-001],
	[-001,-001,-001,-001,-001,-001,-001,-001,-001,-001,-001,-001,-001,-001,-001,-001,-001,-001,-001,-001,-001,-001,-001,-001,-001,-001,-001,-001,-001,-001],
	[-001,-001,-001,-001,-001,-001,-001,-001,-001,-001,-001,-001,-001,-001,-001,-001,-001,-001,-001,-001,-001,-001,-001,-001,-001,-001,-001,-001,-001,-001],
	[-001,-001,-001,-001,-001,-001,-001,-001,-001,-001,-001,-001,-001,-001,-001,-001,-001,-001,-001,-001,-001,-001,-001,-001,-001,-001,-001,-001,-001,-001],
	[-001,-001,-001,-001,-001,-001,-001,-001,-001,-001,-001,-001,-001,-001,-001,-001,-001,-001,-001,-001,-001,-001,-001,-001,-001,-001,-001,-001,-001,-001],
	[-001,-001,-001,-001,-001,-001,-001,-001,-001,-001,0181,0182,-001,-001,-001,-001,-001,-001,-001,-001,-001,-001,-001,-001,-001,-001,-001,-001,-001,-001],
	[-001,-001,-001,-001,-001,-001,-001,-001,-001,-001,-001,-001,-001,-001,-001,-001,0181,0182,0123,-001,-001,-001,-001,-001,-001,-001,-001,-001,-001,-001],
	[-001,-001,-001,-001,-001,-001,-001,-001,-001,-001,-001,-001,-001,-001,-001,0139,-001,-001,0131,-001,-001,-001,-001,-001,-001,-001,-001,-001,-001,-001],
	[-001,-001,-001,-001,-001,-001,-001,-001,-001,-001,-001,0181,0182,-001,-001,-001,-001,-001,-001,0001,0181,0182,-001,-001,-001,-001,-001,-001,-001,-001],
	[-001,-001,-001,-001,-001,-001,-001,-001,-001,-001,-001,-001,-001,-001,-001,-001,-001,-001,-001,0002,-001,-001,-001,-001,-001,-001,-001,-001,-001,-001],
	[-001,-001,-001,-001,-001,-001,-001,-001,-001,-001,-001,0001,0002,-001,-001,-001,-001,-001,-001,-001,-001,-001,-001,-001,-001,-001,-001,-001,-001,-001],
	[-001,-001,-001,-001,-001,-001,-001,-001,-001,-001,-001,-001,-001,-001,-001,-001,0181,0182,-001,-001,-001,-001,-001,-001,-001,-001,-001,-001,-001,-001],
	[-001,-001,-001,-001,-001,-001,-001,-001,-001,-001,-001,-001,-001,-001,-001,-001,-001,-001,-001,-001,-001,-001,-001,-001,-001,-001,-001,-001,-001,-001],
	[-001,-001,-001,-001,-001,-001,-001,-001,-001,-001,-001,-001,-001,-001,-001,-001,-001,-001,-001,-001,-001,-001,-001,-001,-001,-001,-001,-001,-001,-001],
	[-001,-001,-001,-001,-001,-001,-001,-001,-001,-001,-001,-001,-001,-001,-001,-001,-001,-001,-001,-001,-001,-001,-001,-001,-001,-001,-001,-001,-001,-001],
	[-001,-001,-001,-001,-001,-001,-001,-001,-001,-001,-001,-001,-001,-001,-001,-001,-001,-001,0033,-001,-001,-001,-001,-001,-001,-001,-001,-001,-001,-001],
	[-001,-001,-001,-001,-001,-001,-001,-001,-001,-001,-001,-001,-001,-001,-001,-001,-001,-001,-001,-001,-001,-001,-001,-001,-001,-001,-001,-001,-001,-001]
	],
	"couche2": [
	[-001,-001,-001,-001,-001,-001,-001,-001,-001,-001,-001,-001,-001,-001,-001,-001,-001,-001,-001,-001,-001,-001,-001,-001,-001,-001,-001,-001,-001,-001],
	[-001,-001,-001,-001,-001,-001,-001,-001,-001,-001,-001,-001,-001,-001,-001,-001,-001,-001,-001,-001,-001,-001,-001,-001,-001,-001,-001,-001,-001,-001],
	[-001,-001,-001,-001,-001,-001,-001,-001,-001,-001,-001,-001,-001,-001,-001,-001,-001,-001,-001,-001,-001,-001,-001,-001,-001,-001,-001,-001,-001,-001],
	[-001,-001,-001,-001,-001,-001,-001,-001,-001,-001,-001,-001,-001,-001,-001,-001,-001,-001,-001,-001,-001,-001,-001,-001,-001,-001,-001,-001,-001,-001],
	[-001,-001,-001,-001,-001,-001,-001,-001,-001,-001,-001,-001,-001,-001,-001,-001,-001,-001,-001,-001,-001,-001,-001,-001,-001,-001,-001,-001,-001,-001],
	[-001,-001,-001,-001,-001,-001,-001,-001,-001,-001,-001,-001,-001,-001,-001,-001,-001,-001,-001,-001,-001,-001,-001,-001,-001,-001,-001,-001,-001,-001],
	[-001,-001,-001,-001,-001,-001,-001,-001,-001,-001,-001,-001,-001,-001,-001,-001,-001,-001,-001,-001,-001,-001,-001,-001,-001,-001,-001,-001,-001,-001],
	[-001,-001,-001,-001,-001,-001,-001,-001,-001,-001,-001,-001,-001,-001,-001,-001,-001,-001,-001,-001,-001,-001,-001,-001,-001,-001,-001,-001,-001,-001],
	[-001,-001,-001,-001,-001,-001,-001,-001,-001,-001,-001,-001,-001,-001,-001,-001,-001,-001,-001,-001,-001,-001,-001,-001,-001,-001,-001,-001,-001,-001],
	[-001,-001,-001,-001,-001,-001,-001,-001,-001,0181,0182,-001,-001,-001,-001,-001,-001,-001,-001,-001,-001,-001,-001,-001,-001,-001,-001,-001,-001,-001],
	[-001,-001,-001,-001,-001,-001,-001,-001,-001,-001,-001,-001,-001,-001,-001,-001,-001,-001,-001,-001,-001,-001,-001,-001,-001,-001,-001,-001,-001,-001],
	[-001,-001,-001,-001,-001,-001,-001,-001,-001,-001,-001,-001,-001,-001,-001,-001,-001,-001,-001,-001,0173,-001,-001,-001,-001,-001,-001,-001,-001,-001],
	[-001,-001,-001,-001,-001,-001,-001,-001,-001,-001,-001,-001,0174,-001,-001,-001,-001,-001,-001,-001,-001,-001,-001,-001,-001,-001,-001,-001,-001,-001],
	[-001,-001,-001,-001,-001,-001,-001,-001,-001,-001,-001,-001,-001,-001,-001,-001,-001,-001,-001,-001,-001,-001,-001,-001,-001,-001,-001,-001,-001,-001],
	[-001,-001,-001,-001,-001,-001,-001,-001,-001,-001,-001,-001,-001,-001,-001,-001,-001,-001,-001,-001,-001,-001,-001,-001,-001,-001,-001,-001,-001,-001],
	[-001,-001,-001,-001,-001,-001,-001,-001,-001,-001,-001,-001,-001,-001,-001,-001,-001,-001,-001,-001,-001,-001,-001,-001,-001,-001,-001,-001,-001,-001],
	[-001,-001,-001,-001,-001,-001,-001,-001,-001,-001,-001,-001,-001,-001,-001,-001,-001,-001,-001,-001,-001,-001,-001,-001,-001,-001,-001,-001,-001,-001],
	[-001,-001,-001,-001,-001,-001,-001,-001,-001,-001,-001,-001,-001,-001,-001,-001,-001,-001,-001,-001,-001,-001,-001,-001,-001,-001,-001,-001,-001,-001],
	[-001,-001,-001,-001,-001,-001,-001,-001,-001,-001,-001,-001,-001,-001,-001,-001,-001,-001,-001,-001,-001,-001,-001,-001,-001,-001,-001,-001,-001,-001],
	[-001,-001,-001,-001,-001,-001,-001,-001,-001,-001,-001,-001,-001,-001,-001,-001,-001,-001,-001,-001,-001,-001,-001,-001,-001,-001,-001,-001,-001,-001]
	],
	"events": [
	{
		"id": 5,
		"nom": "Clone[341][113]",
		"x": 10,
		"y": 15
	},
	{
		"id": 11,
		"nom": "EV011",
		"x": 18,
		"y": 17,
		"pages": [
		{
			"conditions": [
			{
				"nom": "Parler"
			}
			],
			"commandes": [
			],
			"image": 24,
			"vitesse": "moderee",
			"frequence": "basse",
			"animeEnMouvement": false,
			"animeALArret": false,
			"directionFixe": true,
			"traversable": true,
			"auDessusDeTout": true
		}
		]
	},
	{
		"id": 6,
		"nom": "Clone[341][113]",
		"x": 9,
		"y": 14
	},
	{
		"id": 1,
		"nom": "EV001",
		"x": 19,
		"y": 19,
		"pages": [
		{
			"conditions": [
			{
				"nom": "ArriveeAuContact"
			}
			],
			"commandes": [
			{
				"nom": "ChangerDeMap",
				"variable": false,
				"numeroNouvelleMap": 647,
				"xDebutHeros": 6,
				"yDebutHeros": 1
			}
			],
			"vitesse": "moderee",
			"frequence": "basse",
			"animeEnMouvement": true,
			"animeALArret": false,
			"directionFixe": false,
			"traversable": false,
			"auDessusDeTout": false
		}
		]
	},
	{
		"id": 7,
		"nom": "activer le verglas",
		"x": 11,
		"y": 18,
		"pages": [
		{
			"conditions": [
			],
			"commandes": [
			{
				"nom": "ModifierInterrupteur",
				"numeroInterrupteur": 36,
				"valeur": false
			},
			{
				"nom": "AppelerPageCommune",
				"numeroPageCommune": 55
			},
			{
				"nom": "SupprimerEvent"
			}
			],
			"vitesse": "tres rapide",
			"frequence": "la plus haute",
			"animeEnMouvement": false,
			"animeALArret": false,
			"directionFixe": false,
			"traversable": true,
			"auDessusDeTout": false
		}
		]
	},
	{
		"id": 2,
		"nom": "EV002",
		"x": 9,
		"y": 19,
		"pages": [
		{
			"conditions": [
			{
				"nom": "ArriveeAuContact"
			}
			],
			"commandes": [
			{
				"nom": "ChangerDeMap",
				"variable": false,
				"numeroNouvelleMap": 597,
				"xDebutHeros": 17,
				"yDebutHeros": 1
			}
			],
			"vitesse": "moderee",
			"frequence": "basse",
			"animeEnMouvement": true,
			"animeALArret": false,
			"directionFixe": false,
			"traversable": false,
			"auDessusDeTout": false
		}
		]
	},
	{
		"id": 8,
		"nom": "Clone[21][6]",
		"x": 13,
		"y": 12
	},
	{
		"id": 3,
		"nom": "EV003",
		"x": 20,
		"y": 9,
		"pages": [
		{
			"conditions": [
			{
				"nom": "ArriveeAuContact"
			}
			],
			"commandes": [
			{
				"nom": "ChangerDeMap",
				"variable": false,
				"numeroNouvelleMap": 655,
				"xDebutHeros": 6,
				"yDebutHeros": 11
			}
			],
			"vitesse": "moderee",
			"frequence": "basse",
			"animeEnMouvement": true,
			"animeALArret": false,
			"directionFixe": false,
			"traversable": false,
			"auDessusDeTout": false
		}
		]
	},
	{
		"id": 9,
		"nom": "Clone[21][6]",
		"x": 13,
		"y": 11
	},
	{
		"id": 4,
		"nom": "EV004",
		"x": 20,
		"y": 8,
		"pages": [
		{
			"conditions": [
			{
				"nom": "Parler"
			}
			],
			"commandes": [
			],
			"image": 10,
			"vitesse": "moderee",
			"frequence": "basse",
			"animeEnMouvement": false,
			"animeALArret": false,
			"directionFixe": true,
			"traversable": true,
			"auDessusDeTout": true
		}
		]
	},
	{
		"id": 10,
		"nom": "EV010",
		"x": 18,
		"y": 18,
		"pages": [
		{
			"conditions": [
			{
				"nom": "ArriveeAuContact"
			}
			],
			"commandes": [
			{
				"nom": "ChangerDeMap",
				"variable": false,
				"numeroNouvelleMap": 597,
				"xDebutHeros": 17,
				"yDebutHeros": 4
			}
			],
			"vitesse": "moderee",
			"frequence": "basse",
			"animeEnMouvement": true,
			"animeALArret": false,
			"directionFixe": false,
			"traversable": false,
			"auDessusDeTout": false
		}
		]
	}
	]
}
