{
	"nom": "Grotte de glace",
	"tileset": "Zone Enneigée",
	"largeur": 21,
	"hauteur": 15,
	"couche0": [
	[0168,0168,0168,0168,0168,0168,0168,0168,0168,0168,0168,0168,0168,0168,0168,0168,0168,0168,0168,0168,0168],
	[0168,0168,0168,0168,0168,0168,0168,0168,0168,0168,0168,0168,0168,0168,0168,0168,0168,0168,0168,0168,0168],
	[0168,0168,0168,0168,0168,0168,0168,0168,0168,0168,0169,0170,0170,0170,0180,0168,0168,0168,0168,0168,0168],
	[0168,0168,0168,0168,0168,0169,0170,0170,0170,0170,0177,0009,0003,0022,0179,0170,0170,0180,0168,0168,0168],
	[0168,0168,0168,0168,0169,0177,0052,0000,0009,0010,0010,0017,0000,0021,0010,0010,0022,0188,0168,0168,0168],
	[0168,0168,0168,0168,0184,0000,0000,0000,0024,-008,-008,-008,-008,-008,0052,-008,0030,0179,0180,0168,0168],
	[0168,0168,0168,0176,0177,0009,0010,0010,0017,-008,0008,-008,-008,-008,-008,-008,0021,0022,0188,0168,0168],
	[0168,0168,0168,0184,0009,0017,-008,-008,-008,-008,-008,-008,0000,-008,-008,-008,-008,0030,0188,0168,0168],
	[0168,0168,0168,0184,0024,-008,-008,-008,-008,-008,-008,-008,-008,-008,-008,-008,-008,0030,0188,0168,0168],
	[0168,0168,0168,0184,0024,-008,-008,-008,-008,-008,-008,-008,-008,-008,-008,-008,0052,0030,0188,0168,0168],
	[0168,0168,0168,0184,0024,0008,0000,0000,0053,0058,0058,0058,0058,0049,0000,0000,0000,0030,0188,0168,0168],
	[0168,0168,0168,0184,0024,0000,0000,0000,0030,0195,0202,0202,0193,0024,0000,0000,0000,0030,0188,0168,0168],
	[0168,0168,0168,0184,0057,0058,0051,0058,0054,0188,0168,0168,0184,0057,0058,0051,0058,0054,0188,0168,0168],
	[0168,0168,0168,0201,0202,0202,0202,0202,0202,0203,0168,0168,0201,0202,0202,0202,0202,0202,0203,0168,0168],
	[0168,0168,0168,0168,0168,0168,0168,0168,0168,0168,0168,0168,0168,0168,0168,0168,0168,0168,0168,0168,0168]
	],
	"couche1": [
	[-001,-001,-001,-001,-001,-001,-001,-001,-001,-001,-001,-001,-001,-001,-001,-001,-001,-001,-001,-001,-001],
	[-001,-001,-001,-001,-001,-001,-001,-001,-001,-001,-001,-001,-001,-001,-001,-001,-001,-001,-001,-001,-001],
	[-001,-001,-001,-001,-001,-001,-001,-001,-001,-001,-001,-001,-001,-001,-001,-001,-001,-001,-001,-001,-001],
	[-001,-001,-001,-001,-001,-001,0044,-001,-001,-001,-001,-001,-001,-001,-001,-001,-001,-001,-001,-001,-001],
	[-001,-001,-001,-001,-001,-001,-001,-001,-001,-001,-001,-001,-001,-001,0044,-001,-001,-001,-001,-001,-001],
	[-001,-001,-001,-001,-001,-001,-001,-001,-001,-001,-001,-001,-001,-001,-001,-001,-001,-001,-001,-001,-001],
	[-001,-001,-001,-001,-001,-001,-001,-001,-001,-001,-001,-001,-001,-001,-001,-001,-001,-001,-001,-001,-001],
	[-001,-001,-001,-001,-001,-001,-001,-001,-001,-001,-001,-001,-001,-001,-001,-001,-001,-001,-001,-001,-001],
	[-001,-001,-001,-001,-001,-001,-001,-001,-001,-001,-001,-001,-001,-001,-001,-001,0044,-001,-001,-001,-001],
	[-001,-001,-001,-001,-001,-001,-001,-001,-001,-001,-001,-001,-001,-001,-001,-001,-001,-001,-001,-001,-001],
	[-001,-001,-001,-001,-001,-001,-001,-001,-001,-001,-001,-001,-001,-001,-001,-001,-001,-001,-001,-001,-001],
	[-001,-001,-001,-001,-001,-001,-001,-001,-001,-001,-001,-001,-001,-001,-001,-001,-001,-001,-001,-001,-001],
	[-001,-001,-001,-001,-001,-001,0050,-001,-001,-001,-001,-001,-001,-001,-001,0050,-001,-001,-001,-001,-001],
	[-001,-001,-001,-001,-001,-001,-001,-001,-001,-001,-001,-001,-001,-001,-001,-001,-001,-001,-001,-001,-001],
	[-001,-001,-001,-001,-001,-001,-001,-001,-001,-001,-001,-001,-001,-001,-001,-001,-001,-001,-001,-001,-001]
	],
	"couche2": [
	[-001,-001,-001,-001,-001,-001,-001,-001,-001,-001,-001,-001,-001,-001,-001,-001,-001,-001,-001,-001,-001],
	[-001,-001,-001,-001,-001,-001,-001,-001,-001,-001,-001,-001,-001,-001,-001,-001,-001,-001,-001,-001,-001],
	[-001,-001,-001,-001,-001,-001,-001,-001,-001,-001,-001,-001,-001,-001,-001,-001,-001,-001,-001,-001,-001],
	[-001,-001,-001,-001,-001,-001,-001,-001,-001,-001,-001,-001,-001,-001,-001,-001,-001,-001,-001,-001,-001],
	[-001,-001,-001,-001,-001,-001,-001,-001,-001,-001,-001,-001,-001,-001,-001,-001,-001,-001,-001,-001,-001],
	[-001,-001,-001,-001,-001,-001,-001,-001,-001,-001,-001,-001,-001,-001,-001,-001,-001,-001,-001,-001,-001],
	[-001,-001,-001,-001,-001,-001,-001,-001,-001,-001,-001,-001,-001,-001,-001,-001,-001,-001,-001,-001,-001],
	[-001,-001,-001,-001,-001,-001,-001,-001,-001,-001,-001,-001,-001,-001,-001,-001,-001,-001,-001,-001,-001],
	[-001,-001,-001,-001,-001,-001,-001,-001,-001,-001,-001,-001,-001,-001,-001,-001,-001,-001,-001,-001,-001],
	[-001,-001,-001,-001,-001,-001,-001,-001,-001,-001,-001,-001,-001,-001,-001,-001,-001,-001,-001,-001,-001],
	[-001,-001,-001,-001,-001,-001,-001,-001,-001,-001,-001,-001,-001,-001,-001,-001,-001,-001,-001,-001,-001],
	[-001,-001,-001,-001,-001,-001,-001,-001,-001,-001,-001,-001,-001,-001,-001,-001,-001,-001,-001,-001,-001],
	[-001,-001,-001,-001,-001,-001,-001,-001,-001,-001,-001,-001,-001,-001,-001,-001,-001,-001,-001,-001,-001],
	[-001,-001,-001,-001,-001,-001,-001,-001,-001,-001,-001,-001,-001,-001,-001,-001,-001,-001,-001,-001,-001],
	[-001,-001,-001,-001,-001,-001,-001,-001,-001,-001,-001,-001,-001,-001,-001,-001,-001,-001,-001,-001,-001]
	],
	"events": [
	{
		"id": 5,
		"nom": "stalagtite",
		"x": 6,
		"y": 3,
		"pages": [
		{
			"conditions": [
			{
				"nom": "Parler"
			}
			],
			"commandes": [
			],
			"image": 44,
			"vitesse": "moderee",
			"frequence": "basse",
			"animeEnMouvement": false,
			"animeALArret": false,
			"directionFixe": true,
			"traversable": true,
			"auDessusDeTout": true
		}
		]
	},
	{
		"id": 1,
		"nom": "EV001",
		"x": 15,
		"y": 12,
		"pages": [
		{
			"conditions": [
			{
				"nom": "ArriveeAuContact"
			}
			],
			"commandes": [
			{
				"nom": "ChangerDeMap",
				"variable": false,
				"numeroNouvelleMap": 500,
				"xDebutHeros": 19,
				"yDebutHeros": 7
			}
			],
			"vitesse": "moderee",
			"frequence": "basse",
			"animeEnMouvement": true,
			"animeALArret": false,
			"directionFixe": false,
			"traversable": false,
			"auDessusDeTout": false
		}
		]
	},
	{
		"id": 2,
		"nom": "EV002",
		"x": 6,
		"y": 12,
		"pages": [
		{
			"conditions": [
			{
				"nom": "ArriveeAuContact"
			}
			],
			"commandes": [
			{
				"nom": "ChangerDeMap",
				"variable": false,
				"numeroNouvelleMap": 648,
				"xDebutHeros": 20,
				"yDebutHeros": 10
			}
			],
			"vitesse": "moderee",
			"frequence": "basse",
			"animeEnMouvement": true,
			"animeALArret": false,
			"directionFixe": false,
			"traversable": false,
			"auDessusDeTout": false
		}
		]
	},
	{
		"id": 3,
		"nom": "activer le verglas",
		"x": 16,
		"y": 12,
		"pages": [
		{
			"conditions": [
			],
			"commandes": [
			{
				"nom": "ModifierMeteo",
				"type": "rien",
				"intensite": 5
			},
			{
				"nom": "ModifierInterrupteur",
				"numeroInterrupteur": 36,
				"valeur": true
			},
			{
				"nom": "AppelerPageCommune",
				"numeroPageCommune": 55
			},
			{
				"nom": "SupprimerEvent"
			}
			],
			"vitesse": "tres rapide",
			"frequence": "la plus haute",
			"animeEnMouvement": false,
			"animeALArret": false,
			"directionFixe": false,
			"traversable": true,
			"auDessusDeTout": false
		}
		]
	},
	{
		"id": 4,
		"nom": "EV004",
		"x": 12,
		"y": 3,
		"pages": [
		{
			"conditions": [
			{
				"nom": "ArriveeAuContact"
			}
			],
			"commandes": [
			{
				"nom": "ChangerDeMap",
				"variable": false,
				"numeroNouvelleMap": 665,
				"xDebutHeros": 23,
				"yDebutHeros": 17
			}
			],
			"vitesse": "moderee",
			"frequence": "basse",
			"animeEnMouvement": true,
			"animeALArret": false,
			"directionFixe": false,
			"traversable": false,
			"auDessusDeTout": false
		}
		]
	}
	]
}
