{
	"nom": "Tunnel Mathusalem (suite)",
	"tileset": "Intestins",
	"largeur": 21,
	"hauteur": 30,
	"musique": {
		"nomFichierSonore": "",
		"volume": 1.00,
		"tempo": 1.00
	},
	"fondSonore": {
		"nomFichierSonore": "",
		"volume": 0.80,
		"tempo": 1.00
	},
	"couche0": [
	[0264,0264,0264,0264,0264,0264,0264,0024,0024,-008,0030,0030,0264,0264,0264,0264,0264,0264,0264,0264,0264],
	[0264,0264,0264,0264,0264,0264,0264,0024,0024,-008,0030,0030,0264,0264,0264,0264,0264,0264,0264,0264,0264],
	[0264,0264,0264,0264,0016,0010,0010,0017,0024,-008,0030,0021,0010,0010,0010,0010,0013,0264,0264,0264,0264],
	[0264,0264,0264,0264,0024,0016,0010,0010,0017,-008,0021,0010,0010,0010,0010,0013,0030,0264,0264,0264,0264],
	[0264,0264,0264,0264,0024,0024,-008,-008,-008,-008,-008,-008,-008,-008,-008,0030,0030,0264,0264,0264,0264],
	[0264,0264,0264,0264,0024,0024,-008,0053,0058,0058,0058,0058,0058,0058,0058,0054,0030,0264,0264,0264,0264],
	[0264,0264,0264,0264,0024,0024,-008,0030,0053,0058,0058,0058,0058,0058,0058,0058,0054,0264,0264,0264,0264],
	[0264,0264,0264,0264,0024,0024,-008,0030,0030,0264,0264,0264,0264,0264,0264,0264,0264,0264,0264,0264,0264],
	[0264,0264,0264,0264,0024,0024,-008,0030,0030,0264,0264,0264,0264,0264,0264,0264,0264,0264,0264,0264,0264],
	[0264,0264,0264,0264,0024,0024,-008,0030,0021,0010,0010,0010,0010,0010,0010,0010,0010,0013,0264,0264,0264],
	[0264,0264,0264,0264,0024,0024,-008,0021,0010,0010,0010,0010,0010,0010,0010,0010,0013,0030,0264,0264,0264],
	[0264,0264,0264,0264,0024,0024,-008,-008,-008,-008,-008,-008,-008,-008,-008,-008,0030,0030,0264,0264,0264],
	[0264,0264,0264,0264,0024,0048,0058,0058,0058,0049,-008,0053,0058,0058,0049,-008,0030,0030,0264,0264,0264],
	[0264,0264,0264,0264,0048,0058,0058,0058,0049,0024,-008,0030,0053,0049,0024,-008,0030,0030,0264,0264,0264],
	[0264,0264,0264,0264,0264,0264,0264,0264,0024,0024,-008,0030,0021,0017,0024,-008,0030,0030,0264,0264,0264],
	[0264,0264,0264,0264,0264,0264,0264,0264,0024,0024,-008,0021,0010,0010,0017,-008,0030,0030,0264,0264,0264],
	[0264,0264,0264,0264,0264,0264,0264,0264,0024,0024,-008,-008,-008,-008,-008,-008,0030,0030,0264,0264,0264],
	[0264,0264,0264,0264,0264,0264,0264,0264,0024,0048,0058,0058,0058,0049,-008,0053,0054,0030,0264,0264,0264],
	[0264,0264,0264,0264,0264,0264,0264,0264,0048,0058,0058,0058,0049,0024,-008,0030,0053,0054,0264,0264,0264],
	[0264,0264,0264,0264,0264,0264,0016,0010,0010,0010,0010,0010,0017,0024,-008,0030,0030,0264,0264,0264,0264],
	[0264,0264,0264,0264,0264,0264,0024,0016,0010,0010,0010,0010,0010,0017,-008,0030,0030,0264,0264,0264,0264],
	[0264,0264,0264,0264,0264,0264,0024,0024,-008,-008,-008,-008,-008,-008,-008,0030,0030,0264,0264,0264,0264],
	[0264,0264,0264,0016,0010,0010,0017,0024,-008,0053,0058,0058,0058,0049,-008,0030,0030,0264,0264,0264,0264],
	[0264,0264,0264,0024,0016,0111,0010,0017,-008,0030,0053,0058,0049,0024,-008,0030,0030,0264,0264,0264,0264],
	[0264,0264,0264,0024,0024,-008,-008,-008,-008,0030,0030,0264,0024,0024,-008,0030,0030,0264,0264,0264,0264],
	[0264,0264,0264,0024,0048,0058,0058,0058,0058,0054,0030,0264,0024,0024,-008,0030,0030,0264,0264,0264,0264],
	[0264,0264,0264,0048,0058,0058,0058,0058,0058,0058,0054,0264,0024,0048,0058,0054,0030,0264,0264,0264,0264],
	[0264,0264,0264,0264,0264,0264,0264,0264,0264,0264,0264,0264,0048,0058,0058,0058,0054,0264,0264,0264,0264],
	[0264,0264,0264,0264,0264,0264,0264,0264,0264,0264,0264,0264,0264,0264,0264,0264,0264,0264,0264,0264,0264],
	[0264,0264,0264,0264,0264,0264,0264,0264,0264,0264,0264,0264,0264,0264,0264,0264,0264,0264,0264,0264,0264]
	],
	"couche1": [
	[-001,-001,-001,-001,-001,-001,-001,-001,-001,-001,-001,-001,-001,-001,-001,-001,-001,-001,-001,-001,-001],
	[-001,-001,-001,-001,-001,-001,-001,-001,-001,-001,-001,-001,-001,-001,-001,-001,-001,-001,-001,-001,-001],
	[-001,-001,-001,-001,-001,-001,-001,-001,-001,-001,-001,-001,-001,-001,-001,-001,-001,-001,-001,-001,-001],
	[-001,-001,-001,-001,-001,-001,-001,-001,-001,-001,-001,-001,-001,-001,-001,-001,-001,-001,-001,-001,-001],
	[-001,-001,-001,-001,-001,-001,0052,0014,-001,-001,-001,-001,-001,-001,-001,-001,-001,-001,-001,-001,-001],
	[-001,-001,-001,-001,-001,-001,0014,-001,-001,-001,-001,-001,-001,-001,-001,-001,-001,-001,-001,-001,-001],
	[-001,-001,-001,-001,-001,-001,-001,-001,-001,-001,-001,-001,-001,-001,-001,-001,-001,-001,-001,-001,-001],
	[-001,-001,-001,-001,-001,-001,-001,-001,-001,-001,-001,-001,-001,-001,-001,-001,-001,-001,-001,-001,-001],
	[-001,-001,-001,-001,-001,-001,-001,-001,-001,-001,-001,-001,-001,-001,-001,-001,-001,-001,-001,-001,-001],
	[-001,-001,-001,-001,-001,-001,-001,-001,-001,-001,-001,-001,-001,-001,-001,-001,-001,-001,-001,-001,-001],
	[-001,-001,-001,-001,-001,-001,-001,-001,-001,-001,-001,-001,-001,-001,-001,-001,-001,-001,-001,-001,-001],
	[-001,-001,-001,-001,-001,-001,-001,-001,-001,-001,-001,-001,0014,0052,0014,-001,-001,-001,-001,-001,-001],
	[-001,-001,-001,-001,-001,-001,-001,-001,-001,-001,-001,-001,-001,-001,-001,-001,-001,-001,-001,-001,-001],
	[-001,-001,-001,-001,-001,-001,-001,-001,-001,-001,-001,-001,-001,-001,-001,-001,-001,-001,-001,-001,-001],
	[-001,-001,-001,-001,-001,-001,-001,-001,-001,-001,-001,-001,-001,-001,-001,-001,-001,-001,-001,-001,-001],
	[-001,-001,-001,-001,-001,-001,-001,-001,-001,-001,-001,-001,-001,-001,-001,-001,-001,-001,-001,-001,-001],
	[-001,-001,-001,-001,-001,-001,-001,-001,-001,-001,-001,-001,-001,-001,-001,-001,-001,-001,-001,-001,-001],
	[-001,-001,-001,-001,-001,-001,-001,-001,-001,-001,-001,-001,-001,-001,-001,-001,-001,-001,-001,-001,-001],
	[-001,-001,-001,-001,-001,-001,-001,-001,-001,-001,-001,-001,-001,-001,-001,-001,-001,-001,-001,-001,-001],
	[-001,-001,-001,-001,-001,-001,-001,-001,-001,-001,-001,-001,-001,-001,-001,-001,-001,-001,-001,-001,-001],
	[-001,-001,-001,-001,-001,-001,-001,-001,-001,-001,-001,-001,-001,-001,-001,-001,-001,-001,-001,-001,-001],
	[-001,-001,-001,-001,-001,-001,-001,-001,-001,-001,-001,0052,0014,-001,-001,-001,-001,-001,-001,-001,-001],
	[-001,-001,-001,-001,-001,-001,-001,-001,-001,-001,-001,-001,-001,-001,-001,-001,-001,-001,-001,-001,-001],
	[-001,-001,-001,-001,-001,-001,-001,-001,-001,-001,-001,-001,-001,-001,-001,-001,-001,-001,-001,-001,-001],
	[-001,-001,-001,-001,-001,-001,-001,-001,-001,-001,-001,-001,-001,-001,0014,-001,-001,-001,-001,-001,-001],
	[-001,-001,-001,-001,-001,-001,-001,-001,-001,-001,-001,-001,-001,-001,0052,-001,-001,-001,-001,-001,-001],
	[-001,-001,-001,-001,-001,-001,-001,-001,-001,-001,-001,-001,-001,-001,-001,-001,-001,-001,-001,-001,-001],
	[-001,-001,-001,-001,-001,-001,-001,-001,-001,-001,-001,-001,-001,-001,-001,-001,-001,-001,-001,-001,-001],
	[-001,-001,-001,-001,-001,-001,-001,-001,-001,-001,-001,-001,-001,-001,-001,-001,-001,-001,-001,-001,-001],
	[-001,-001,-001,-001,-001,-001,-001,-001,-001,-001,-001,-001,-001,-001,-001,-001,-001,-001,-001,-001,-001]
	],
	"couche2": [
	[-001,-001,-001,-001,-001,-001,-001,-001,-001,-001,-001,-001,-001,-001,-001,-001,-001,-001,-001,-001,-001],
	[-001,-001,-001,-001,-001,-001,-001,-001,-001,-001,-001,-001,-001,-001,-001,-001,-001,-001,-001,-001,-001],
	[-001,-001,-001,-001,-001,-001,-001,-001,-001,-001,-001,-001,-001,-001,-001,-001,-001,-001,-001,-001,-001],
	[-001,-001,-001,-001,-001,-001,-001,-001,-001,-001,-001,-001,-001,-001,-001,-001,-001,-001,-001,-001,-001],
	[-001,-001,-001,-001,-001,-001,-001,-001,-001,-001,-001,-001,-001,-001,-001,-001,-001,-001,-001,-001,-001],
	[-001,-001,-001,-001,-001,-001,-001,-001,-001,-001,-001,-001,-001,-001,-001,-001,-001,-001,-001,-001,-001],
	[-001,-001,-001,-001,-001,-001,-001,-001,-001,-001,-001,-001,-001,-001,-001,-001,-001,-001,-001,-001,-001],
	[-001,-001,-001,-001,-001,-001,-001,-001,-001,-001,-001,-001,-001,-001,-001,-001,-001,-001,-001,-001,-001],
	[-001,-001,-001,-001,-001,-001,-001,-001,-001,-001,-001,-001,-001,-001,-001,-001,-001,-001,-001,-001,-001],
	[-001,-001,-001,-001,-001,-001,-001,-001,-001,-001,-001,-001,-001,-001,-001,-001,-001,-001,-001,-001,-001],
	[-001,-001,-001,-001,-001,-001,-001,-001,-001,-001,-001,-001,-001,-001,-001,-001,-001,-001,-001,-001,-001],
	[-001,-001,-001,-001,-001,-001,-001,-001,-001,-001,-001,-001,-001,-001,-001,-001,-001,-001,-001,-001,-001],
	[-001,-001,-001,-001,-001,-001,-001,-001,-001,-001,-001,-001,-001,-001,-001,-001,-001,-001,-001,-001,-001],
	[-001,-001,-001,-001,-001,-001,-001,-001,-001,-001,-001,-001,-001,-001,-001,-001,-001,-001,-001,-001,-001],
	[-001,-001,-001,-001,-001,-001,-001,-001,-001,-001,-001,-001,-001,-001,-001,-001,-001,-001,-001,-001,-001],
	[-001,-001,-001,-001,-001,-001,-001,-001,-001,-001,-001,-001,-001,-001,-001,-001,-001,-001,-001,-001,-001],
	[-001,-001,-001,-001,-001,-001,-001,-001,-001,-001,-001,-001,-001,-001,-001,-001,-001,-001,-001,-001,-001],
	[-001,-001,-001,-001,-001,-001,-001,-001,-001,-001,-001,-001,-001,-001,-001,-001,-001,-001,-001,-001,-001],
	[-001,-001,-001,-001,-001,-001,-001,-001,-001,-001,-001,-001,-001,-001,-001,-001,-001,-001,-001,-001,-001],
	[-001,-001,-001,-001,-001,-001,-001,-001,-001,-001,-001,-001,-001,-001,-001,-001,-001,-001,-001,-001,-001],
	[-001,-001,-001,-001,-001,-001,-001,-001,-001,-001,-001,-001,-001,-001,-001,-001,-001,-001,-001,-001,-001],
	[-001,-001,-001,-001,-001,-001,-001,-001,-001,-001,-001,-001,-001,-001,-001,-001,-001,-001,-001,-001,-001],
	[-001,-001,-001,-001,-001,-001,-001,-001,-001,-001,-001,-001,-001,-001,-001,-001,-001,-001,-001,-001,-001],
	[-001,-001,-001,-001,-001,-001,-001,-001,-001,-001,-001,-001,-001,-001,-001,-001,-001,-001,-001,-001,-001],
	[-001,-001,-001,-001,-001,-001,-001,-001,-001,-001,-001,-001,-001,-001,-001,-001,-001,-001,-001,-001,-001],
	[-001,-001,-001,-001,-001,-001,-001,-001,-001,-001,-001,-001,-001,-001,-001,-001,-001,-001,-001,-001,-001],
	[-001,-001,-001,-001,-001,-001,-001,-001,-001,-001,-001,-001,-001,-001,-001,-001,-001,-001,-001,-001,-001],
	[-001,-001,-001,-001,-001,-001,-001,-001,-001,-001,-001,-001,-001,-001,-001,-001,-001,-001,-001,-001,-001],
	[-001,-001,-001,-001,-001,-001,-001,-001,-001,-001,-001,-001,-001,-001,-001,-001,-001,-001,-001,-001,-001],
	[-001,-001,-001,-001,-001,-001,-001,-001,-001,-001,-001,-001,-001,-001,-001,-001,-001,-001,-001,-001,-001]
	],
	"events": [
	{
		"id": 5,
		"nom": "Clone[021][004]",
		"x": 14,
		"y": 25
	},
	{
		"id": 6,
		"nom": "Clone[021][004]",
		"x": 6,
		"y": 6
	},
	{
		"id": 1,
		"nom": "EV001",
		"x": 5,
		"y": 23,
		"pages": [
		{
			"conditions": [
			{
				"nom": "ArriveeAuContact"
			}
			],
			"commandes": [
			{
				"nom": "EffacerImage",
				"numero": 9
			},
			{
				"nom": "ChangerDeMap",
				"variable": false,
				"numeroNouvelleMap": 43,
				"xDebutHeros": 29,
				"yDebutHeros": 25
			}
			],
			"vitesse": "moderee",
			"frequence": "basse",
			"animeEnMouvement": true,
			"animeALArret": false,
			"directionFixe": false,
			"traversable": false,
			"auDessusDeTout": false
		}
		]
	},
	{
		"id": 2,
		"nom": "EV002",
		"x": 9,
		"y": 0,
		"pages": [
		{
			"conditions": [
			{
				"nom": "ArriveeAuContact"
			}
			],
			"commandes": [
			{
				"nom": "EffacerImage",
				"numero": 9
			},
			{
				"nom": "ChangerDeMap",
				"variable": false,
				"numeroNouvelleMap": 660,
				"xDebutHeros": 10,
				"yDebutHeros": 13
			}
			],
			"vitesse": "moderee",
			"frequence": "basse",
			"animeEnMouvement": true,
			"animeALArret": false,
			"directionFixe": false,
			"traversable": false,
			"auDessusDeTout": false
		}
		]
	},
	{
		"id": 3,
		"nom": "Obscurité",
		"x": 11,
		"y": 0,
		"pages": [
		{
			"conditions": [
			],
			"commandes": [
			{
				"nom": "AppelerPageCommune",
				"numeroPageCommune": 84
			}
			],
			"vitesse": "moderee",
			"frequence": "basse",
			"animeEnMouvement": true,
			"animeALArret": false,
			"directionFixe": false,
			"traversable": false,
			"auDessusDeTout": false
		}
		]
	},
	{
		"id": 4,
		"nom": "Clone[021][004]",
		"x": 12,
		"y": 16
	}
	]
}
