{
	"nom": "Tunnel souche (entree)",
	"tileset": "Intestins",
	"largeur": 21,
	"hauteur": 15,
	"couche0": [
	[0264,0264,0264,0264,0264,0264,0264,0264,0264,0264,0264,0264,0264,0264,0264,0264,0264,0264,0264,0264,0264],
	[0264,0264,0264,0264,0264,0264,0264,0264,0264,0264,0264,0264,0264,0264,0264,0264,0264,0264,0264,0264,0264],
	[0264,0264,0264,0264,0264,0264,0264,0009,0010,0010,0010,0010,0010,0022,0264,0264,0264,0264,0264,0264,0264],
	[0264,0264,0264,0264,0264,0264,0009,0017,0009,0010,0010,0010,0022,0021,0022,0264,0264,0264,0264,0264,0264],
	[0264,0264,0264,0264,0264,0264,0024,0009,0017,0000,0000,0000,0021,0022,0030,0264,0264,0264,0264,0264,0264],
	[0264,0264,0264,0264,0264,0264,0024,0024,-007,0000,0000,0000,-007,0030,0030,0264,0264,0264,0264,0264,0264],
	[0264,0264,0264,0264,0264,0264,0024,0024,-007,0000,0000,0000,-007,0030,0030,0264,0264,0264,0264,0264,0264],
	[0264,0264,0264,0264,0264,0264,0024,0024,-007,-007,-007,-007,-007,0030,0030,0264,0264,0264,0264,0264,0264],
	[0264,0264,0264,0264,0264,0264,0024,0057,0049,-007,-007,-007,0053,0054,0030,0264,0264,0264,0264,0264,0264],
	[0264,0264,0264,0264,0264,0264,0057,0049,0057,0049,-008,0053,0054,0053,0054,0264,0264,0264,0264,0264,0264],
	[0264,0264,0264,0264,0264,0264,0264,0057,0049,0024,-008,0030,0053,0054,0264,0264,0264,0264,0264,0264,0264],
	[0264,0264,0264,0264,0264,0264,0264,0264,0024,0024,-008,0030,0030,0264,0264,0264,0264,0264,0264,0264,0264],
	[0264,0264,0264,0264,0264,0264,0264,0264,0024,0024,-008,0030,0030,0264,0264,0264,0264,0264,0264,0264,0264],
	[0264,0264,0264,0264,0264,0264,0264,0264,0024,0024,-008,0030,0030,0264,0264,0264,0264,0264,0264,0264,0264],
	[0264,0264,0264,0264,0264,0264,0264,0264,0024,0024,-008,0030,0030,0264,0264,0264,0264,0264,0264,0264,0264]
	],
	"couche1": [
	[-001,-001,-001,-001,-001,-001,-001,-001,-001,-001,-001,-001,-001,-001,-001,-001,-001,-001,-001,-001,-001],
	[-001,-001,-001,-001,-001,-001,-001,-001,-001,-001,-001,-001,-001,-001,-001,-001,-001,-001,-001,-001,-001],
	[-001,-001,-001,-001,-001,-001,-001,0348,0350,0345,-005,0344,0345,0349,-001,-001,-001,-001,-001,-001,-001],
	[-001,-001,-001,-001,-001,-001,0348,-001,0358,-001,-005,-001,-001,-001,0349,-001,-001,-001,-001,-001,-001],
	[-001,-001,-001,-001,-001,-001,0355,-001,-001,-001,-001,0052,-001,-001,0354,-001,-001,-001,-001,-001,-001],
	[-001,-001,-001,-001,-001,-001,0347,-001,-001,-001,-001,0014,0052,-001,0346,-001,-001,-001,-001,-001,-001],
	[-001,-001,-001,-001,-001,-001,-001,-001,0014,-001,-001,-001,0014,-001,-001,-001,-001,-001,-001,-001,-001],
	[-001,-001,-001,-001,-001,-001,0347,-001,0052,-001,-001,-001,-001,-001,0354,-001,-001,-001,-001,-001,-001],
	[-001,-001,-001,-001,-001,-001,0355,-001,-001,0014,-001,-001,-001,-001,0346,-001,-001,-001,-001,-001,-001],
	[-001,-001,-001,-001,-001,-001,0356,-001,-001,-001,-001,-001,-001,-001,0357,-001,-001,-001,-001,-001,-001],
	[-001,-001,-001,-001,-001,-001,-001,0356,-001,-001,-001,-001,-001,0357,-001,-001,-001,-001,-001,-001,-001],
	[-001,-001,-001,-001,-001,-001,-001,-001,0347,-001,-001,-001,0354,-001,-001,-001,-001,-001,-001,-001,-001],
	[-001,-001,-001,-001,-001,-001,-001,-001,-001,-001,-001,-001,0346,-001,-001,-001,-001,-001,-001,-001,-001],
	[-001,-001,-001,-001,-001,-001,-001,-001,0347,-001,-001,-001,-001,-001,-001,-001,-001,-001,-001,-001,-001],
	[-001,-001,-001,-001,-001,-001,-001,-001,0355,-001,-001,-001,0354,-001,-001,-001,-001,-001,-001,-001,-001]
	],
	"couche2": [
	[-001,-001,-001,-001,-001,-001,-001,-001,-001,-001,-001,-001,-001,-001,-001,-001,-001,-001,-001,-001,-001],
	[-001,-001,-001,-001,-001,-001,-001,-001,-001,-001,-001,-001,-001,-001,-001,-001,-001,-001,-001,-001,-001],
	[-001,-001,-001,-001,-001,-001,-001,-001,-001,-001,-001,-001,-001,-001,-001,-001,-001,-001,-001,-001,-001],
	[-001,-001,-001,-001,-001,-001,-001,-001,-001,-001,-001,-001,-001,-001,-001,-001,-001,-001,-001,-001,-001],
	[-001,-001,-001,-001,-001,-001,-001,-001,-001,-001,-001,-001,-001,-001,-001,-001,-001,-001,-001,-001,-001],
	[-001,-001,-001,-001,-001,-001,-001,-001,-001,-001,-001,-001,-001,-001,-001,-001,-001,-001,-001,-001,-001],
	[-001,-001,-001,-001,-001,-001,-001,-001,-001,-001,-001,-001,-001,-001,-001,-001,-001,-001,-001,-001,-001],
	[-001,-001,-001,-001,-001,-001,-001,-001,-001,-001,-001,-001,-001,-001,-001,-001,-001,-001,-001,-001,-001],
	[-001,-001,-001,-001,-001,-001,-001,-001,-001,-001,-001,-001,-001,-001,-001,-001,-001,-001,-001,-001,-001],
	[-001,-001,-001,-001,-001,-001,-001,-001,-001,-001,-001,-001,-001,-001,-001,-001,-001,-001,-001,-001,-001],
	[-001,-001,-001,-001,-001,-001,-001,-001,-001,-001,-001,-001,-001,-001,-001,-001,-001,-001,-001,-001,-001],
	[-001,-001,-001,-001,-001,-001,-001,-001,-001,-001,-001,-001,-001,-001,-001,-001,-001,-001,-001,-001,-001],
	[-001,-001,-001,-001,-001,-001,-001,-001,-001,-001,-001,-001,-001,-001,-001,-001,-001,-001,-001,-001,-001],
	[-001,-001,-001,-001,-001,-001,-001,-001,-001,-001,-001,-001,-001,-001,-001,-001,-001,-001,-001,-001,-001],
	[-001,-001,-001,-001,-001,-001,-001,-001,-001,-001,-001,-001,-001,-001,-001,-001,-001,-001,-001,-001,-001]
	],
	"events": [
	{
		"id": 5,
		"nom": "Clone[341][161]",
		"x": 11,
		"y": 6
	},
	{
		"id": 11,
		"nom": "Clone[341][163]",
		"x": 11,
		"y": 7
	},
	{
		"id": 6,
		"nom": "Clone[341][161]",
		"x": 10,
		"y": 7
	},
	{
		"id": 12,
		"nom": "Clone[341][163]",
		"x": 10,
		"y": 6
	},
	{
		"id": 1,
		"nom": "brouillard",
		"x": 13,
		"y": 3,
		"pages": [
		{
			"conditions": [
			],
			"commandes": [
			{
				"nom": "AppelerPageCommune",
				"numeroPageCommune": 85
			},
			{
				"nom": "ModifierBrouillard",
				"opacite": 200,
				"modeDeFusion": "normal",
				"defilementX": 0,
				"defilementY": 0,
				"zoom": 100,
				"nuance": 0,
				"nomImage": "tunnel souche"
			},
			{
				"nom": "SupprimerEvent"
			}
			],
			"vitesse": "moderee",
			"frequence": "basse",
			"animeEnMouvement": true,
			"animeALArret": false,
			"directionFixe": false,
			"traversable": false,
			"auDessusDeTout": false
		}
		]
	},
	{
		"id": 7,
		"nom": "Clone[341][161]",
		"x": 9,
		"y": 6
	},
	{
		"id": 13,
		"nom": "Clone[341][163]",
		"x": 12,
		"y": 6
	},
	{
		"id": 2,
		"nom": "EV002",
		"x": 10,
		"y": 2,
		"pages": [
		{
			"conditions": [
			{
				"nom": "ArriveeAuContact"
			}
			],
			"commandes": [
			{
				"nom": "ChangerDeMap",
				"variable": false,
				"numeroNouvelleMap": 146,
				"xDebutHeros": 31,
				"yDebutHeros": 25
			}
			],
			"vitesse": "moderee",
			"frequence": "basse",
			"animeEnMouvement": true,
			"animeALArret": false,
			"directionFixe": false,
			"traversable": false,
			"auDessusDeTout": false
		}
		]
	},
	{
		"id": 8,
		"nom": "Clone[341][163]",
		"x": 11,
		"y": 5
	},
	{
		"id": 14,
		"nom": "Clone[341][163]",
		"x": 8,
		"y": 6
	},
	{
		"id": 3,
		"nom": "Clone[341][161]",
		"x": 10,
		"y": 5
	},
	{
		"id": 9,
		"nom": "Clone[341][163]",
		"x": 9,
		"y": 5
	},
	{
		"id": 4,
		"nom": "EV004",
		"x": 10,
		"y": 14,
		"pages": [
		{
			"conditions": [
			{
				"nom": "ArriveeAuContact"
			}
			],
			"commandes": [
			{
				"nom": "EffacerImage",
				"numero": 9
			},
			{
				"nom": "ChangerDeMap",
				"variable": false,
				"numeroNouvelleMap": 663,
				"xDebutHeros": 10,
				"yDebutHeros": 1
			}
			],
			"vitesse": "moderee",
			"frequence": "basse",
			"animeEnMouvement": true,
			"animeALArret": false,
			"directionFixe": false,
			"traversable": false,
			"auDessusDeTout": false
		}
		]
	},
	{
		"id": 10,
		"nom": "Clone[341][163]",
		"x": 9,
		"y": 7
	}
	]
}
