{
	"nom": "Tunnel souche (suite)",
	"tileset": "Intestins",
	"largeur": 21,
	"hauteur": 30,
	"musique": {
		"nomFichierSonore": "",
		"volume": 1.00,
		"tempo": 1.00
	},
	"fondSonore": {
		"nomFichierSonore": "",
		"volume": 0.80,
		"tempo": 1.00
	},
	"couche0": [
	[0264,0264,0264,0264,0264,0264,0264,0264,0024,0024,-008,0030,0030,0264,0264,0264,0264,0264,0264,0264,0264],
	[0264,0264,0264,0264,0264,0264,0264,0264,0024,0024,-008,0030,0030,0264,0264,0264,0264,0264,0264,0264,0264],
	[0264,0264,0264,0264,0264,0264,0264,0264,0024,0024,-008,0030,0030,0264,0264,0264,0264,0264,0264,0264,0264],
	[0264,0264,0264,0009,0010,0010,0010,0010,0017,0024,-008,0030,0021,0010,0010,0010,0010,0022,0264,0264,0264],
	[0264,0264,0264,0024,0009,0010,0010,0010,0010,0017,-008,0021,0010,0010,0010,0010,0022,0030,0264,0264,0264],
	[0264,0264,0264,0024,0024,-008,-008,-008,-008,-008,-008,-008,-008,-008,-008,-008,0030,0030,0264,0264,0264],
	[0264,0264,0264,0024,0024,-008,0053,0058,0058,0058,0058,0058,0058,0058,0049,-008,0030,0030,0264,0264,0264],
	[0264,0264,0264,0024,0024,-008,0030,0053,0058,0058,0058,0058,0058,0049,0024,-008,0030,0030,0264,0264,0264],
	[0009,0010,0010,0017,0024,-008,0030,0021,0010,0022,0264,0009,0010,0017,0024,-008,0030,0021,0010,0010,0022],
	[0024,0009,0010,0010,0017,-008,0021,0010,0022,0030,0264,0024,0009,0010,0017,-008,0021,0010,0010,0022,0030],
	[0024,0024,-008,-008,-008,-008,-008,-008,0030,0030,0264,0024,0024,-008,-008,-008,-008,-008,-008,0030,0030],
	[0024,0024,-008,0053,0058,0058,0049,-008,0030,0030,0264,0024,0024,-008,0053,0058,0058,0049,-008,0030,0030],
	[0024,0024,-008,0030,0053,0049,0024,-008,0030,0021,0010,0017,0024,-008,0030,0053,0049,0024,-008,0030,0030],
	[0024,0024,-008,0030,0030,0024,0024,-008,0021,0010,0010,0010,0017,-008,0030,0030,0024,0024,-008,0030,0030],
	[0024,0024,-008,0030,0030,0024,0024,-007,-007,-007,-007,-007,-007,-007,0030,0030,0024,0024,-008,0030,0030],
	[0024,0024,-008,0030,0030,0024,0024,-007,0053,0058,0058,0058,0049,-007,0030,0030,0024,0024,-008,0030,0030],
	[0024,0024,-008,0030,0030,0024,0024,-007,0030,0053,0058,0049,0024,-007,0030,0030,0024,0024,-008,0030,0030],
	[0024,0024,-008,0030,0030,0024,0024,-007,0030,0021,0010,0017,0024,-007,0030,0030,0024,0024,-008,0030,0030],
	[0024,0024,-008,0030,0030,0024,0024,-007,0021,0010,0010,0010,0017,-007,0030,0030,0024,0024,-008,0030,0030],
	[0024,0024,-008,0030,0030,0024,0024,-007,-007,-007,-007,-007,-007,-007,0030,0030,0024,0024,-008,0030,0030],
	[0024,0024,-008,0030,0030,0024,0057,0058,0058,0058,0058,0058,0058,0058,0054,0030,0024,0024,-008,0030,0030],
	[0024,0024,-008,0030,0030,0057,0058,0058,0058,0058,0058,0058,0058,0058,0058,0054,0024,0024,-008,0030,0030],
	[0024,0024,-008,0030,0021,0010,0010,0010,0010,0010,0010,0010,0010,0010,0010,0010,0017,0024,-008,0030,0030],
	[0024,0024,-008,0021,0010,0010,0010,0010,0010,0010,0010,0010,0010,0010,0010,0010,0010,0017,-008,0030,0030],
	[0024,0024,-008,-008,-008,-008,-007,-007,-007,0000,0000,0000,-007,-007,-007,-008,-008,-008,-008,0030,0030],
	[0024,0057,0058,0058,0058,0058,0058,0058,0049,0000,0000,0000,0053,0058,0058,0058,0058,0058,0058,0054,0030],
	[0057,0058,0058,0058,0058,0058,0058,0049,0057,0058,0118,0058,0054,0053,0058,0058,0058,0058,0058,0058,0054],
	[0264,0264,0264,0264,0264,0264,0264,0057,0058,0058,0058,0058,0058,0054,0264,0264,0264,0264,0264,0264,0264],
	[0264,0264,0264,0264,0264,0264,0264,0264,0264,0264,0264,0264,0264,0264,0264,0264,0264,0264,0264,0264,0264],
	[0264,0264,0264,0264,0264,0264,0264,0264,0264,0264,0264,0264,0264,0264,0264,0264,0264,0264,0264,0264,0264]
	],
	"couche1": [
	[-001,-001,-001,-001,-001,-001,-001,-001,0355,-001,-001,-001,0346,-001,-001,-001,-001,-001,-001,-001,-001],
	[-001,-001,-001,-001,-001,-001,-001,-001,0355,-001,-001,-001,0354,-001,-001,-001,-001,-001,-001,-001,-001],
	[-001,-001,-001,-001,-001,-001,-001,-001,0347,-001,-001,-001,-001,-001,-001,-001,-001,-001,-001,-001,-001],
	[-001,-001,-001,0348,0344,0345,-001,0345,-001,-001,-001,-001,-001,0350,0344,0345,0344,0349,-001,-001,-001],
	[-001,-001,-001,0355,-001,-001,-001,-001,-001,-001,-001,-001,-001,0358,-001,-001,-001,-001,-001,-001,-001],
	[-001,-001,-001,-001,-001,0014,0052,-001,-001,-001,-001,-001,-001,0014,0052,-001,-001,-001,-001,-001,-001],
	[-001,-001,-001,0347,-001,0052,-001,-001,-001,-001,-001,0351,-001,-001,-001,-001,-001,0346,-001,-001,-001],
	[-001,-001,-001,0355,-001,0014,-001,-001,0352,0353,0352,0359,0352,-001,-001,-001,-001,0354,-001,-001,-001],
	[0348,0344,0345,-001,-001,-001,-001,-001,0350,0349,-001,0348,0344,-001,-001,-001,-001,-001,0344,0345,0349],
	[0347,-001,-001,-001,-001,-001,-001,-001,0358,0346,-001,0355,-001,-001,-001,-001,-001,-001,-001,-001,0346],
	[0355,-001,-001,-001,-001,-001,-001,-001,-001,0354,-001,0347,-001,-001,-001,-001,-001,-001,-001,-001,0354],
	[-001,-001,-001,-001,-001,-001,-001,-001,-001,0354,-001,0347,-001,-001,-001,-001,-001,-001,-001,-001,-001],
	[0347,-001,-001,-001,-001,-001,-001,-001,-001,-001,0350,-001,-001,-001,-001,-001,-001,-001,-001,-001,-001],
	[0347,-001,-001,-001,-001,-001,-001,-001,-001,-001,0358,-001,-001,-001,-001,-001,-001,-001,-001,-001,0354],
	[-001,-001,-001,-001,-001,-001,-001,-001,-001,0014,-001,-001,-001,-001,-001,-001,-001,-001,-001,-001,0346],
	[-001,-001,-001,-001,-001,-001,-001,-001,-001,-001,-001,-001,-001,0014,-001,-001,-001,-001,-001,-001,0354],
	[-001,-001,-001,-001,-001,-001,-001,-001,-001,-001,-001,-001,-001,0052,-001,-001,-001,-001,-001,-001,-001],
	[-001,-001,-001,-001,-001,-001,-001,0052,-001,-001,-001,-001,-001,-001,-001,-001,-001,-001,-001,-001,0354],
	[-001,-001,0014,-001,-001,-001,-001,0014,-001,-001,-001,-001,-001,-001,-001,-001,-001,-001,-001,-001,0346],
	[-001,-001,0052,-001,-001,-001,-001,-001,-001,-001,-001,-001,0014,-001,-001,-001,-001,-001,-001,-001,-001],
	[-001,-001,-001,-001,-001,-001,-001,-001,-001,-001,-001,-001,-001,-001,-001,-001,-001,-001,-001,-001,-001],
	[-001,-001,0014,-001,-001,-001,-001,-001,-001,-001,-001,-001,-001,-001,-001,-001,-001,-001,-001,-001,-001],
	[0347,-001,-001,-001,-001,-001,-001,-001,-001,-001,-001,-001,-001,-001,-001,-001,-001,-001,0014,-001,-001],
	[-001,-001,-001,-001,-001,-001,-001,-001,-001,-001,-001,-001,-001,-001,-001,-001,-001,-001,0052,-001,-001],
	[0347,-001,-001,-001,-001,-001,-001,-001,-001,-001,-001,-001,-001,-001,-001,-001,-001,0014,0014,-001,0346],
	[0355,-001,-001,0351,-001,-001,-001,-001,-001,-001,-001,-001,-001,-001,-001,-001,-001,-001,0351,-001,0354],
	[0356,0353,0352,0359,-001,0352,0353,-001,-001,0351,-001,-001,-001,-001,0352,0353,-001,0352,0359,0353,0357],
	[-001,-001,-001,-001,-001,-001,-001,0356,0352,0359,0352,-001,0352,0357,-001,-001,-001,-001,-001,-001,-001],
	[-001,-001,-001,-001,-001,-001,-001,-001,-001,-001,-001,-001,-001,-001,-001,-001,-001,-001,-001,-001,-001],
	[-001,-001,-001,-001,-001,-001,-001,-001,-001,-001,-001,-001,-001,-001,-001,-001,-001,-001,-001,-001,-001]
	],
	"couche2": [
	[-001,-001,-001,-001,-001,-001,-001,-001,-001,-001,-001,-001,-001,-001,-001,-001,-001,-001,-001,-001,-001],
	[-001,-001,-001,-001,-001,-001,-001,-001,-001,-001,-001,-001,-001,-001,-001,-001,-001,-001,-001,-001,-001],
	[-001,-001,-001,-001,-001,-001,-001,-001,-001,-001,-001,-001,-001,-001,-001,-001,-001,-001,-001,-001,-001],
	[-001,-001,-001,-001,-001,-001,-001,-001,-001,-001,-001,-001,-001,-001,-001,-001,-001,-001,-001,-001,-001],
	[-001,-001,-001,-001,-001,-001,-001,-001,-001,-001,-001,-001,-001,-001,-001,-001,-001,-001,-001,-001,-001],
	[-001,-001,-001,-001,-001,-001,-001,-001,-001,-001,-001,-001,-001,-001,-001,-001,-001,-001,-001,-001,-001],
	[-001,-001,-001,-001,-001,-001,-001,-001,-001,-001,-001,-001,-001,-001,-001,-001,-001,-001,-001,-001,-001],
	[-001,-001,-001,-001,-001,-001,-001,-001,-001,-001,-001,-001,-001,-001,-001,-001,-001,-001,-001,-001,-001],
	[-001,-001,-001,-001,-001,-001,-001,-001,-001,-001,-001,-001,-001,-001,-001,-001,-001,-001,-001,-001,-001],
	[-001,-001,-001,-001,-001,-001,-001,-001,-001,-001,-001,-001,-001,-001,-001,-001,-001,-001,-001,-001,-001],
	[-001,-001,-001,-001,-001,-001,-001,-001,-001,-001,-001,-001,-001,-001,-001,-001,-001,-001,-001,-001,-001],
	[-001,-001,-001,-001,-001,-001,-001,-001,-001,-001,-001,-001,-001,-001,-001,-001,-001,-001,-001,-001,-001],
	[-001,-001,-001,-001,-001,-001,-001,-001,-001,-001,-001,-001,-001,-001,-001,-001,-001,-001,-001,-001,-001],
	[-001,-001,-001,-001,-001,-001,-001,-001,-001,-001,-001,-001,-001,-001,-001,-001,-001,-001,-001,-001,-001],
	[-001,-001,-001,-001,-001,-001,-001,-001,-001,-001,-001,-001,-001,-001,-001,-001,-001,-001,-001,-001,-001],
	[-001,-001,-001,-001,-001,-001,-001,-001,-001,-001,-001,-001,-001,-001,-001,-001,-001,-001,-001,-001,-001],
	[-001,-001,-001,-001,-001,-001,-001,-001,-001,-001,-001,-001,-001,-001,-001,-001,-001,-001,-001,-001,-001],
	[-001,-001,-001,-001,-001,-001,-001,-001,-001,-001,-001,-001,-001,-001,-001,-001,-001,-001,-001,-001,-001],
	[-001,-001,-001,-001,-001,-001,-001,-001,-001,-001,-001,-001,-001,-001,-001,-001,-001,-001,-001,-001,-001],
	[-001,-001,-001,-001,-001,-001,-001,-001,-001,-001,-001,-001,-001,-001,-001,-001,-001,-001,-001,-001,-001],
	[-001,-001,-001,-001,-001,-001,-001,-001,-001,-001,-001,-001,-001,-001,-001,-001,-001,-001,-001,-001,-001],
	[-001,-001,-001,-001,-001,-001,-001,-001,-001,-001,-001,-001,-001,-001,-001,-001,-001,-001,-001,-001,-001],
	[-001,-001,-001,-001,-001,-001,-001,-001,-001,-001,-001,-001,-001,-001,-001,-001,-001,-001,-001,-001,-001],
	[-001,-001,-001,-001,-001,-001,-001,-001,-001,-001,-001,-001,-001,-001,-001,-001,-001,-001,-001,-001,-001],
	[-001,-001,-001,-001,-001,-001,-001,-001,-001,-001,-001,-001,-001,-001,-001,-001,-001,-001,-001,-001,-001],
	[-001,-001,-001,-001,-001,-001,-001,-001,-001,-001,-001,-001,-001,-001,-001,-001,-001,-001,-001,-001,-001],
	[-001,-001,-001,-001,-001,-001,-001,-001,-001,-001,-001,-001,-001,-001,-001,-001,-001,-001,-001,-001,-001],
	[-001,-001,-001,-001,-001,-001,-001,-001,-001,-001,-001,-001,-001,-001,-001,-001,-001,-001,-001,-001,-001],
	[-001,-001,-001,-001,-001,-001,-001,-001,-001,-001,-001,-001,-001,-001,-001,-001,-001,-001,-001,-001,-001],
	[-001,-001,-001,-001,-001,-001,-001,-001,-001,-001,-001,-001,-001,-001,-001,-001,-001,-001,-001,-001,-001]
	],
	"events": [
	{
		"id": 5,
		"nom": "Clone[021][004]",
		"x": 18,
		"y": 16
	},
	{
		"id": 6,
		"nom": "Clone[021][004]",
		"x": 2,
		"y": 17
	},
	{
		"id": 1,
		"nom": "EV001",
		"x": 10,
		"y": 26,
		"pages": [
		{
			"conditions": [
			{
				"nom": "ArriveeAuContact"
			}
			],
			"commandes": [
			{
				"nom": "EffacerImage",
				"numero": 9
			},
			{
				"nom": "ChangerDeMap",
				"variable": false,
				"numeroNouvelleMap": 151,
				"xDebutHeros": 34,
				"yDebutHeros": 10
			}
			],
			"vitesse": "moderee",
			"frequence": "basse",
			"animeEnMouvement": true,
			"animeALArret": false,
			"directionFixe": false,
			"traversable": false,
			"auDessusDeTout": false
		}
		]
	},
	{
		"id": 7,
		"nom": "Clone[021][004]",
		"x": 18,
		"y": 17
	},
	{
		"id": 2,
		"nom": "EV002",
		"x": 10,
		"y": 0,
		"pages": [
		{
			"conditions": [
			{
				"nom": "ArriveeAuContact"
			}
			],
			"commandes": [
			{
				"nom": "EffacerImage",
				"numero": 9
			},
			{
				"nom": "ChangerDeMap",
				"variable": false,
				"numeroNouvelleMap": 662,
				"xDebutHeros": 10,
				"yDebutHeros": 13
			}
			],
			"vitesse": "moderee",
			"frequence": "basse",
			"animeEnMouvement": true,
			"animeALArret": false,
			"directionFixe": false,
			"traversable": false,
			"auDessusDeTout": false
		}
		]
	},
	{
		"id": 8,
		"nom": "Clone[021][004]",
		"x": 10,
		"y": 19
	},
	{
		"id": 3,
		"nom": "Obscurité",
		"x": 12,
		"y": 0,
		"pages": [
		{
			"conditions": [
			],
			"commandes": [
			{
				"nom": "AppelerPageCommune",
				"numeroPageCommune": 84
			}
			],
			"vitesse": "moderee",
			"frequence": "basse",
			"animeEnMouvement": true,
			"animeALArret": false,
			"directionFixe": false,
			"traversable": false,
			"auDessusDeTout": false
		}
		]
	},
	{
		"id": 4,
		"nom": "Clone[021][004]",
		"x": 2,
		"y": 16
	}
	]
}
