{
	"nom": "Cabane",
	"tileset": "Maison",
	"largeur": 21,
	"hauteur": 15,
	"musique": {
		"nomFichierSonore": "Maison vicking 2.ogg",
		"volume": 1.00,
		"tempo": 1.00
	},
	"fondSonore": {
		"nomFichierSonore": "001-Wind01.ogg",
		"volume": 0.00,
		"tempo": 1.00
	},
	"couche0": [
	[0017,0017,0017,0017,0017,0017,0017,0017,0017,0017,0017,0017,0017,0017,0017,0017,0017,0017,0017,0017,0017],
	[0017,0017,0017,0017,0017,0017,0017,0017,0017,0017,0017,0017,0017,0017,0017,0017,0017,0017,0017,0017,0017],
	[0017,0017,0017,0017,0017,0017,0017,0017,0017,0017,0017,0017,0017,0017,0017,0017,0017,0017,0017,0017,0017],
	[0017,0017,0017,0017,0017,0340,0341,0308,0309,0308,0309,0308,0309,0308,0342,0343,0017,0017,0017,0017,0017],
	[0017,0017,0017,0017,0017,0348,0349,0316,0317,0316,0317,0316,0317,0316,0350,0351,0017,0017,0017,0017,0017],
	[0017,0017,0017,0017,0017,0324,0325,0000,0000,0000,0000,0000,0000,0000,0310,0311,0017,0017,0017,0017,0017],
	[0017,0017,0017,0017,0017,0332,0333,0000,0000,0000,0000,0000,0000,0000,0318,0319,0017,0017,0017,0017,0017],
	[0017,0017,0017,0017,0017,0324,0325,0301,0000,0000,0000,0000,0000,0000,0310,0311,0017,0017,0017,0017,0017],
	[0017,0017,0017,0017,0017,0332,0333,0000,0000,0000,0000,0000,0000,0000,0318,0319,0017,0017,0017,0017,0017],
	[0017,0017,0017,0017,0017,0324,0325,0000,0000,0000,0000,0000,0000,0000,0310,0311,0017,0017,0017,0017,0017],
	[0017,0017,0017,0017,0017,0356,0357,0326,0327,0384,0023,0386,0327,0326,0358,0359,0017,0017,0017,0017,0017],
	[0017,0017,0017,0017,0017,0364,0365,0334,0335,0392,0393,0394,0335,0334,0366,0367,0017,0017,0017,0017,0017],
	[0017,0017,0017,0017,0017,0017,0017,0017,0017,0017,0017,0017,0017,0017,0017,0017,0017,0017,0017,0017,0017],
	[0017,0017,0017,0017,0017,0017,0017,0017,0017,0017,0017,0017,0017,0017,0017,0017,0017,0017,0017,0017,0017],
	[0017,0017,0017,0017,0017,0017,0017,0017,0017,0017,0017,0017,0017,0017,0017,0017,0017,0017,0017,0017,0017]
	],
	"couche1": [
	[-001,-001,-001,-001,-001,-001,-001,-001,-001,-001,-001,-001,-001,-001,-001,-001,-001,-001,-001,-001,-001],
	[-001,-001,-001,-001,-001,-001,-001,-001,-001,-001,-001,-001,-001,-001,-001,-001,-001,-001,-001,-001,-001],
	[-001,-001,-001,-001,-001,-001,-001,-001,-001,-001,-001,-001,-001,-001,-001,-001,-001,-001,-001,-001,-001],
	[-001,-001,-001,-001,-001,0658,0659,0028,0029,-001,0050,-001,-001,-001,-001,-001,-001,-001,-001,-001,-001],
	[-001,-001,-001,-001,-001,0666,0667,0036,0037,-001,0058,-001,-001,-001,-001,-001,-001,-001,-001,-001,-001],
	[-001,-001,-001,-001,-001,-001,-001,0044,0045,-001,-001,0002,0030,0031,-001,-001,-001,-001,-001,-001,-001],
	[-001,-001,-001,-001,-001,0555,0556,-001,-001,-001,-001,-001,0038,0039,-001,-001,-001,-001,-001,-001,-001],
	[-001,-001,-001,-001,-001,0563,0564,-001,0005,0007,-001,-001,0046,0047,-001,-001,-001,-001,-001,-001,-001],
	[-001,-001,-001,-001,-001,0571,0572,-001,0013,0015,-001,-001,-001,-001,-001,-001,-001,-001,-001,-001,-001],
	[-001,-001,-001,-001,-001,-001,-001,-001,-001,-001,-001,-001,-001,-001,-001,-001,-001,-001,-001,-001,-001],
	[-001,-001,-001,-001,-001,-001,-001,-001,-001,-001,-001,-001,-001,-001,0662,0663,-001,-001,-001,-001,-001],
	[-001,-001,-001,-001,-001,-001,-001,-001,-001,-001,-001,-001,-001,-001,0670,0671,-001,-001,-001,-001,-001],
	[-001,-001,-001,-001,-001,-001,-001,-001,-001,-001,-001,-001,-001,-001,-001,-001,-001,-001,-001,-001,-001],
	[-001,-001,-001,-001,-001,-001,-001,-001,-001,-001,-001,-001,-001,-001,-001,-001,-001,-001,-001,-001,-001],
	[-001,-001,-001,-001,-001,-001,-001,-001,-001,-001,-001,-001,-001,-001,-001,-001,-001,-001,-001,-001,-001]
	],
	"couche2": [
	[-001,-001,-001,-001,-001,-001,-001,-001,-001,-001,-001,-001,-001,-001,-001,-001,-001,-001,-001,-001,-001],
	[-001,-001,-001,-001,-001,-001,-001,-001,-001,-001,-001,-001,-001,-001,-001,-001,-001,-001,-001,-001,-001],
	[-001,-001,-001,-001,-001,-001,-001,-001,-001,-001,-001,-001,-001,-001,-001,-001,-001,-001,-001,-001,-001],
	[-001,-001,-001,-001,-001,-001,-001,-001,-001,-001,-001,-001,-001,-001,-001,-001,-001,-001,-001,-001,-001],
	[-001,-001,-001,-001,-001,-001,-001,-001,-001,-001,-001,-001,-001,-001,-001,-001,-001,-001,-001,-001,-001],
	[-001,-001,-001,-001,-001,-001,-001,-001,-001,-001,-001,-001,-001,-001,-001,-001,-001,-001,-001,-001,-001],
	[-001,-001,-001,-001,-001,-001,-001,-001,-001,-001,-001,-001,-001,-001,-001,-001,-001,-001,-001,-001,-001],
	[-001,-001,-001,-001,-001,-001,-001,-001,-001,-001,-001,-001,-001,-001,-001,-001,-001,-001,-001,-001,-001],
	[-001,-001,-001,-001,-001,-001,-001,-001,-001,-001,-001,-001,-001,-001,-001,-001,-001,-001,-001,-001,-001],
	[-001,-001,-001,-001,-001,-001,-001,-001,-001,-001,-001,-001,-001,-001,-001,-001,-001,-001,-001,-001,-001],
	[-001,-001,-001,-001,-001,-001,-001,-001,-001,-001,-001,-001,-001,-001,-001,-001,-001,-001,-001,-001,-001],
	[-001,-001,-001,-001,-001,-001,-001,-001,-001,-001,-001,-001,-001,-001,-001,-001,-001,-001,-001,-001,-001],
	[-001,-001,-001,-001,-001,-001,-001,-001,-001,-001,-001,-001,-001,-001,-001,-001,-001,-001,-001,-001,-001],
	[-001,-001,-001,-001,-001,-001,-001,-001,-001,-001,-001,-001,-001,-001,-001,-001,-001,-001,-001,-001,-001],
	[-001,-001,-001,-001,-001,-001,-001,-001,-001,-001,-001,-001,-001,-001,-001,-001,-001,-001,-001,-001,-001]
	],
	"events": [
	{
		"id": 5,
		"nom": "Clone[341][008]",
		"x": 9,
		"y": 5
	},
	{
		"id": 6,
		"nom": "Clone[341][165]",
		"x": 9,
		"y": 7
	},
	{
		"id": 1,
		"nom": "Clone[341][004]",
		"x": 13,
		"y": 8
	},
	{
		"id": 7,
		"nom": "Fiolin",
		"x": 12,
		"y": 6,
		"pages": [
		{
			"conditions": [
			{
				"nom": "Parler"
			}
			],
			"commandes": [
			{
				"nom": "ModifierInterrupteur",
				"numeroInterrupteur": 12,
				"valeur": true
			},
			{
				"nom": "AppelerUnScript",
				"script": "$game_temp.faceset = \"fiolin\""
			},
			{
				"nom": "Message",
				"texte": "Je viens ici pour m'entrainer à jouer."
			},
			{
				"nom": "Message",
				"texte": "Je peux même jouer le Ranz des vaches, \\nalors qu'il est interdit de jouer ce morceau."
			},
			{
				"nom": "Message",
				"texte": "Quand les Vikings l'entendent, \\nils se rappellent leur contrée natale, \\net ça les fait pleurer."
			},
			{
				"nom": "AppelerUnScript",
				"script": "$game_temp.faceset = \"fiolin moqueur\""
			},
			{
				"nom": "Message",
				"texte": "Ici, je peux jouer ça tranquillement sans finir \\nprivé de dessert ou écartelé."
			},
			{
				"nom": "Attendre",
				"nombreDeFrames": 8
			},
			{
				"nom": "ModifierInterrupteur",
				"numeroInterrupteur": 12,
				"valeur": false
			}
			],
			"image": "Fiolin + mandoline character",
			"vitesse": "moderee",
			"frequence": "basse",
			"animeEnMouvement": false,
			"animeALArret": true,
			"directionFixe": false,
			"traversable": false,
			"auDessusDeTout": false
		}
		]
	},
	{
		"id": 2,
		"nom": "Clone[341][004]",
		"x": 13,
		"y": 9
	},
	{
		"id": 8,
		"nom": "EV008",
		"x": 12,
		"y": 3,
		"pages": [
		{
			"conditions": [
			],
			"commandes": [
			{
				"nom": "ModifierInterrupteur",
				"numeroInterrupteur": 91,
				"valeur": true
			},
			{
				"nom": "SupprimerEvent"
			}
			],
			"vitesse": "moderee",
			"frequence": "basse",
			"animeEnMouvement": true,
			"animeALArret": false,
			"directionFixe": false,
			"traversable": false,
			"auDessusDeTout": false
		}
		]
	},
	{
		"id": 3,
		"nom": "Clone[341][004]",
		"x": 12,
		"y": 9
	},
	{
		"id": 9,
		"nom": "EV009",
		"x": 12,
		"y": 11,
		"pages": [
		{
			"conditions": [
			],
			"commandes": [
			{
				"nom": "ModifierMeteo",
				"type": "rien",
				"intensite": 5
			},
			{
				"nom": "ModifierInterrupteur",
				"numeroInterrupteur": 36,
				"valeur": false
			},
			{
				"nom": "AppelerPageCommune",
				"numeroPageCommune": 55
			},
			{
				"nom": "SupprimerEvent"
			}
			],
			"vitesse": "moderee",
			"frequence": "basse",
			"animeEnMouvement": true,
			"animeALArret": false,
			"directionFixe": false,
			"traversable": false,
			"auDessusDeTout": false
		}
		]
	},
	{
		"id": 4,
		"nom": "Clone[341][004]",
		"x": 12,
		"y": 8
	},
	{
		"id": 10,
		"nom": "EV010",
		"x": 10,
		"y": 11,
		"pages": [
		{
			"conditions": [
			{
				"nom": "ArriveeAuContact"
			}
			],
			"commandes": [
			{
				"nom": "ChangerDeMap",
				"variable": false,
				"numeroNouvelleMap": 665,
				"xDebutHeros": 20,
				"yDebutHeros": 4
			}
			],
			"vitesse": "moderee",
			"frequence": "basse",
			"animeEnMouvement": true,
			"animeALArret": false,
			"directionFixe": false,
			"traversable": false,
			"auDessusDeTout": false
		}
		]
	}
	]
}
