{
	"nom": "Vers le 3e mammouth",
	"tileset": "Zone Enneigée",
	"largeur": 21,
	"hauteur": 15,
	"musique": {
		"nomFichierSonore": "",
		"volume": 1.00,
		"tempo": 1.00
	},
	"fondSonore": {
		"nomFichierSonore": "",
		"volume": 0.80,
		"tempo": 1.00
	},
	"couche0": [
	[0168,0168,0168,0168,0176,0170,0170,0170,0170,0170,0170,0170,0170,0180,0168,0168,0168,0168,0168,0168,0168],
	[0168,0168,0176,0170,0177,0009,0010,0010,0010,0010,0010,0010,0013,0179,0170,0170,0180,0168,0168,0168,0168],
	[0168,0168,0184,0009,0010,0017,0000,0009,0010,0003,0010,0013,0021,0010,0010,0013,0179,0170,0180,0168,0168],
	[0168,0168,0184,0024,0052,0000,0000,0024,0000,0000,0000,0021,0010,0010,0013,0021,0010,0013,0188,0168,0168],
	[0168,0168,0184,0024,0000,0000,0000,0024,0000,0000,0000,0000,0000,0000,0021,0010,0013,0030,0188,0168,0168],
	[0168,0168,0184,0024,0000,0009,0018,0017,0000,0000,0000,0000,0000,0000,0000,0000,0030,0030,0188,0168,0168],
	[0168,0168,0184,0024,0000,0024,0000,0000,0000,0189,0190,0000,0000,0000,0008,0000,0030,0030,0188,0168,0168],
	[0168,0168,0184,0024,0000,0024,0189,0190,0189,0190,0000,0000,0000,0000,0000,0000,0030,0030,0188,0168,0168],
	[0168,0168,0184,0024,0000,0024,0000,0000,0000,0000,0000,0000,0008,0000,0000,0000,0030,0030,0188,0168,0168],
	[0168,0168,0184,0024,0000,0057,0058,0058,0058,0058,0049,0000,0000,0000,0000,0053,0054,0030,0188,0168,0168],
	[0168,0168,0184,0024,0000,0053,0058,0058,0049,0000,0057,0058,0049,0000,0053,0054,0053,0054,0188,0168,0168],
	[0168,0168,0184,0024,0000,0030,0189,0190,0057,0058,0058,0049,0024,0000,0030,0053,0054,0195,0196,0168,0168],
	[0168,0168,0184,0024,0000,0030,0195,0202,0202,0202,0193,0024,0024,0000,0030,0030,0195,0196,0168,0168,0168],
	[0168,0168,0184,0024,0000,0037,0188,-001,0168,0168,0184,0024,0024,0000,0030,0030,0188,0168,0168,0168,0168],
	[0168,0168,0184,0024,0000,0030,0188,-001,0168,0168,0184,0024,0024,0000,0030,0030,0188,0168,0168,0168,0168]
	],
	"couche1": [
	[-001,-001,-001,-001,-001,-001,-001,-001,-001,-001,-001,-001,-001,-001,-001,-001,-001,-001,-001,-001,-001],
	[-001,-001,-001,-001,-001,-001,-001,-001,-001,-001,-001,-001,-001,-001,-001,-001,-001,-001,-001,-001,-001],
	[-001,-001,-001,-001,0044,-001,-001,-001,-001,0004,-001,-001,-001,-001,-001,-001,-001,-001,-001,-001,-001],
	[-001,-001,-001,-001,-001,-001,-001,-001,-001,-001,-001,-001,-001,-001,-001,-001,-001,-001,-001,-001,-001],
	[-001,-001,-001,-001,-001,-001,-001,-001,-001,-001,-001,-001,-001,-001,-001,-001,-001,-001,-001,-001,-001],
	[-001,-001,-001,-001,-001,-001,-001,-001,-001,0181,0182,-001,-001,-001,-001,-001,-001,-001,-001,-001,-001],
	[-001,-001,-001,-001,-001,-001,0181,0182,0181,0182,-001,-001,-001,-001,-001,-001,-001,-001,-001,-001,-001],
	[-001,-001,-001,-001,-001,-001,-001,-001,-001,-001,-001,-001,-001,-001,-001,-001,-001,-001,-001,-001,-001],
	[-001,-001,-001,-001,-001,-001,-001,-001,-001,-001,-001,-001,-001,-001,-001,-001,-001,-001,-001,-001,-001],
	[-001,-001,-001,-001,-001,-001,-001,-001,-001,-001,-001,-001,-001,-001,-001,-001,-001,-001,-001,-001,-001],
	[-001,-001,-001,-001,-001,-001,0181,0182,-001,-001,-001,-001,-001,-001,-001,-001,-001,-001,-001,-001,-001],
	[-001,-001,-001,-001,-001,-001,-001,-001,-001,-001,-001,-001,-001,-001,-001,-001,-001,-001,-001,-001,-001],
	[-001,-001,-001,-001,-001,-001,-001,-001,-001,-001,-001,-001,-001,-001,-001,-001,-001,-001,-001,-001,-001],
	[-001,-001,-001,-001,-001,0045,-001,-001,-001,-001,-001,-001,-001,-001,-001,-001,-001,-001,-001,-001,-001],
	[-001,-001,-001,-001,-001,-001,-001,-001,-001,-001,-001,-001,-001,-001,-001,-001,-001,-001,-001,-001,-001]
	],
	"couche2": [
	[-001,-001,-001,-001,-001,-001,-001,-001,-001,-001,-001,-001,-001,-001,-001,-001,-001,-001,-001,-001,-001],
	[-001,-001,-001,-001,-001,-001,-001,-001,-001,-001,-001,-001,-001,-001,-001,-001,-001,-001,-001,-001,-001],
	[-001,-001,-001,-001,-001,-001,-001,-001,-001,-001,-001,-001,-001,-001,-001,-001,-001,-001,-001,-001,-001],
	[-001,-001,-001,-001,-001,-001,-001,-001,-001,-001,-001,-001,-001,-001,-001,-001,-001,-001,-001,-001,-001],
	[-001,-001,-001,-001,-001,-001,-001,-001,-001,-001,-001,-001,-001,-001,-001,-001,-001,-001,-001,-001,-001],
	[-001,-001,-001,-001,-001,-001,-001,-001,-001,-001,-001,-001,-001,-001,-001,-001,-001,-001,-001,-001,-001],
	[-001,-001,-001,-001,-001,-001,-001,-001,-001,-001,-001,-001,-001,-001,-001,-001,-001,-001,-001,-001,-001],
	[-001,-001,-001,-001,-001,-001,-001,-001,-001,-001,-001,-001,-001,-001,-001,-001,-001,-001,-001,-001,-001],
	[-001,-001,-001,-001,-001,-001,-001,-001,-001,-001,-001,-001,-001,-001,-001,-001,-001,-001,-001,-001,-001],
	[-001,-001,-001,-001,-001,-001,-001,-001,-001,-001,-001,-001,-001,-001,-001,-001,-001,-001,-001,-001,-001],
	[-001,-001,-001,-001,-001,-001,-001,-001,-001,-001,-001,-001,-001,-001,-001,-001,-001,-001,-001,-001,-001],
	[-001,-001,-001,-001,-001,-001,-001,-001,-001,-001,-001,-001,-001,-001,-001,-001,-001,-001,-001,-001,-001],
	[-001,-001,-001,-001,-001,-001,-001,-001,-001,-001,-001,-001,-001,-001,-001,-001,-001,-001,-001,-001,-001],
	[-001,-001,-001,-001,-001,-001,-001,-001,-001,-001,-001,-001,-001,-001,-001,-001,-001,-001,-001,-001,-001],
	[-001,-001,-001,-001,-001,-001,-001,-001,-001,-001,-001,-001,-001,-001,-001,-001,-001,-001,-001,-001,-001]
	],
	"events": [
	{
		"id": 5,
		"nom": "Clone[341][113]",
		"x": 8,
		"y": 5
	},
	{
		"id": 11,
		"nom": "EV011",
		"x": 9,
		"y": 1,
		"pages": [
		{
			"conditions": [
			{
				"nom": "Parler"
			}
			],
			"commandes": [
			],
			"image": 10,
			"vitesse": "moderee",
			"frequence": "basse",
			"animeEnMouvement": false,
			"animeALArret": false,
			"directionFixe": true,
			"traversable": true,
			"auDessusDeTout": true
		}
		]
	},
	{
		"id": 6,
		"nom": "Clone[341][113]",
		"x": 8,
		"y": 8
	},
	{
		"id": 12,
		"nom": "EV012",
		"x": 5,
		"y": 12,
		"pages": [
		{
			"conditions": [
			{
				"nom": "Parler"
			}
			],
			"commandes": [
			],
			"image": 30,
			"vitesse": "moderee",
			"frequence": "basse",
			"animeEnMouvement": false,
			"animeALArret": false,
			"directionFixe": true,
			"traversable": true,
			"auDessusDeTout": true
		}
		]
	},
	{
		"id": 1,
		"nom": "EV001",
		"x": 9,
		"y": 2,
		"pages": [
		{
			"conditions": [
			{
				"nom": "ArriveeAuContact"
			}
			],
			"commandes": [
			{
				"nom": "ChangerDeMap",
				"variable": false,
				"numeroNouvelleMap": 657,
				"xDebutHeros": 17,
				"yDebutHeros": 11
			}
			],
			"vitesse": "moderee",
			"frequence": "basse",
			"animeEnMouvement": true,
			"animeALArret": false,
			"directionFixe": false,
			"traversable": false,
			"auDessusDeTout": false
		}
		]
	},
	{
		"id": 7,
		"nom": "Clone[21][6]",
		"x": 11,
		"y": 6
	},
	{
		"id": 2,
		"nom": "EV002",
		"x": 13,
		"y": 14,
		"pages": [
		{
			"conditions": [
			{
				"nom": "ArriveeAuContact"
			}
			],
			"commandes": [
			{
				"nom": "ChangerDeMap",
				"variable": false,
				"numeroNouvelleMap": 597,
				"xDebutHeros": 3,
				"yDebutHeros": 1
			}
			],
			"vitesse": "moderee",
			"frequence": "basse",
			"animeEnMouvement": true,
			"animeALArret": false,
			"directionFixe": false,
			"traversable": false,
			"auDessusDeTout": false
		}
		]
	},
	{
		"id": 8,
		"nom": "Clone[21][6]",
		"x": 15,
		"y": 5
	},
	{
		"id": 3,
		"nom": "EV003",
		"x": 4,
		"y": 14,
		"pages": [
		{
			"conditions": [
			{
				"nom": "ArriveeAuContact"
			}
			],
			"commandes": [
			{
				"nom": "ChangerDeMap",
				"variable": false,
				"numeroNouvelleMap": 649,
				"xDebutHeros": 14,
				"yDebutHeros": 1
			}
			],
			"vitesse": "moderee",
			"frequence": "basse",
			"animeEnMouvement": true,
			"animeALArret": false,
			"directionFixe": false,
			"traversable": false,
			"auDessusDeTout": false
		}
		]
	},
	{
		"id": 9,
		"nom": "Clone[21][6]",
		"x": 15,
		"y": 8
	},
	{
		"id": 4,
		"nom": "Clone[341][113]",
		"x": 13,
		"y": 10
	},
	{
		"id": 10,
		"nom": "EV010",
		"x": 5,
		"y": 13,
		"pages": [
		{
			"conditions": [
			{
				"nom": "ArriveeAuContact"
			}
			],
			"commandes": [
			{
				"nom": "ChangerDeMap",
				"variable": false,
				"numeroNouvelleMap": 597,
				"xDebutHeros": 1,
				"yDebutHeros": 5
			}
			],
			"vitesse": "moderee",
			"frequence": "basse",
			"animeEnMouvement": true,
			"animeALArret": false,
			"directionFixe": false,
			"traversable": false,
			"auDessusDeTout": false
		}
		]
	}
	]
}
