{
	"nom": "Labyrinthe (B2)",
	"tileset": "Desert",
	"largeur": 35,
	"hauteur": 35,
	"couche0": [
	[0000,0000,0000,0134,0110,0110,0110,0110,0110,0110,0110,0110,0110,0110,0110,0110,0110,0110,0110,0110,0110,0110,0110,0110,0110,0110,0110,0110,0110,0110,0110,0110,0110,0110,0110],
	[0000,0000,0000,0103,0134,0110,0110,0110,0110,0110,0110,0110,0110,0110,0110,0110,0110,0110,0110,0110,0110,0110,0110,0110,0110,0110,0110,0110,0110,0110,0110,0110,0110,0110,0110],
	[0000,0134,0110,0111,0103,0134,0110,0110,0110,0110,0110,0110,0110,0110,0110,0110,0110,0110,0110,0110,0110,0110,0110,0110,0110,0110,0110,0110,0110,0110,0110,0110,0110,0110,0110],
	[0000,0103,0134,0110,0111,0103,0000,0000,0000,0081,0080,0000,0000,0000,0000,0000,0000,0000,0000,0000,0000,0000,0000,0000,0000,0000,0000,0000,0000,0000,0000,0000,0000,0000,0000],
	[0110,0111,0103,0134,0110,0111,0000,0080,0000,0000,0000,0000,0000,0000,0000,0000,0000,0000,0000,0000,0000,0000,0000,0000,0000,0000,0000,0000,0000,0000,0000,0000,0000,0000,0000],
	[0110,0110,0111,0103,0000,0000,0000,0000,0000,0000,0000,0000,0000,0000,0000,0000,0000,0000,0000,0000,0000,0000,0000,0000,0000,0000,0000,0000,0000,0000,0000,0000,0000,0000,0000],
	[0110,0110,0110,0111,0000,0000,0000,0000,0000,0000,0000,0000,0000,0000,0000,0000,0000,0000,0000,0000,0000,0000,0000,0000,0000,0000,0000,0000,0000,0000,0000,0000,0000,0000,0000],
	[0000,0000,0000,0000,0000,0000,0000,0000,0000,0000,0000,0000,0000,0000,0000,0000,0000,0000,0000,0000,0000,0000,0000,0000,0000,0000,0000,0000,0000,0000,0000,0000,0000,0000,0000],
	[0000,0000,0000,0000,0000,0000,0000,0000,0000,0000,0000,0000,0000,0000,0000,0000,0000,0000,0000,0000,0000,0000,0000,0000,0000,0000,0000,0000,0000,0000,0000,0000,0000,0000,0000],
	[0000,0000,0000,0000,0000,0000,0000,0000,0000,0000,0000,0000,0000,0000,0000,0000,0000,0000,0000,0000,0000,0000,0000,0000,0000,0000,0000,0000,0000,0000,0000,0000,0000,0000,0000],
	[0000,0000,0000,0000,0000,0000,0000,0000,0000,0000,0000,0000,0000,0000,0000,0000,0000,0000,0000,0000,0000,0000,0000,0000,0000,0000,0000,0000,0000,0000,0000,0000,0000,0000,0000],
	[0000,0000,0000,0000,0000,0000,0000,0000,0000,0000,0000,0000,0000,0000,0000,0000,0000,0000,0000,0000,0000,0000,0000,0000,0000,0000,0000,0000,0000,0000,0000,0000,0000,0000,0000],
	[0000,0000,0000,0000,0000,0000,0000,0000,0000,0000,0000,0000,0000,0000,0000,0000,0000,0000,0000,0000,0000,0000,0000,0000,0000,0000,0000,0000,0000,0000,0000,0000,0000,0000,0000],
	[0000,0000,0000,0000,0000,0000,0000,0000,0000,0000,0000,0000,0000,0000,0000,0000,0000,0000,0000,0000,0000,0000,0000,0000,0000,0000,0000,0000,0000,0000,0000,0000,0000,0000,0000],
	[0000,0000,0000,0000,0000,0000,0000,0000,0000,0000,0000,0000,0000,0000,0000,0000,0000,0000,0000,0000,0000,0000,0000,0000,0000,0000,0000,0000,0000,0000,0000,0000,0000,0000,0000],
	[0000,0000,0000,0000,0000,0000,0000,0000,0000,0000,0000,0000,0000,0000,0000,0000,0000,0000,0000,0000,0000,0000,0000,0000,0000,0000,0000,0000,0000,0000,0000,0000,0000,0000,0000],
	[0000,0000,0000,0000,0000,0000,0000,0000,0000,0000,0000,0000,0000,0000,0000,0000,0000,0000,0000,0000,0000,0000,0000,0000,0000,0000,0000,0000,0000,0000,0000,0000,0000,0000,0000],
	[0000,0000,0000,0000,0000,0000,0000,0000,0000,0000,0000,0000,0000,0000,0000,0000,0000,0000,0000,0000,0000,0000,0000,0000,0000,0000,0000,0000,0000,0000,0000,0000,0000,0000,0000],
	[0000,0000,0000,0000,0000,0000,0000,0000,0000,0000,0000,0000,0000,0000,0000,0000,0000,0000,0000,0000,0000,0000,0000,0000,0000,0000,0000,0000,0000,0000,0000,0000,0000,0000,0000],
	[0000,0000,0000,0000,0000,0000,0000,0000,0000,0000,0000,0000,0000,0000,0000,0000,0000,0000,0000,0000,0000,0000,0000,0000,0000,0000,0000,0000,0000,0000,0000,0000,0000,0000,0000],
	[0000,0000,0000,0000,0000,0000,0000,0000,0000,0000,0000,0000,0000,0000,0000,0000,0000,0000,0000,0000,0000,0000,0000,0000,0000,0000,0000,0000,0000,0000,0000,0000,0000,0000,0000],
	[0000,0000,0000,0000,0000,0000,0000,0000,0000,0000,0000,0000,0000,0000,0000,0000,0000,0000,0000,0000,0000,0000,0000,0000,0000,0000,0000,0000,0000,0000,0000,0000,0000,0000,0000],
	[0000,0000,0000,0000,0000,0000,0000,0000,0000,0000,0000,0000,0000,0000,0000,0000,0000,0000,0000,0000,0000,0000,0000,0000,0000,0000,0000,0000,0000,0000,0000,0000,0000,0000,0000],
	[0000,0000,0000,0000,0000,0000,0000,0000,0000,0000,0000,0000,0000,0000,0000,0000,0000,0000,0000,0000,0000,0000,0000,0000,0000,0000,0000,0000,0000,0000,0000,0000,0000,0000,0000],
	[0000,0000,0000,0000,0000,0000,0000,0000,0000,0000,0000,0000,0000,0000,0000,0000,0000,0000,0000,0000,0000,0000,0000,0000,0000,0000,0000,0000,0000,0000,0000,0000,0000,0000,0000],
	[0000,0000,0000,0000,0000,0000,0000,0000,0000,0000,0000,0000,0000,0000,0000,0000,0000,0000,0000,0000,0000,0000,0000,0000,0000,0000,0000,0000,0000,0000,0000,0000,0000,0000,0000],
	[0000,0000,0000,0000,0000,0000,0000,0000,0000,0000,0000,0000,0000,0000,0000,0000,0000,0000,0000,0000,0000,0000,0000,0000,0000,0000,0000,0000,0000,0000,0000,0000,0000,0000,0000],
	[0000,0000,0000,0000,0000,0000,0000,0000,0000,0000,0000,0000,0000,0000,0000,0000,0000,0000,0000,0000,0000,0000,0000,0000,0000,0000,0000,0000,0000,0000,0000,0000,0000,0000,0000],
	[0000,0000,0000,0000,0000,0000,0000,0000,0000,0000,0000,0000,0000,0000,0000,0000,0000,0000,0000,0000,0000,0000,0000,0000,0000,0000,0000,0000,0000,0000,0000,0000,0000,0000,0000],
	[0000,0000,0000,0000,0000,0000,0000,0000,0000,0000,0000,0000,0000,0000,0000,0000,0000,0000,0000,0000,0000,0000,0000,0000,0000,0000,0000,0000,0000,0000,0000,0000,0000,0000,0000],
	[0000,0000,0000,0000,0000,0000,0000,0000,0000,0000,0000,0000,0000,0000,0000,0000,0000,0000,0000,0000,0000,0000,0000,0000,0000,0000,0000,0000,0000,0000,0000,0000,0000,0000,0000],
	[0000,0000,0000,0000,0000,0000,0000,0000,0000,0000,0000,0000,0000,0000,0000,0000,0000,0000,0000,0000,0000,0000,0000,0000,0000,0000,0000,0000,0000,0000,0000,0000,0000,0000,0000],
	[0000,0000,0000,0000,0000,0000,0000,0000,0000,0000,0000,0000,0000,0000,0000,0000,0000,0000,0000,0000,0000,0000,0000,0000,0000,0000,0000,0000,0000,0000,0000,0000,0000,0000,0000],
	[0000,0000,0000,0000,0000,0000,0000,0000,0000,0000,0000,0000,0000,0000,0000,0000,0000,0000,0000,0000,0000,0000,0000,0000,0000,0000,0000,0000,0000,0000,0000,0000,0000,0000,0000],
	[0000,0000,0000,0000,0000,0000,0000,0000,0000,0000,0000,0000,0000,0000,0000,0000,0000,0000,0000,0000,0000,0000,0000,0000,0000,0000,0000,0000,0000,0000,0000,0000,0000,0000,0000]
	],
	"couche1": [
	[-001,-001,-001,-001,-001,-001,-001,-001,-001,-001,-001,-001,-001,-001,-001,-001,-001,-001,-001,-001,-001,-001,-001,-001,-001,-001,-001,-001,-001,-001,-001,-001,-001,-001,-001],
	[-001,-001,-001,-001,-001,-001,-001,-001,-001,-001,-001,-001,-001,-001,-001,-001,-001,-001,-001,-001,-001,-001,-001,-001,-001,-001,-001,-001,-001,-001,-001,-001,-001,-001,-001],
	[-001,-001,-001,-001,-001,-001,-001,-001,-001,0073,-001,-001,-001,-001,-001,-001,-001,-001,-001,-001,-001,-001,-001,-001,-001,-001,-001,-001,-001,-001,-001,-001,-001,-001,-001],
	[-001,-001,-001,-001,-001,-001,-001,-001,-001,-001,-001,-001,-001,-001,-001,-001,-001,-001,-001,-001,-001,-001,-001,-001,-001,-001,-001,-001,-001,-001,-001,-001,-001,-001,-001],
	[-001,-001,-001,-001,-001,-001,-001,-001,-001,-001,-001,-001,-001,-001,-002,-002,-002,-002,-002,-002,-002,-002,-002,-002,-002,-002,-002,-002,-002,-002,-002,-002,-002,-001,-001],
	[-001,-001,-001,-001,-001,-001,-001,-001,-001,-001,-001,-001,-001,-001,-003,-003,-003,-003,-003,-003,-003,-003,-003,-003,-003,-003,-003,-003,-003,-003,-003,-003,-003,-001,-001],
	[-001,-001,-001,-001,-001,-001,-001,-001,-002,-002,-002,-002,-002,-002,-003,-001,-002,-002,-002,-002,-002,-002,-002,-002,-002,-002,-001,-002,-002,-002,-002,-001,-003,-001,-001],
	[-001,-001,-001,-001,-001,-001,-001,-001,-003,-003,-003,-003,-003,-003,-003,-001,-003,-003,-003,-003,-003,-003,-003,-003,-003,-003,-001,-003,-003,-003,-003,-001,-003,-002,-002],
	[-001,-001,-001,-001,-001,-001,-001,-001,-003,-001,-002,-002,-002,-001,-003,-001,-003,-001,-002,-002,-002,-002,-002,-001,-003,-002,-002,-003,-001,-002,-003,-001,-003,-003,-003],
	[-001,-001,-001,-001,-001,-001,-001,-001,-003,-001,-003,-003,-003,-001,-003,-001,-003,-001,-003,-003,-003,-003,-003,-001,-003,-003,-003,-003,-001,-003,-003,-002,-002,-002,-002],
	[-001,-001,-001,-001,-001,-001,-001,-001,-003,-001,-003,-001,-003,-001,-003,-001,-003,-001,-003,-001,-002,-001,-003,-002,-002,-002,-002,-002,-002,-001,-003,-003,-003,-003,-003],
	[-001,-001,-001,-001,-001,-001,-002,-001,-003,-002,-002,-002,-003,-001,-003,-001,-003,-002,-002,-001,-003,-001,-003,-003,-003,-003,-003,-003,-003,-001,-003,-001,-003,-001,-002],
	[-001,-001,-001,-001,-001,-001,-003,-001,-003,-003,-003,-003,-003,-001,-003,-001,-003,-003,-003,-001,-003,-001,-003,-001,-002,-002,-002,-001,-003,-001,-003,-001,-003,-001,-003],
	[-001,-001,-001,-001,-002,-002,-003,-002,-002,-002,-002,-002,-002,-002,-003,-002,-002,-002,-002,-002,-003,-001,-003,-001,-003,-003,-003,-001,-003,-001,-003,-002,-002,-001,-003],
	[-001,-001,-001,-001,-003,-003,-003,-003,-003,-003,-003,-003,-003,-003,-003,-003,-003,-003,-003,-003,-003,-001,-003,-001,-003,-001,-002,-002,-002,-002,-003,-003,-003,-001,-003],
	[-001,-001,-001,-001,-003,-001,-002,-002,-002,-002,-002,-002,-002,-002,-002,-002,-002,-002,-002,-002,-002,-002,-003,-001,-003,-001,-003,-003,-003,-003,-003,-001,-002,-001,-003],
	[-001,-001,-001,-001,-003,-001,-003,-003,-003,-003,-003,-003,-003,-003,-003,-003,-003,-003,-003,-003,-003,-003,-003,-001,-003,-002,-002,-002,-002,-001,-003,-001,-003,-001,-003],
	[-001,-001,-001,-001,-003,-001,-003,-001,-002,-002,-002,-002,-002,-002,-002,-002,-002,-002,-002,-002,-002,-001,-003,-001,-003,-003,-003,-003,-003,-001,-003,-001,-003,-002,-002],
	[-001,-001,-001,-001,-003,-001,-003,-001,-003,-003,-003,-003,-003,-003,-003,-003,-003,-003,-003,-003,-003,-001,-003,-001,-003,-001,-002,-001,-002,-002,-003,-001,-003,-003,-003],
	[-001,-001,-001,-001,-003,-001,-003,-001,-003,-001,-002,-002,-002,-002,-002,-002,-002,-002,-002,-001,-003,-001,-003,-001,-003,-001,-003,-001,-003,-003,-003,-001,-003,-001,-002],
	[-001,-001,-001,-001,-003,-001,-003,-001,-003,-001,-003,-003,-003,-003,-003,-003,-003,-003,-003,-001,-003,-001,-003,-001,-003,-001,-003,-002,-002,-002,-002,-002,-003,-001,-003],
	[-001,-001,-001,-001,-003,-001,-003,-001,-003,-001,-003,-001,-002,-002,-002,-002,-002,-001,-003,-001,-003,-001,-003,-001,-003,-001,-003,-003,-003,-003,-003,-003,-003,-001,-003],
	[-001,-001,-001,-001,-003,-001,-003,-001,-003,-001,-003,-001,-003,-003,-003,-003,-003,-001,-003,-001,-003,-001,-003,-001,-003,-002,-002,-002,-002,-002,-002,-002,-002,-002,-003],
	[-001,-001,0118,-001,-003,-001,-003,-001,-003,-001,-003,-001,-003,-001,-002,-002,-002,-001,-002,-002,-003,-001,-003,-001,-003,-003,-003,-003,-003,-003,-003,-003,-003,-003,-003],
	[-001,-001,-001,-001,-003,-001,-003,-001,-003,-001,-003,-001,-003,-001,-003,-003,-003,-001,-003,-003,-003,-001,-003,-001,-003,-001,-002,-002,-002,-002,-002,-002,-002,-001,-003],
	[-001,0118,-001,-001,-003,-001,-003,-001,-003,-001,-003,-001,-003,-001,-003,-001,-002,-002,-002,-002,-002,-002,-003,-001,-003,-001,-003,-003,-003,-003,-003,-003,-003,-001,-003],
	[-001,-001,0118,-001,-003,-001,-003,-001,-003,-001,-003,-001,-003,-001,-003,-001,-003,-003,-003,-003,-003,-003,-003,-001,-003,-001,-003,-001,-002,-002,-002,-001,-003,-001,-003],
	[-001,-001,-001,-001,-003,-001,-003,-001,-003,-001,-003,-001,-003,-001,-003,-002,-002,-002,-002,-002,-002,-002,-002,-002,-003,-001,-003,-001,-003,-003,-003,-001,-003,-001,-003],
	[-001,-001,-001,-001,-003,-001,-003,-001,-003,-001,-003,-001,-003,-001,-003,-003,-003,-003,-003,-003,-003,-003,-003,-003,-003,-001,-003,-001,-002,-001,-003,-001,-003,-001,-003],
	[-001,-001,-001,-001,-003,-001,-003,-001,-003,-001,-003,-001,-003,-002,-002,-002,-002,-002,-002,-002,-002,-002,-002,-001,-003,-002,-002,-002,-003,-001,-003,-001,-003,-001,-003],
	[-001,-001,-001,-001,-003,-001,-003,-001,-003,-001,-003,-001,-003,-003,-003,-003,-003,-003,-003,-003,-003,-003,-003,-001,-003,-003,-003,-003,-003,-001,-003,-001,-003,-001,-003],
	[-001,-001,-001,-001,-003,-001,-003,-001,-003,-001,-003,-002,-002,-002,-002,-002,-002,-002,-002,-002,-002,-001,-003,-002,-002,-002,-002,-002,-002,-002,-003,-001,-003,-001,-003],
	[-001,-001,-001,-001,-003,-001,-003,-001,-003,-001,-003,-003,-003,-003,-003,-003,-003,-003,-003,-003,-003,-001,-003,-003,-003,-003,-003,-003,-003,-003,-003,-001,-003,-001,-003],
	[-001,-001,-001,-001,-003,-001,-003,-001,-003,-002,-002,-002,-002,-002,-002,-002,-002,-002,-002,-001,-003,-002,-002,-002,-002,-002,-002,-002,-002,-001,-003,-001,-003,-002,-002],
	[-001,-001,-001,-001,-003,-001,-003,-001,-003,-003,-003,-003,-003,-003,-003,-003,-003,-003,-003,-001,-003,-003,-003,-003,-003,-003,-003,-003,-003,-001,-003,-001,-003,-003,-003]
	],
	"couche2": [
	[-001,-001,-001,-001,-001,-001,-001,-001,-001,-001,-001,-001,-001,-001,-001,-001,-001,-001,-001,-001,-001,-001,-001,-001,-001,-001,-001,-001,-001,-001,-001,-001,-001,-001,-001],
	[-001,-001,-001,-001,-001,-001,-001,-001,-001,-001,-001,-001,-001,-001,-001,-001,-001,-001,-001,-001,-001,-001,-001,-001,-001,-001,-001,-001,-001,-001,-001,-001,-001,-001,-001],
	[-001,-001,-001,-001,-001,-001,-001,-001,-001,-001,-001,-001,-001,-001,-001,-001,-001,-001,-001,-001,-001,-001,-001,-001,-001,-001,-001,-001,-001,-001,-001,-001,-001,-001,-001],
	[-001,-001,-001,-001,-001,-001,-001,-001,-001,-001,-001,-001,-001,-001,-001,-001,-001,-001,-001,-001,-001,-001,-001,-001,-001,-001,-001,-001,-001,-001,-001,-001,-001,-001,-001],
	[-001,-001,-001,-001,-001,-001,-001,-001,-001,-001,-001,-001,-001,-001,-001,-001,-001,-001,-001,-001,-001,-001,-001,-001,-001,-001,-001,-001,-001,-001,-001,-001,-001,-001,-001],
	[-001,-001,-001,-001,-001,-001,-001,-001,-001,-001,-001,-001,-001,-001,-001,-001,-001,-001,-001,-001,-001,-001,-001,-001,-001,-001,-001,-001,-001,-001,-001,-001,-001,-001,-001],
	[-001,-001,-001,-001,-001,-001,-001,-001,-001,-001,-001,-001,-001,-001,-001,-001,-001,-001,-001,-001,-001,-001,-001,-001,-001,-001,-001,-001,-001,-001,-001,-001,-001,-001,-001],
	[-001,-001,-001,-001,-001,-001,-001,-001,-001,-001,-001,-001,-001,-001,-001,-001,-001,-001,-001,-001,-001,-001,-001,-001,-001,-001,-001,-001,-001,-001,-001,-001,-001,-001,-001],
	[-001,-001,-001,-001,-001,-001,-001,-001,-001,-001,-001,-001,-001,-001,-001,-001,-001,-001,-001,-001,-001,-001,-001,-001,-001,-001,-001,-001,-001,-001,-001,-001,-001,-001,-001],
	[-001,-001,-001,-001,-001,-001,-001,-001,-001,-001,-001,-001,-001,-001,-001,-001,-001,-001,-001,-001,-001,-001,-001,-001,-001,-001,-001,-001,-001,-001,-001,-001,-001,-001,-001],
	[-001,-001,-001,-001,-001,-001,-001,-001,-001,-001,-001,-001,-001,-001,-001,-001,-001,-001,-001,-001,-001,-001,-001,-001,-001,-001,-001,-001,-001,-001,-001,-001,-001,-001,-001],
	[-001,-001,-001,-001,-001,-001,-001,-001,-001,-001,-001,-001,-001,-001,-001,-001,-001,-001,-001,-001,-001,-001,-001,-001,-001,-001,-001,-001,-001,-001,-001,-001,-001,-001,-001],
	[-001,-001,-001,-001,-001,-001,-001,-001,-001,-001,-001,-001,-001,-001,-001,-001,-001,-001,-001,-001,-001,-001,-001,-001,-001,-001,-001,-001,-001,-001,-001,-001,-001,-001,-001],
	[-001,-001,-001,-001,-001,-001,-001,-001,-001,-001,-001,-001,-001,-001,-001,-001,-001,-001,-001,-001,-001,-001,-001,-001,-001,-001,-001,-001,-001,-001,-001,-001,-001,-001,-001],
	[-001,-001,-001,-001,-001,-001,-001,-001,-001,-001,-001,-001,-001,-001,-001,-001,-001,-001,-001,-001,-001,-001,-001,-001,-001,-001,-001,-001,-001,-001,-001,-001,-001,-001,-001],
	[-001,-001,-001,-001,-001,-001,-001,-001,-001,-001,-001,-001,-001,-001,-001,-001,-001,-001,-001,-001,-001,-001,-001,-001,-001,-001,-001,-001,-001,-001,-001,-001,-001,-001,-001],
	[-001,-001,-001,-001,-001,-001,-001,-001,-001,-001,-001,-001,-001,-001,-001,-001,-001,-001,-001,-001,-001,-001,-001,-001,-001,-001,-001,-001,-001,-001,-001,-001,-001,-001,-001],
	[-001,-001,-001,-001,-001,-001,-001,-001,-001,-001,-001,-001,-001,-001,-001,-001,-001,-001,-001,-001,-001,-001,-001,-001,-001,-001,-001,-001,-001,-001,-001,-001,-001,-001,-001],
	[-001,-001,-001,-001,-001,-001,-001,-001,-001,-001,-001,-001,-001,-001,-001,-001,-001,-001,-001,-001,-001,-001,-001,-001,-001,-001,-001,-001,-001,-001,-001,-001,-001,-001,-001],
	[-001,-001,-001,-001,-001,-001,-001,-001,-001,-001,-001,-001,-001,-001,-001,-001,-001,-001,-001,-001,-001,-001,-001,-001,-001,-001,-001,-001,-001,-001,-001,-001,-001,-001,-001],
	[-001,-001,-001,-001,-001,-001,-001,-001,-001,-001,-001,-001,-001,-001,-001,-001,-001,-001,-001,-001,-001,-001,-001,-001,-001,-001,-001,-001,-001,-001,-001,-001,-001,-001,-001],
	[-001,-001,-001,-001,-001,-001,-001,-001,-001,-001,-001,-001,-001,-001,-001,-001,-001,-001,-001,-001,-001,-001,-001,-001,-001,-001,-001,-001,-001,-001,-001,-001,-001,-001,-001],
	[-001,-001,-001,-001,-001,-001,-001,-001,-001,-001,-001,-001,-001,-001,-001,-001,-001,-001,-001,-001,-001,-001,-001,-001,-001,-001,-001,-001,-001,-001,-001,-001,-001,-001,-001],
	[-001,-001,-001,-001,-001,-001,-001,-001,-001,-001,-001,-001,-001,-001,-001,-001,-001,-001,-001,-001,-001,-001,-001,-001,-001,-001,-001,-001,-001,-001,-001,-001,-001,-001,-001],
	[-001,-001,-001,-001,-001,-001,-001,-001,-001,-001,-001,-001,-001,-001,-001,-001,-001,-001,-001,-001,-001,-001,-001,-001,-001,-001,-001,-001,-001,-001,-001,-001,-001,-001,-001],
	[-001,-001,-001,-001,-001,-001,-001,-001,-001,-001,-001,-001,-001,-001,-001,-001,-001,-001,-001,-001,-001,-001,-001,-001,-001,-001,-001,-001,-001,-001,-001,-001,-001,-001,-001],
	[-001,-001,-001,-001,-001,-001,-001,-001,-001,-001,-001,-001,-001,-001,-001,-001,-001,-001,-001,-001,-001,-001,-001,-001,-001,-001,-001,-001,-001,-001,-001,-001,-001,-001,-001],
	[-001,-001,-001,-001,-001,-001,-001,-001,-001,-001,-001,-001,-001,-001,-001,-001,-001,-001,-001,-001,-001,-001,-001,-001,-001,-001,-001,-001,-001,-001,-001,-001,-001,-001,-001],
	[-001,-001,-001,-001,-001,-001,-001,-001,-001,-001,-001,-001,-001,-001,-001,-001,-001,-001,-001,-001,-001,-001,-001,-001,-001,-001,-001,-001,-001,-001,-001,-001,-001,-001,-001],
	[-001,-001,-001,-001,-001,-001,-001,-001,-001,-001,-001,-001,-001,-001,-001,-001,-001,-001,-001,-001,-001,-001,-001,-001,-001,-001,-001,-001,-001,-001,-001,-001,-001,-001,-001],
	[-001,-001,-001,-001,-001,-001,-001,-001,-001,-001,-001,-001,-001,-001,-001,-001,-001,-001,-001,-001,-001,-001,-001,-001,-001,-001,-001,-001,-001,-001,-001,-001,-001,-001,-001],
	[-001,-001,-001,-001,-001,-001,-001,-001,-001,-001,-001,-001,-001,-001,-001,-001,-001,-001,-001,-001,-001,-001,-001,-001,-001,-001,-001,-001,-001,-001,-001,-001,-001,-001,-001],
	[-001,-001,-001,-001,-001,-001,-001,-001,-001,-001,-001,-001,-001,-001,-001,-001,-001,-001,-001,-001,-001,-001,-001,-001,-001,-001,-001,-001,-001,-001,-001,-001,-001,-001,-001],
	[-001,-001,-001,-001,-001,-001,-001,-001,-001,-001,-001,-001,-001,-001,-001,-001,-001,-001,-001,-001,-001,-001,-001,-001,-001,-001,-001,-001,-001,-001,-001,-001,-001,-001,-001],
	[-001,-001,-001,-001,-001,-001,-001,-001,-001,-001,-001,-001,-001,-001,-001,-001,-001,-001,-001,-001,-001,-001,-001,-001,-001,-001,-001,-001,-001,-001,-001,-001,-001,-001,-001]
	],
	"events": [
	{
		"id": 1,
		"nom": "teleporteur",
		"x": 34,
		"y": 34,
		"pages": [
		{
			"conditions": [
			],
			"commandes": [
			{
				"nom": "ModifierVariable",
				"numeroVariable": 2,
				"operationAFaire": "rendre egal a",
				"valeurADonner": 0,
				"operationAFaire2": "coordonnee x"
			},
			{
				"nom": "ModifierVariable",
				"numeroVariable": 3,
				"operationAFaire": "rendre egal a",
				"valeurADonner": 0,
				"operationAFaire2": "coordonnee y"
			},
			{
				"nom": "Commentaire",
				"texte": "gauche"
			},
			{
				"nom": "ConditionVariable",
				"numeroVariable": 2,
				"inegalite": "<=",
				"valeurQuIlEstCenseAvoir": 0,
				"comparerAUneAutreVariable": false,
				"numero": 0
			},
			{
				"nom": "ConditionDirection",
				"idEventConcerne": 0,
				"direction": 1,
				"numero": 1
			},
			{
				"nom": "ConditionTouche",
				"touche": "GAUCHE",
				"numero": 2
			},
			{
				"nom": "ModifierVariable",
				"numeroVariable": 66,
				"operationAFaire": "rendre egal a",
				"valeurADonner": 675,
				"operationAFaire2": "valeur brute"
			},
			{
				"nom": "ModifierVariable",
				"numeroVariable": 67,
				"operationAFaire": "rendre egal a",
				"valeurADonner": 34,
				"operationAFaire2": "valeur brute"
			},
			{
				"nom": "ModifierVariable",
				"numeroVariable": 68,
				"operationAFaire": "rendre egal a",
				"valeurADonner": 0,
				"operationAFaire2": "coordonnee y"
			},
			{
				"nom": "ChangerDeMap",
				"variable": true,
				"numeroNouvelleMap": 66,
				"xDebutHeros": 67,
				"yDebutHeros": 68
			},
			{
				"nom": "ConditionFin",
				"numero": 2
			},
			{
				"nom": "ConditionFin",
				"numero": 1
			},
			{
				"nom": "ConditionFin",
				"numero": 0
			},
			{
				"nom": "Commentaire",
				"texte": "droite"
			},
			{
				"nom": "ConditionVariable",
				"numeroVariable": 2,
				"inegalite": ">=",
				"valeurQuIlEstCenseAvoir": 34,
				"comparerAUneAutreVariable": false,
				"numero": 3
			},
			{
				"nom": "ConditionDirection",
				"idEventConcerne": 0,
				"direction": 2,
				"numero": 4
			},
			{
				"nom": "ConditionTouche",
				"touche": "DROITE",
				"numero": 5
			},
			{
				"nom": "ModifierVariable",
				"numeroVariable": 66,
				"operationAFaire": "rendre egal a",
				"valeurADonner": 673,
				"operationAFaire2": "valeur brute"
			},
			{
				"nom": "ModifierVariable",
				"numeroVariable": 67,
				"operationAFaire": "rendre egal a",
				"valeurADonner": 0,
				"operationAFaire2": "valeur brute"
			},
			{
				"nom": "ModifierVariable",
				"numeroVariable": 68,
				"operationAFaire": "rendre egal a",
				"valeurADonner": 0,
				"operationAFaire2": "coordonnee y"
			},
			{
				"nom": "ChangerDeMap",
				"variable": true,
				"numeroNouvelleMap": 66,
				"xDebutHeros": 67,
				"yDebutHeros": 68
			},
			{
				"nom": "ConditionFin",
				"numero": 5
			},
			{
				"nom": "ConditionFin",
				"numero": 4
			},
			{
				"nom": "ConditionFin",
				"numero": 3
			},
			{
				"nom": "Commentaire",
				"texte": "bas"
			},
			{
				"nom": "ConditionVariable",
				"numeroVariable": 3,
				"inegalite": ">=",
				"valeurQuIlEstCenseAvoir": 34,
				"comparerAUneAutreVariable": false,
				"numero": 6
			},
			{
				"nom": "ConditionDirection",
				"idEventConcerne": 0,
				"direction": 0,
				"numero": 7
			},
			{
				"nom": "ConditionTouche",
				"touche": "BAS",
				"numero": 8
			},
			{
				"nom": "ModifierVariable",
				"numeroVariable": 66,
				"operationAFaire": "rendre egal a",
				"valeurADonner": 671,
				"operationAFaire2": "valeur brute"
			},
			{
				"nom": "ModifierVariable",
				"numeroVariable": 67,
				"operationAFaire": "rendre egal a",
				"valeurADonner": 2,
				"operationAFaire2": "contenu de la variable"
			},
			{
				"nom": "ModifierVariable",
				"numeroVariable": 68,
				"operationAFaire": "rendre egal a",
				"valeurADonner": 0,
				"operationAFaire2": "valeur brute"
			},
			{
				"nom": "ChangerDeMap",
				"variable": true,
				"numeroNouvelleMap": 66,
				"xDebutHeros": 67,
				"yDebutHeros": 68
			},
			{
				"nom": "ConditionFin",
				"numero": 8
			},
			{
				"nom": "ConditionFin",
				"numero": 7
			},
			{
				"nom": "ConditionFin",
				"numero": 6
			}
			],
			"vitesse": "moderee",
			"frequence": "basse",
			"animeEnMouvement": true,
			"animeALArret": false,
			"directionFixe": false,
			"traversable": false,
			"auDessusDeTout": false
		}
		]
	},
	{
		"id": 2,
		"nom": "Clone[341][006]",
		"x": 11,
		"y": 10
	}
	]
}
