{
	"nom": "Salle 10 (nombres gauche)",
	"tileset": "Pyramide",
	"largeur": 21,
	"hauteur": 15,
	"musique": {
		"nomFichierSonore": "",
		"volume": 1.00,
		"tempo": 1.00
	},
	"fondSonore": {
		"nomFichierSonore": "",
		"volume": 0.80,
		"tempo": 1.00
	},
	"couche0": [
	[0309,0008,0337,0329,0330,0005,0004,0005,0004,0005,0005,0004,0005,0005,0004,0005,0004,0005,0038,0039,0002],
	[0308,0309,0008,0337,0338,0013,0012,0013,0012,0013,0013,0012,0013,0013,0012,0013,0012,0013,0046,0047,0002],
	[0303,0308,0309,0008,0008,0008,0008,0008,0019,0002,0002,0002,0035,0008,0008,0008,0008,0008,0020,0021,0002],
	[0315,0316,0317,0008,0079,0008,0094,0008,0027,0002,0002,0002,0043,0008,0103,0008,0102,0008,0028,0029,0002],
	[0002,0006,0007,0008,0087,0008,0095,0008,0027,0002,0002,0002,0043,0008,0087,0008,0078,0008,0020,0021,0002],
	[0002,0014,0015,0008,0008,0008,0008,0008,0071,0002,0002,0002,0070,0008,0008,0008,0008,0008,0028,0029,0002],
	[0002,0052,0053,0023,0032,0033,0034,0023,0022,0023,0022,0023,0022,0023,0032,0033,0034,0023,0054,0055,0002],
	[0002,0060,0061,0031,0040,0041,0042,0031,0030,0031,0030,0031,0030,0031,0040,0041,0042,0031,0062,0063,0002],
	[0036,0037,0004,0005,0016,0017,0018,0005,0004,0005,0004,0005,0004,0005,0016,0017,0018,0005,0004,0038,0039],
	[0044,0045,0012,0013,0024,0025,0026,0013,0012,0013,0012,0013,0012,0013,0024,0025,0026,0013,0012,0046,0047],
	[0006,0007,0000,0000,0000,-008,0000,0000,0000,0000,0000,0000,0000,0000,0000,-008,0000,0000,0000,0020,0021],
	[0014,0015,0000,0000,0000,-008,-008,-008,-008,-008,-008,-008,-008,-008,-008,-008,0000,0000,0000,0028,0029],
	[0006,0007,0000,0000,0000,0000,0000,0000,0000,0000,-008,0000,0000,0000,0000,0000,0000,0000,0000,0020,0021],
	[0052,0053,0022,0023,0022,0023,0022,0023,0022,0032,0033,0034,0022,0023,0022,0023,0022,0023,0022,0054,0055],
	[0060,0061,0030,0031,0030,0031,0030,0031,0030,0040,0041,0042,0030,0031,0030,0031,0030,0031,0030,0062,0063]
	],
	"couche1": [
	[-001,-001,-001,-001,-001,-001,-001,-001,-001,-001,-001,-001,-001,-001,-001,-001,-001,-001,-001,-001,-001],
	[-001,-001,-001,-001,-001,-001,-001,-001,-001,-001,-001,-001,-001,-001,-001,-001,-001,-001,-001,-001,-001],
	[-001,-001,-001,-001,-001,0011,-001,-001,-001,-001,-001,-001,-001,-001,-001,0011,-001,-001,-001,-001,-001],
	[-001,-001,-001,-001,-001,-001,-001,-001,-001,-001,-001,-001,-001,-001,-001,-001,-001,-001,-001,-001,-001],
	[-001,-001,-001,-001,-001,-001,-001,-001,-001,-001,-001,-001,-001,-001,-001,-001,-001,-001,-001,-001,-001],
	[-001,-001,-001,-001,-001,-001,-001,-001,-001,-001,-001,-001,-001,-001,-001,-001,-001,-001,-001,-001,-001],
	[-001,-001,-001,-001,-001,-001,-001,-001,-001,-001,-001,-001,-001,-001,-001,-001,-001,-001,-001,-001,-001],
	[-001,-001,-001,-001,-001,-001,-001,-001,-001,-001,-001,-001,-001,-001,-001,-001,-001,-001,-001,-001,-001],
	[-001,-001,-001,-001,-001,-001,-001,-001,-001,-001,-001,-001,-001,-001,-001,-001,-001,-001,-001,-001,-001],
	[-001,-001,-001,-001,-001,-001,-001,-001,-001,-001,-001,-001,-001,-001,-001,-001,-001,-001,-001,-001,-001],
	[-001,-001,-001,-001,-001,-001,-001,-001,-001,-001,-001,-001,-001,-001,-001,-001,-001,-001,-001,-001,-001],
	[-001,-001,-001,-001,-001,-001,-001,-001,-001,-001,-001,-001,-001,-001,-001,-001,-001,-001,-001,-001,-001],
	[-001,-001,-001,-001,-001,-001,-001,-001,-001,-001,-001,-001,-001,-001,-001,-001,-001,-001,-001,-001,-001],
	[-001,-001,-001,-001,-001,-001,-001,-001,-001,-001,-001,-001,-001,-001,-001,-001,-001,-001,-001,-001,-001],
	[-001,-001,-001,-001,-001,-001,-001,-001,-001,-001,-001,-001,-001,-001,-001,-001,-001,-001,-001,-001,-001]
	],
	"couche2": [
	[-001,-001,-001,-001,-001,-001,-001,-001,-001,-001,-001,-001,-001,-001,-001,-001,-001,-001,-001,-001,-001],
	[-001,-001,-001,-001,-001,-001,-001,-001,-001,-001,-001,-001,-001,-001,-001,-001,-001,-001,-001,-001,-001],
	[-001,-001,-001,-001,-001,-001,-001,-001,-001,-001,-001,-001,-001,-001,-001,-001,-001,-001,-001,-001,-001],
	[-001,-001,-001,-001,-001,-001,-001,-001,-001,-001,-001,-001,-001,-001,-001,-001,-001,-001,-001,-001,-001],
	[-001,-001,-001,-001,-001,-001,-001,-001,-001,-001,-001,-001,-001,-001,-001,-001,-001,-001,-001,-001,-001],
	[-001,-001,-001,-001,-001,-001,-001,-001,-001,-001,-001,-001,-001,-001,-001,-001,-001,-001,-001,-001,-001],
	[-001,-001,-001,-001,-001,-001,-001,-001,-001,-001,-001,-001,-001,-001,-001,-001,-001,-001,-001,-001,-001],
	[-001,-001,-001,-001,-001,-001,-001,-001,-001,-001,-001,-001,-001,-001,-001,-001,-001,-001,-001,-001,-001],
	[-001,-001,-001,-001,-001,-001,-001,-001,-001,-001,-001,-001,-001,-001,-001,-001,-001,-001,-001,-001,-001],
	[-001,-001,-001,-001,-001,-001,-001,-001,-001,-001,-001,-001,-001,-001,-001,-001,-001,-001,-001,-001,-001],
	[-001,-001,-001,-001,-001,-001,-001,-001,-001,-001,-001,-001,-001,-001,-001,-001,-001,-001,-001,-001,-001],
	[-001,-001,-001,-001,-001,-001,-001,-001,-001,-001,-001,-001,-001,-001,-001,-001,-001,-001,-001,-001,-001],
	[-001,-001,-001,-001,-001,-001,-001,-001,-001,-001,-001,-001,-001,-001,-001,-001,-001,-001,-001,-001,-001],
	[-001,-001,-001,-001,-001,-001,-001,-001,-001,-001,-001,-001,-001,-001,-001,-001,-001,-001,-001,-001,-001],
	[-001,-001,-001,-001,-001,-001,-001,-001,-001,-001,-001,-001,-001,-001,-001,-001,-001,-001,-001,-001,-001]
	],
	"events": [
	{
		"id": 5,
		"nom": "EV005",
		"x": 3,
		"y": 1,
		"pages": [
		{
			"conditions": [
			{
				"nom": "ArriveeAuContact"
			}
			],
			"commandes": [
			{
				"nom": "ChangerDeMap",
				"variable": false,
				"numeroNouvelleMap": 751,
				"xDebutHeros": 18,
				"yDebutHeros": 12
			}
			],
			"vitesse": "moderee",
			"frequence": "basse",
			"animeEnMouvement": true,
			"animeALArret": false,
			"directionFixe": false,
			"traversable": false,
			"auDessusDeTout": false
		}
		]
	},
	{
		"id": 6,
		"nom": "EV006",
		"x": 2,
		"y": 2,
		"pages": [
		{
			"conditions": [
			{
				"nom": "ArriveeAuContact"
			}
			],
			"commandes": [
			{
				"nom": "ChangerDeMap",
				"variable": false,
				"numeroNouvelleMap": 751,
				"xDebutHeros": 18,
				"yDebutHeros": 12
			}
			],
			"vitesse": "moderee",
			"frequence": "basse",
			"animeEnMouvement": true,
			"animeALArret": false,
			"directionFixe": false,
			"traversable": false,
			"auDessusDeTout": false
		}
		]
	},
	{
		"id": 1,
		"nom": "EV001",
		"x": 10,
		"y": 14,
		"pages": [
		{
			"conditions": [
			{
				"nom": "ArriveeAuContact"
			}
			],
			"commandes": [
			{
				"nom": "ChangerDeMap",
				"variable": false,
				"numeroNouvelleMap": 684,
				"xDebutHeros": 10,
				"yDebutHeros": 3
			}
			],
			"vitesse": "moderee",
			"frequence": "basse",
			"animeEnMouvement": true,
			"animeALArret": false,
			"directionFixe": false,
			"traversable": false,
			"auDessusDeTout": false
		}
		]
	},
	{
		"id": 2,
		"nom": "Pancarte",
		"x": 5,
		"y": 2,
		"pages": [
		{
			"conditions": [
			{
				"nom": "Parler"
			}
			],
			"commandes": [
			{
				"nom": "ConditionDirection",
				"idEventConcerne": 0,
				"direction": 3,
				"numero": 0
			},
			{
				"nom": "ModifierInterrupteur",
				"numeroInterrupteur": 12,
				"valeur": true
			},
			{
				"nom": "Commentaire",
				"texte": "(en) 2546"
			},
			{
				"nom": "Message",
				"texte": "2546"
			},
			{
				"nom": "Attendre",
				"nombreDeFrames": 8
			},
			{
				"nom": "ConditionFin",
				"numero": 0
			},
			{
				"nom": "ModifierInterrupteur",
				"numeroInterrupteur": 12,
				"valeur": false
			}
			],
			"vitesse": "moderee",
			"frequence": "basse",
			"animeEnMouvement": false,
			"animeALArret": false,
			"directionFixe": false,
			"traversable": false,
			"auDessusDeTout": false
		}
		]
	},
	{
		"id": 3,
		"nom": "Pancarte",
		"x": 15,
		"y": 2,
		"pages": [
		{
			"conditions": [
			{
				"nom": "Parler"
			}
			],
			"commandes": [
			{
				"nom": "ConditionDirection",
				"idEventConcerne": 0,
				"direction": 3,
				"numero": 0
			},
			{
				"nom": "ModifierInterrupteur",
				"numeroInterrupteur": 12,
				"valeur": true
			},
			{
				"nom": "Commentaire",
				"texte": "(en) 8741"
			},
			{
				"nom": "Message",
				"texte": "8741"
			},
			{
				"nom": "Attendre",
				"nombreDeFrames": 8
			},
			{
				"nom": "ConditionFin",
				"numero": 0
			},
			{
				"nom": "ModifierInterrupteur",
				"numeroInterrupteur": 12,
				"valeur": false
			}
			],
			"vitesse": "moderee",
			"frequence": "basse",
			"animeEnMouvement": false,
			"animeALArret": false,
			"directionFixe": false,
			"traversable": false,
			"auDessusDeTout": false
		}
		]
	},
	{
		"id": 4,
		"nom": "musique",
		"x": 11,
		"y": 14,
		"pages": [
		{
			"conditions": [
			],
			"commandes": [
			{
				"nom": "ConditionInterrupteur",
				"numeroInterrupteur": 134,
				"valeurQuIlEstCenseAvoir": false,
				"numero": 0
			},
			{
				"nom": "JouerMusique",
				"nomFichierSonore": "Temple de Kujira 2.ogg",
				"volume": 1.00,
				"tempo": 1.00
			},
			{
				"nom": "ConditionSinon",
				"numero": 0
			},
			{
				"nom": "JouerMusique",
				"nomFichierSonore": "Temple de Kujira.ogg",
				"volume": 1.00,
				"tempo": 1.00
			},
			{
				"nom": "ConditionFin",
				"numero": 0
			},
			{
				"nom": "SupprimerEvent"
			}
			],
			"vitesse": "moderee",
			"frequence": "basse",
			"animeEnMouvement": true,
			"animeALArret": false,
			"directionFixe": false,
			"traversable": false,
			"auDessusDeTout": false
		}
		]
	}
	]
}
