{
	"nom": "Paradis de la Poterie",
	"tileset": "Maison",
	"largeur": 21,
	"hauteur": 15,
	"musique": {
		"nomFichierSonore": "Marchand du desert.ogg",
		"volume": 0.90,
		"tempo": 1.00
	},
	"fondSonore": {
		"nomFichierSonore": "001-Wind01.ogg",
		"volume": 0.00,
		"tempo": 1.00
	},
	"couche0": [
	[0017,0017,0017,0017,0017,0017,0017,0017,0017,0017,0017,0017,0017,0017,0017,0017,0017,0017,0017,0017,0017],
	[0017,0017,0017,0017,0017,0340,0341,0308,0309,0308,0309,0308,0309,0309,0342,0343,0017,0017,0017,0017,0017],
	[0017,0017,0017,0017,0017,0348,0349,0316,0317,0316,0317,0316,0317,0317,0350,0351,0017,0017,0017,0017,0017],
	[0017,0017,0017,0017,0017,0324,0325,0000,0000,0000,0000,0000,0000,0000,0310,0311,0017,0017,0017,0017,0017],
	[0017,0017,0017,0017,0017,0332,0333,0301,0000,0000,0000,0000,0000,0000,0318,0319,0017,0017,0017,0017,0017],
	[0017,0017,0017,0017,0017,0324,0325,0000,0000,0000,0000,0000,0000,0000,0310,0311,0017,0017,0017,0017,0017],
	[0017,0017,0017,0017,0017,0332,0333,0000,0000,0000,0000,0000,0000,0000,0318,0319,0017,0017,0017,0017,0017],
	[0017,0017,0017,0017,0017,0324,0325,0000,-008,-008,-008,-008,-008,0000,0310,0311,0017,0017,0017,0017,0017],
	[0017,0017,0017,0017,0017,0332,0333,0000,-008,-008,-008,-008,-008,0000,0318,0319,0017,0017,0017,0017,0017],
	[0017,0017,0017,0017,0017,0324,0325,0000,-008,-008,-008,-008,-008,0000,0310,0311,0017,0017,0017,0017,0017],
	[0017,0017,0017,0017,0017,0332,0333,0301,-008,-008,-008,-008,-008,0000,0318,0319,0017,0017,0017,0017,0017],
	[0017,0017,0017,0017,0017,0324,0325,0000,0000,0000,0000,0000,0000,0000,0310,0311,0017,0017,0017,0017,0017],
	[0017,0017,0017,0017,0017,0356,0357,0326,0327,0384,0023,0386,0326,0327,0358,0359,0017,0017,0017,0017,0017],
	[0017,0017,0017,0017,0017,0364,0365,0334,0335,0392,0393,0394,0334,0335,0366,0367,0017,0017,0017,0017,0017],
	[0017,0017,0017,0017,0017,0017,0017,0017,0017,0017,0017,0017,0017,0017,0017,0017,0017,0017,0017,0017,0017]
	],
	"couche1": [
	[-001,-001,-001,-001,-001,-001,-001,-001,-001,-001,-001,-001,-001,-001,-001,-001,-001,-001,-001,-001,-001],
	[-001,-001,-001,-001,-001,-001,-001,-001,-001,0053,0054,0055,-001,-001,-001,-001,-001,-001,-001,-001,-001],
	[-001,-001,-001,-001,-001,-001,-001,-001,-001,0061,0062,0063,-001,-001,-001,-001,-001,-001,-001,-001,-001],
	[-001,-001,-001,-001,-001,0555,0556,-001,-001,-001,-001,-001,-001,-001,-001,-001,-001,-001,-001,-001,-001],
	[-001,-001,-001,-001,-001,0563,0564,-001,-001,-001,-001,-001,-001,-001,-001,-001,-001,-001,-001,-001,-001],
	[-001,-001,-001,-001,-001,0571,0572,-001,-001,-001,-001,-001,-001,-001,-001,-001,-001,-001,-001,-001,-001],
	[-001,-001,-001,-001,-001,-001,-001,-001,-001,-001,-001,-001,-001,-001,-001,-001,-001,-001,-001,-001,-001],
	[-001,-001,-001,-001,-001,-001,-001,-001,-001,-001,-001,-001,-001,-001,-001,-001,-001,-001,-001,-001,-001],
	[-001,-001,-001,-001,-001,-001,-001,-001,-001,0005,0006,0007,-001,-001,-001,-001,-001,-001,-001,-001,-001],
	[-001,-001,-001,-001,-001,0555,0556,-001,-001,0013,0014,0015,-001,-001,-001,-001,-001,-001,-001,-001,-001],
	[-001,-001,-001,-001,-001,0563,0564,-001,-001,-001,-001,-001,-001,-001,-001,-001,-001,-001,-001,-001,-001],
	[-001,-001,-001,-001,-001,0571,0572,-001,-001,-001,-001,-001,-001,-001,-001,-001,-001,-001,-001,-001,-001],
	[-001,-001,-001,-001,-001,-001,-001,-001,-001,-001,-001,-001,-001,-001,-001,-001,-001,-001,-001,-001,-001],
	[-001,-001,-001,-001,-001,-001,-001,-001,-001,-001,-001,-001,-001,-001,-001,-001,-001,-001,-001,-001,-001],
	[-001,-001,-001,-001,-001,-001,-001,-001,-001,-001,-001,-001,-001,-001,-001,-001,-001,-001,-001,-001,-001]
	],
	"couche2": [
	[-001,-001,-001,-001,-001,-001,-001,-001,-001,-001,-001,-001,-001,-001,-001,-001,-001,-001,-001,-001,-001],
	[-001,-001,-001,-001,-001,-001,-001,-001,-001,-001,-001,-001,-001,-001,-001,-001,-001,-001,-001,-001,-001],
	[-001,-001,-001,-001,-001,-001,-001,-001,-001,-001,-001,-001,-001,-001,-001,-001,-001,-001,-001,-001,-001],
	[-001,-001,-001,-001,-001,-001,-001,-001,-001,-001,-001,-001,-001,-001,-001,-001,-001,-001,-001,-001,-001],
	[-001,-001,-001,-001,-001,-001,-001,-001,-001,-001,-001,-001,-001,-001,-001,-001,-001,-001,-001,-001,-001],
	[-001,-001,-001,-001,-001,-001,-001,-001,-001,-001,-001,-001,-001,-001,-001,-001,-001,-001,-001,-001,-001],
	[-001,-001,-001,-001,-001,-001,-001,-001,-001,-001,-001,-001,-001,-001,-001,-001,-001,-001,-001,-001,-001],
	[-001,-001,-001,-001,-001,-001,-001,-001,-001,-001,-001,-001,-001,-001,-001,-001,-001,-001,-001,-001,-001],
	[-001,-001,-001,-001,-001,-001,-001,-001,-001,-001,-001,0043,-001,-001,-001,-001,-001,-001,-001,-001,-001],
	[-001,-001,-001,-001,-001,-001,-001,-001,-001,-001,-001,-001,-001,-001,-001,-001,-001,-001,-001,-001,-001],
	[-001,-001,-001,-001,-001,-001,-001,-001,-001,-001,-001,-001,-001,-001,-001,-001,-001,-001,-001,-001,-001],
	[-001,-001,-001,-001,-001,-001,-001,-001,-001,-001,-001,-001,-001,-001,-001,-001,-001,-001,-001,-001,-001],
	[-001,-001,-001,-001,-001,-001,-001,-001,-001,-001,-001,-001,-001,-001,-001,-001,-001,-001,-001,-001,-001],
	[-001,-001,-001,-001,-001,-001,-001,-001,-001,-001,-001,-001,-001,-001,-001,-001,-001,-001,-001,-001,-001],
	[-001,-001,-001,-001,-001,-001,-001,-001,-001,-001,-001,-001,-001,-001,-001,-001,-001,-001,-001,-001,-001]
	],
	"events": [
	{
		"id": 5,
		"nom": "Clone[341][004]",
		"x": 10,
		"y": 5
	},
	{
		"id": 16,
		"nom": "Clone[341][004]",
		"x": 10,
		"y": 6
	},
	{
		"id": 27,
		"nom": "marchand",
		"x": 10,
		"y": 7,
		"pages": [
		{
			"conditions": [
			{
				"nom": "Parler"
			}
			],
			"commandes": [
			{
				"nom": "ModifierInterrupteur",
				"numeroInterrupteur": 12,
				"valeur": true
			},
			{
				"nom": "Commentaire",
				"texte": "(en) Welcome to Pottery Heaven!"
			},
			{
				"nom": "Message",
				"texte": "Bienvenue au Paradis de la Poterie !"
			},
			{
				"nom": "Commentaire",
				"texte": "(en) This pottery is imported from\\nHummingbird village."
			},
			{
				"nom": "Message",
				"texte": "Ces poteries sont importées du village colibri."
			},
			{
				"nom": "Attendre",
				"nombreDeFrames": 8
			},
			{
				"nom": "ModifierInterrupteur",
				"numeroInterrupteur": 12,
				"valeur": false
			}
			],
			"image": "arabe character",
			"vitesse": "moderee",
			"frequence": "basse",
			"animeEnMouvement": false,
			"animeALArret": true,
			"directionFixe": true,
			"traversable": false,
			"auDessusDeTout": false
		}
		]
	},
	{
		"id": 11,
		"nom": "Clone[341][003]",
		"x": 12,
		"y": 5
	},
	{
		"id": 22,
		"nom": "Clone[341][004]",
		"x": 7,
		"y": 5
	},
	{
		"id": 28,
		"nom": "Clone[341][165]",
		"x": 9,
		"y": 8
	},
	{
		"id": 6,
		"nom": "Clone[341][004]",
		"x": 9,
		"y": 5
	},
	{
		"id": 17,
		"nom": "Clone[341][004]",
		"x": 9,
		"y": 6
	},
	{
		"id": 1,
		"nom": "EV001",
		"x": 10,
		"y": 13,
		"pages": [
		{
			"conditions": [
			{
				"nom": "ArriveeAuContact"
			}
			],
			"commandes": [
			{
				"nom": "ChangerDeMap",
				"variable": false,
				"numeroNouvelleMap": 188,
				"xDebutHeros": 16,
				"yDebutHeros": 32
			}
			],
			"vitesse": "moderee",
			"frequence": "basse",
			"animeEnMouvement": true,
			"animeALArret": false,
			"directionFixe": false,
			"traversable": false,
			"auDessusDeTout": false
		}
		]
	},
	{
		"id": 12,
		"nom": "Clone[341][004]",
		"x": 8,
		"y": 4
	},
	{
		"id": 23,
		"nom": "Clone[341][003]",
		"x": 13,
		"y": 3
	},
	{
		"id": 7,
		"nom": "Clone[341][004]",
		"x": 9,
		"y": 4
	},
	{
		"id": 18,
		"nom": "Clone[341][004]",
		"x": 12,
		"y": 6
	},
	{
		"id": 2,
		"nom": "Clone[341][004]",
		"x": 10,
		"y": 4
	},
	{
		"id": 13,
		"nom": "Clone[341][004]",
		"x": 9,
		"y": 3
	},
	{
		"id": 24,
		"nom": "Clone[341][003]",
		"x": 7,
		"y": 3
	},
	{
		"id": 8,
		"nom": "Clone[341][003]",
		"x": 10,
		"y": 3
	},
	{
		"id": 19,
		"nom": "Clone[341][004]",
		"x": 13,
		"y": 5
	},
	{
		"id": 3,
		"nom": "Clone[341][004]",
		"x": 11,
		"y": 4
	},
	{
		"id": 14,
		"nom": "Clone[341][004]",
		"x": 11,
		"y": 3
	},
	{
		"id": 25,
		"nom": "Clone[341][004]",
		"x": 8,
		"y": 3
	},
	{
		"id": 9,
		"nom": "Clone[341][003]",
		"x": 8,
		"y": 5
	},
	{
		"id": 20,
		"nom": "Clone[341][004]",
		"x": 13,
		"y": 4
	},
	{
		"id": 4,
		"nom": "Clone[341][004]",
		"x": 11,
		"y": 5
	},
	{
		"id": 26,
		"nom": "Clone[341][004]",
		"x": 12,
		"y": 3
	},
	{
		"id": 15,
		"nom": "Clone[341][006]",
		"x": 12,
		"y": 4
	},
	{
		"id": 10,
		"nom": "Clone[341][003]",
		"x": 11,
		"y": 6
	},
	{
		"id": 21,
		"nom": "Clone[341][004]",
		"x": 8,
		"y": 6
	}
	]
}
