{
	"nom": "Bibliothèque",
	"tileset": "Maison",
	"largeur": 21,
	"hauteur": 25,
	"musique": {
		"nomFichierSonore": "",
		"volume": 1.00,
		"tempo": 1.00
	},
	"fondSonore": {
		"nomFichierSonore": "",
		"volume": 0.80,
		"tempo": 1.00
	},
	"couche0": [
	[0017,0017,0017,0017,0017,0017,0017,0017,0017,0017,0017,0017,0017,0017,0017,0017,0017,0017,0017,0017,0017],
	[0017,0017,0017,0017,0017,0017,0017,0017,0017,0017,0017,0017,0017,0017,0017,0017,0017,0017,0017,0017,0017],
	[0017,0017,0017,0017,0017,0017,0017,0017,0017,0017,0017,0017,0017,0017,0017,0017,0017,0017,0017,0017,0017],
	[0017,0017,0017,0017,0017,0017,0017,0017,0017,0017,0017,0017,0017,0017,0017,0017,0017,0017,0017,0017,0017],
	[0017,0017,0017,0017,0017,0017,0017,0017,0017,0017,0017,0017,0017,0017,0017,0017,0017,0017,0017,0017,0017],
	[0017,0017,0017,0017,0017,0017,0017,0017,0017,0340,0341,0308,0309,0308,0309,0308,0309,0342,0343,0017,0017],
	[0017,0017,0017,0017,0017,0017,0017,0017,0017,0348,0349,0316,0317,0316,0317,0316,0317,0350,0351,0017,0017],
	[0017,0017,0017,0017,0017,0017,0017,0017,0017,0324,0325,0000,0000,0000,0000,0000,0000,0310,0311,0017,0017],
	[0017,0017,0017,0017,0017,0017,0017,0017,0017,0332,0333,0000,0000,0000,0000,0000,0000,0318,0319,0017,0017],
	[0017,0017,0340,0341,0308,0309,0308,0309,0308,0390,0391,0000,0000,0000,0000,0000,0000,0310,0311,0017,0017],
	[0017,0017,0348,0349,0316,0317,0316,0317,0316,0398,0399,0000,0000,0000,0000,0000,0000,0318,0319,0017,0017],
	[0017,0017,0324,0325,0000,0000,0000,0000,0000,0000,0000,0000,0000,0000,0000,0000,0000,0310,0311,0017,0017],
	[0017,0017,0332,0333,0000,0000,0000,0000,0000,0000,0000,0000,0000,0000,0000,0000,0000,0318,0319,0017,0017],
	[0017,0017,0324,0325,0000,0000,0000,0000,0000,0000,0000,0000,0000,0000,0000,0000,0000,0310,0311,0017,0017],
	[0017,0017,0332,0333,0000,0000,0000,0000,0000,0000,0000,0000,0000,0000,0000,0000,0000,0318,0319,0017,0017],
	[0017,0017,0324,0325,0000,0000,0301,0000,0000,0000,0000,0000,0000,0000,0000,0000,0000,0310,0311,0017,0017],
	[0017,0017,0356,0357,0326,0327,0326,0327,0326,0327,0326,0384,0023,0386,0326,0327,0326,0358,0359,0017,0017],
	[0017,0017,0364,0365,0334,0335,0334,0335,0334,0335,0334,0392,0393,0394,0334,0335,0334,0366,0367,0017,0017],
	[0017,0017,0017,0017,0017,0017,0017,0017,0017,0017,0017,0017,0017,0017,0017,0017,0017,0017,0017,0017,0017],
	[0017,0017,0017,0017,0017,0017,0017,0017,0017,0017,0017,0017,0017,0017,0017,0017,0017,0017,0017,0017,0017],
	[0017,0017,0017,0017,0017,0017,0017,0017,0017,0017,0017,0017,0017,0017,0017,0017,0017,0017,0017,0017,0017],
	[0017,0017,0017,0017,0017,0017,0017,0017,0017,0017,0017,0017,0017,0017,0017,0017,0017,0017,0017,0017,0017],
	[0017,0017,0017,0017,0017,0017,0017,0017,0017,0017,0017,0017,0017,0017,0017,0017,0017,0017,0017,0017,0017],
	[0017,0017,0017,0017,0017,0017,0017,0017,0017,0017,0017,0017,0017,0017,0017,0017,0017,0017,0017,0017,0017],
	[0017,0017,0017,0017,0017,0017,0017,0017,0017,0017,0017,0017,0017,0017,0017,0017,0017,0017,0017,0017,0017]
	],
	"couche1": [
	[-001,-001,-001,-001,-001,-001,-001,-001,-001,-001,-001,-001,-001,-001,-001,-001,-001,-001,-001,-001,-001],
	[-001,-001,-001,-001,-001,-001,-001,-001,-001,-001,-001,-001,-001,-001,-001,-001,-001,-001,-001,-001,-001],
	[-001,-001,-001,-001,-001,-001,-001,-001,-001,-001,-001,-001,-001,-001,-001,-001,-001,-001,-001,-001,-001],
	[-001,-001,-001,-001,-001,-001,-001,-001,-001,-001,-001,-001,-001,-001,-001,-001,-001,-001,-001,-001,-001],
	[-001,-001,-001,-001,-001,-001,-001,-001,-001,-001,-001,-001,-001,-001,-001,-001,-001,-001,-001,-001,-001],
	[-001,-001,-001,-001,-001,-001,-001,-001,-001,-001,-001,0003,0004,0003,0004,0003,0004,-001,-001,-001,-001],
	[-001,-001,-001,-001,-001,-001,-001,-001,-001,-001,-001,0011,0012,0011,0012,0011,0012,-001,-001,-001,-001],
	[-001,-001,-001,-001,-001,-001,-001,-001,-001,-001,-001,0019,0020,0019,0020,0019,0020,-001,-001,-001,-001],
	[-001,-001,-001,-001,-001,-001,-001,-001,-001,-001,-001,-001,-001,-001,-001,-001,0002,-001,-001,-001,-001],
	[-001,-001,-001,-001,0003,0004,0003,0004,0003,0004,-001,-001,-001,0003,0004,0003,0004,-001,-001,-001,-001],
	[-001,-001,-001,-001,0011,0012,0011,0012,0011,0012,-001,-001,-001,0011,0012,0011,0012,-001,-001,-001,-001],
	[-001,-001,-001,-001,0019,0020,0019,0020,0019,0020,-001,-001,-001,0019,0020,0019,0020,-001,-001,-001,-001],
	[-001,-001,-001,-001,-001,-001,-001,-001,-001,-001,-001,-001,-001,-001,-001,-001,-001,-001,-001,-001,-001],
	[-001,-001,-001,-001,-001,-001,-001,-001,0584,-001,-001,-001,-001,-001,-001,-001,-001,-001,-001,-001,-001],
	[-001,-001,-001,-001,0584,-001,-001,-001,0592,0584,-001,-001,-001,-001,0005,0007,-001,-001,-001,-001,-001],
	[-001,-001,-001,-001,0600,-001,-001,-001,0600,0600,-001,-001,-001,-001,0013,0015,-001,-001,-001,-001,-001],
	[-001,-001,-001,-001,-001,0552,0553,0554,-001,-001,-001,-001,-001,-001,-001,-001,-001,-001,-001,-001,-001],
	[-001,-001,-001,-001,-001,0560,0561,0562,-001,-001,-001,-001,-001,-001,-001,-001,-001,-001,-001,-001,-001],
	[-001,-001,-001,-001,-001,-001,-001,-001,-001,-001,-001,-001,-001,-001,-001,-001,-001,-001,-001,-001,-001],
	[-001,-001,-001,-001,-001,-001,-001,-001,-001,-001,-001,-001,-001,-001,-001,-001,-001,-001,-001,-001,-001],
	[-001,-001,-001,-001,-001,-001,-001,-001,-001,-001,-001,-001,-001,-001,-001,-001,-001,-001,-001,-001,-001],
	[-001,-001,-001,-001,-001,-001,-001,-001,-001,-001,-001,-001,-001,-001,-001,-001,-001,-001,-001,-001,-001],
	[-001,-001,-001,-001,-001,-001,-001,-001,-001,-001,-001,-001,-001,-001,-001,-001,-001,-001,-001,-001,-001],
	[-001,-001,-001,-001,-001,-001,-001,-001,-001,-001,-001,-001,-001,-001,-001,-001,-001,-001,-001,-001,-001],
	[-001,-001,-001,-001,-001,-001,-001,-001,-001,-001,-001,-001,-001,-001,-001,-001,-001,-001,-001,-001,-001]
	],
	"couche2": [
	[-001,-001,-001,-001,-001,-001,-001,-001,-001,-001,-001,-001,-001,-001,-001,-001,-001,-001,-001,-001,-001],
	[-001,-001,-001,-001,-001,-001,-001,-001,-001,-001,-001,-001,-001,-001,-001,-001,-001,-001,-001,-001,-001],
	[-001,-001,-001,-001,-001,-001,-001,-001,-001,-001,-001,-001,-001,-001,-001,-001,-001,-001,-001,-001,-001],
	[-001,-001,-001,-001,-001,-001,-001,-001,-001,-001,-001,-001,-001,-001,-001,-001,-001,-001,-001,-001,-001],
	[-001,-001,-001,-001,-001,-001,-001,-001,-001,-001,-001,-001,-001,-001,-001,-001,-001,-001,-001,-001,-001],
	[-001,-001,-001,-001,-001,-001,-001,-001,-001,-001,-001,-001,-001,-001,-001,-001,-001,-001,-001,-001,-001],
	[-001,-001,-001,-001,-001,-001,-001,-001,-001,-001,-001,-001,-001,-001,-001,-001,-001,-001,-001,-001,-001],
	[-001,-001,-001,-001,-001,-001,-001,-001,-001,-001,-001,-001,-001,-001,-001,-001,-001,-001,-001,-001,-001],
	[-001,-001,-001,-001,-001,-001,-001,-001,-001,-001,-001,-001,-001,-001,-001,-001,-001,-001,-001,-001,-001],
	[-001,-001,-001,-001,-001,-001,-001,-001,-001,-001,-001,-001,-001,-001,-001,-001,-001,-001,-001,-001,-001],
	[-001,-001,-001,-001,-001,-001,-001,-001,-001,-001,-001,-001,-001,-001,-001,-001,-001,-001,-001,-001,-001],
	[-001,-001,-001,-001,-001,0584,-001,-001,-001,-001,-001,-001,-001,-001,-001,-001,-001,-001,-001,-001,-001],
	[-001,-001,-001,-001,-001,0600,-001,-001,-001,-001,-001,-001,-001,-001,-001,-001,-001,-001,-001,-001,-001],
	[-001,-001,-001,-001,-001,-001,-001,-001,-001,-001,-001,-001,-001,-001,-001,-001,-001,-001,-001,-001,-001],
	[-001,-001,-001,-001,-001,-001,-001,-001,-001,-001,-001,-001,-001,-001,0051,0052,-001,-001,-001,-001,-001],
	[-001,-001,-001,-001,-001,-001,-001,-001,-001,-001,-001,-001,-001,-001,0059,0060,-001,-001,-001,-001,-001],
	[-001,-001,-001,-001,-001,-001,-001,-001,-001,-001,-001,-001,-001,-001,-001,-001,-001,-001,-001,-001,-001],
	[-001,-001,-001,-001,-001,-001,-001,-001,-001,-001,-001,-001,-001,-001,-001,-001,-001,-001,-001,-001,-001],
	[-001,-001,-001,-001,-001,-001,-001,-001,-001,-001,-001,-001,-001,-001,-001,-001,-001,-001,-001,-001,-001],
	[-001,-001,-001,-001,-001,-001,-001,-001,-001,-001,-001,-001,-001,-001,-001,-001,-001,-001,-001,-001,-001],
	[-001,-001,-001,-001,-001,-001,-001,-001,-001,-001,-001,-001,-001,-001,-001,-001,-001,-001,-001,-001,-001],
	[-001,-001,-001,-001,-001,-001,-001,-001,-001,-001,-001,-001,-001,-001,-001,-001,-001,-001,-001,-001,-001],
	[-001,-001,-001,-001,-001,-001,-001,-001,-001,-001,-001,-001,-001,-001,-001,-001,-001,-001,-001,-001,-001],
	[-001,-001,-001,-001,-001,-001,-001,-001,-001,-001,-001,-001,-001,-001,-001,-001,-001,-001,-001,-001,-001],
	[-001,-001,-001,-001,-001,-001,-001,-001,-001,-001,-001,-001,-001,-001,-001,-001,-001,-001,-001,-001,-001]
	],
	"events": [
	{
		"id": 1,
		"nom": "EV001",
		"x": 12,
		"y": 17,
		"pages": [
		{
			"conditions": [
			{
				"nom": "ArriveeAuContact"
			}
			],
			"commandes": [
			{
				"nom": "ChangerDeMap",
				"variable": false,
				"numeroNouvelleMap": 188,
				"xDebutHeros": 26,
				"yDebutHeros": 29
			}
			],
			"vitesse": "moderee",
			"frequence": "basse",
			"animeEnMouvement": true,
			"animeALArret": false,
			"directionFixe": false,
			"traversable": false,
			"auDessusDeTout": false
		}
		]
	},
	{
		"id": 2,
		"nom": "Viking",
		"x": 16,
		"y": 14,
		"pages": [
		{
			"conditions": [
			{
				"nom": "Parler"
			}
			],
			"commandes": [
			{
				"nom": "ModifierInterrupteur",
				"numeroInterrupteur": 12,
				"valeur": true
			},
			{
				"nom": "JouerEffetSonore",
				"nomFichierSonore": "viking2 vieux.ogg",
				"volume": 1.00,
				"tempo": 1.00
			},
			{
				"nom": "AppelerUnScript",
				"script": "$game_temp.faceset = \"viking vieux\""
			},
			{
				"nom": "Message",
				"texte": "Elle, là-bas, elle a emprunté un livre \\nil y a 6 mois et elle ne l'a toujours pas rendu."
			},
			{
				"nom": "Message",
				"texte": "On lui a envoyé des courriers pour qu'elle \\nvienne le rendre, mais ça n'a servi à rien."
			},
			{
				"nom": "Message",
				"texte": "Au début je me demandais ce qui pouvait bien \\nse passer dans sa tête..."
			},
			{
				"nom": "Deplacement",
				"ignorerLesMouvementsImpossibles": false,
				"repeterLeDeplacement": false,
				"attendreLaFinDuDeplacement": false,
				"mouvements": [
				{
					"nom": "Sauter",
					"x": 0,
					"y": 0
				},
				{
					"nom": "AppelerUneCommande",
					"nomCommande": "Attendre",
					"nombreDeFrames": 1
				},
				{
					"nom": "Sauter",
					"x": 0,
					"y": 0
				}
				]
			},
			{
				"nom": "Message",
				"texte": "...mais maintenant j'ai juste envie qu'elle me \\nrende mon livre !"
			},
			{
				"nom": "Attendre",
				"nombreDeFrames": 8
			},
			{
				"nom": "ModifierInterrupteur",
				"numeroInterrupteur": 12,
				"valeur": false
			}
			],
			"image": "viking vieux character",
			"directionInitiale": 1,
			"vitesse": "lente",
			"frequence": "tres basse",
			"animeEnMouvement": true,
			"animeALArret": false,
			"directionFixe": false,
			"traversable": false,
			"auDessusDeTout": false
		}
		]
	},
	{
		"id": 3,
		"nom": "Viking",
		"x": 5,
		"y": 13,
		"pages": [
		{
			"conditions": [
			{
				"nom": "Parler"
			}
			],
			"commandes": [
			{
				"nom": "ModifierInterrupteur",
				"numeroInterrupteur": 12,
				"valeur": true
			},
			{
				"nom": "JouerEffetSonore",
				"nomFichierSonore": "Viking2 femme.ogg",
				"volume": 1.00,
				"tempo": 1.00
			},
			{
				"nom": "AppelerUnScript",
				"script": "$game_temp.faceset = \"viking jaune femme\""
			},
			{
				"nom": "JouerAnimation",
				"idAnimation": 42
			},
			{
				"nom": "Message",
				"texte": "\\SHAKE J'ai trop honte !"
			},
			{
				"nom": "Message",
				"texte": "J'ai oublié de rendre un livre après un mois.\\nComme j'étais en retard, j'avais trop honte \\nde venir le rendre !"
			},
			{
				"nom": "Message",
				"texte": "J'ai attendu encore plus, et ça ne faisait que \\nme rendre encore plus en retard, et me rendre \\nencore plus honteuse !"
			},
			{
				"nom": "Message",
				"texte": "Aujourd'hui, j'ai pris mon courage à deux \\nmains et je suis venu le rendre."
			},
			{
				"nom": "Message",
				"texte": "\\SHAKE Mais je n'ose toujours pas."
			},
			{
				"nom": "JouerEffetSonore",
				"nomFichierSonore": "Viking1 femme.ogg",
				"volume": 1.00,
				"tempo": 1.00
			},
			{
				"nom": "Message",
				"texte": "Finalement, peut-être que je devrais prétendre \\nl'avoir perdu ?"
			},
			{
				"nom": "Attendre",
				"nombreDeFrames": 8
			},
			{
				"nom": "ModifierInterrupteur",
				"numeroInterrupteur": 12,
				"valeur": false
			}
			],
			"deplacement": {
				"nom": "Deplacement",
				"ignorerLesMouvementsImpossibles": false,
				"repeterLeDeplacement": true,
				"attendreLaFinDuDeplacement": false,
				"mouvements": [
				{
					"nom": "Avancer",
					"direction": 0,
					"nombreDeCarreaux": 1
				},
				{
					"nom": "Avancer",
					"direction": 0,
					"nombreDeCarreaux": 1
				},
				{
					"nom": "Avancer",
					"direction": 2,
					"nombreDeCarreaux": 1
				},
				{
					"nom": "Avancer",
					"direction": 2,
					"nombreDeCarreaux": 1
				},
				{
					"nom": "Avancer",
					"direction": 3,
					"nombreDeCarreaux": 1
				},
				{
					"nom": "Avancer",
					"direction": 3,
					"nombreDeCarreaux": 1
				},
				{
					"nom": "Avancer",
					"direction": 1,
					"nombreDeCarreaux": 1
				},
				{
					"nom": "Avancer",
					"direction": 1,
					"nombreDeCarreaux": 1
				}
				]
			},
			"image": "viking2 femme petit character",
			"directionInitiale": 1,
			"vitesse": "moderee",
			"frequence": "basse",
			"animeEnMouvement": true,
			"animeALArret": false,
			"directionFixe": false,
			"traversable": false,
			"auDessusDeTout": false
		}
		]
	}
	]
}
