{
	"nom": "Auberge",
	"tileset": "Maison",
	"largeur": 21,
	"hauteur": 15,
	"musique": {
		"nomFichierSonore": "Maison 2.ogg",
		"volume": 1.00,
		"tempo": 1.00
	},
	"fondSonore": {
		"nomFichierSonore": "001-Wind01.ogg",
		"volume": 0.00,
		"tempo": 1.00
	},
	"couche0": [
	[0017,0017,0017,0017,0017,0017,0017,0017,0017,0017,0017,0017,0017,0017,0017,0017,0017,0017,0017,0017,0017],
	[0017,0017,0017,0017,0017,0017,0017,0017,0017,0017,0017,0017,0017,0017,0017,0017,0017,0017,0017,0017,0017],
	[0017,0017,0017,0340,0341,0308,0309,0308,0309,0308,0309,0308,0309,0308,0309,0308,0342,0343,0017,0017,0017],
	[0017,0017,0017,0348,0349,0316,0317,0316,0317,0316,0317,0316,0317,0316,0317,0316,0350,0351,0017,0017,0017],
	[0017,0017,0017,0332,0333,0000,0000,0000,0000,0000,0000,0000,0000,0000,0000,0000,0318,0319,0017,0017,0017],
	[0017,0017,0017,0332,0333,0000,0000,0000,0000,0000,0000,0000,0000,0000,0000,0000,0318,0319,0017,0017,0017],
	[0017,0017,0017,0324,0325,0000,0000,0000,0000,0000,0000,0000,0000,0000,0000,0000,0310,0311,0017,0017,0017],
	[0017,0017,0017,0332,0333,0301,0000,0000,0000,0000,0000,0000,0000,0000,0000,0000,0318,0319,0017,0017,0017],
	[0017,0017,0017,0324,0325,0000,0000,0000,0000,0000,0000,0000,0000,0000,0000,0000,0310,0311,0017,0017,0017],
	[0017,0017,0017,0332,0333,0000,0000,0000,0000,0000,0000,0000,0000,0000,0000,0000,0318,0319,0017,0017,0017],
	[0017,0017,0017,0332,0333,0000,0000,0000,0000,0000,0000,0000,0000,0000,0000,0000,0318,0319,0017,0017,0017],
	[0017,0017,0017,0356,0357,0326,0384,0023,0386,0326,0327,0326,0327,0326,0327,0326,0358,0359,0017,0017,0017],
	[0017,0017,0017,0364,0365,0334,0392,0393,0394,0334,0335,0334,0335,0334,0335,0334,0366,0367,0017,0017,0017],
	[0017,0017,0017,0017,0017,0017,0017,0017,0017,0017,0017,0017,0017,0017,0017,0017,0017,0017,0017,0017,0017],
	[0017,0017,0017,0017,0017,0017,0017,0017,0017,0017,0017,0017,0017,0017,0017,0017,0017,0017,0017,0017,0017]
	],
	"couche1": [
	[-001,-001,-001,-001,-001,-001,-001,-001,-001,-001,-001,-001,-001,-001,-001,-001,-001,-001,-001,-001,-001],
	[-001,-001,-001,-001,-001,-001,-001,-001,-001,-001,-001,-001,-001,-001,-001,-001,-001,-001,-001,-001,-001],
	[-001,-001,-001,-001,-001,-001,-001,-001,-001,-001,-001,-001,-001,-001,-001,-001,-001,-001,-001,-001,-001],
	[-001,-001,-001,-001,-001,-001,0030,0031,-001,-001,0030,0031,-001,-001,0030,0031,-001,-001,-001,-001,-001],
	[-001,-001,-001,-001,-001,0002,0038,0039,-001,0002,0038,0039,-001,0002,0038,0039,-001,-001,-001,-001,-001],
	[-001,-001,-001,-001,-001,-001,0046,0047,-001,-001,0046,0047,-001,-001,0046,0047,-001,-001,-001,-001,-001],
	[-001,-001,-001,0555,0556,-001,-001,-001,-001,-001,-001,-001,-001,-001,-001,-001,-001,-001,-001,-001,-001],
	[-001,-001,-001,0563,0564,-001,-001,-001,-001,-001,-001,-001,-001,-001,-001,-001,-001,-001,-001,-001,-001],
	[-001,-001,-001,0571,0572,-001,-001,-001,-001,-001,0030,0031,-001,-001,0030,0031,-001,-001,-001,-001,-001],
	[-001,-001,-001,-001,-001,-001,-001,-001,-001,-001,0038,0039,-001,-001,0038,0039,-001,-001,-001,-001,-001],
	[-001,-001,-001,-001,-001,0518,0526,-001,-001,0002,0046,0047,-001,0002,0046,0047,-001,-001,-001,-001,-001],
	[-001,-001,-001,-001,-001,-001,-001,-001,-001,-001,-001,-001,-001,-001,-001,-001,-001,-001,-001,-001,-001],
	[-001,-001,-001,-001,-001,-001,-001,-001,-001,-001,-001,-001,-001,-001,-001,-001,-001,-001,-001,-001,-001],
	[-001,-001,-001,-001,-001,-001,-001,-001,-001,-001,-001,-001,-001,-001,-001,-001,-001,-001,-001,-001,-001],
	[-001,-001,-001,-001,-001,-001,-001,-001,-001,-001,-001,-001,-001,-001,-001,-001,-001,-001,-001,-001,-001]
	],
	"couche2": [
	[-001,-001,-001,-001,-001,-001,-001,-001,-001,-001,-001,-001,-001,-001,-001,-001,-001,-001,-001,-001,-001],
	[-001,-001,-001,-001,-001,-001,-001,-001,-001,-001,-001,-001,-001,-001,-001,-001,-001,-001,-001,-001,-001],
	[-001,-001,-001,-001,-001,-001,-001,0064,0065,0066,-001,0064,0065,0066,-001,-001,-001,-001,-001,-001,-001],
	[-001,-001,-001,-001,-001,-001,-001,0072,0073,0074,-001,0072,0073,0074,-001,-001,-001,-001,-001,-001,-001],
	[-001,-001,-001,-001,-001,-001,-001,-001,-001,-001,-001,-001,-001,-001,-001,-001,-001,-001,-001,-001,-001],
	[-001,-001,-001,-001,-001,-001,-001,-001,-001,-001,-001,-001,-001,-001,-001,0048,-001,-001,-001,-001,-001],
	[-001,-001,-001,-001,-001,-001,-001,-001,-001,-001,-001,-001,-001,-001,-001,0056,0080,0081,-001,-001,-001],
	[-001,-001,-001,-001,-001,-001,-001,-001,-001,-001,-001,-001,-001,-001,-001,-001,0088,0089,-001,-001,-001],
	[-001,-001,-001,-001,-001,-001,-001,-001,-001,-001,-001,-001,-001,-001,-001,-001,0096,0097,-001,-001,-001],
	[-001,-001,-001,-001,-001,-001,-001,-001,-001,-001,-001,-001,-001,-001,-001,-001,-001,-001,-001,-001,-001],
	[-001,-001,-001,-001,-001,-001,-001,-001,-001,-001,-001,-001,-001,-001,-001,-001,-001,-001,-001,-001,-001],
	[-001,-001,-001,-001,-001,-001,-001,-001,-001,-001,-001,0067,0068,0069,-001,-001,-001,-001,-001,-001,-001],
	[-001,-001,-001,-001,-001,-001,-001,-001,-001,-001,-001,0075,0076,0077,-001,-001,-001,-001,-001,-001,-001],
	[-001,-001,-001,-001,-001,-001,-001,-001,-001,-001,-001,-001,-001,-001,-001,-001,-001,-001,-001,-001,-001],
	[-001,-001,-001,-001,-001,-001,-001,-001,-001,-001,-001,-001,-001,-001,-001,-001,-001,-001,-001,-001,-001]
	],
	"events": [
	{
		"id": 1,
		"nom": "EV001",
		"x": 7,
		"y": 12,
		"pages": [
		{
			"conditions": [
			{
				"nom": "ArriveeAuContact"
			}
			],
			"commandes": [
			{
				"nom": "ChangerDeMap",
				"variable": false,
				"numeroNouvelleMap": 188,
				"xDebutHeros": 20,
				"yDebutHeros": 55
			}
			],
			"vitesse": "moderee",
			"frequence": "basse",
			"animeEnMouvement": true,
			"animeALArret": false,
			"directionFixe": false,
			"traversable": false,
			"auDessusDeTout": false
		}
		]
	},
	{
		"id": 2,
		"nom": "Viking",
		"x": 7,
		"y": 7,
		"pages": [
		{
			"conditions": [
			{
				"nom": "Parler"
			}
			],
			"commandes": [
			{
				"nom": "ModifierInterrupteur",
				"numeroInterrupteur": 12,
				"valeur": true
			},
			{
				"nom": "JouerEffetSonore",
				"nomFichierSonore": "viking1 vieux.ogg",
				"volume": 1.00,
				"tempo": 1.00
			},
			{
				"nom": "AppelerUnScript",
				"script": "$game_temp.faceset = \"viking vieux\""
			},
			{
				"nom": "Commentaire",
				"texte": "(en) This is a hostel for travelers\\nwho come from far away."
			},
			{
				"nom": "Message",
				"texte": "C'est une auberge pour les voyageurs \\nqui viennent de loin."
			},
			{
				"nom": "Attendre",
				"nombreDeFrames": 8
			},
			{
				"nom": "ModifierInterrupteur",
				"numeroInterrupteur": 12,
				"valeur": false
			}
			],
			"image": "viking vieux character",
			"vitesse": "lente",
			"frequence": "tres basse",
			"animeEnMouvement": true,
			"animeALArret": false,
			"directionFixe": false,
			"traversable": false,
			"auDessusDeTout": false
		}
		]
	},
	{
		"id": 3,
		"nom": "Clone[341][165]",
		"x": 14,
		"y": 9
	}
	]
}
