{
	"nom": "11,5 mini ballon",
	"tileset": "Sanctuaire de Kaze",
	"largeur": 21,
	"hauteur": 15,
	"musique": {
		"nomFichierSonore": "",
		"volume": 1.00,
		"tempo": 1.00
	},
	"fondSonore": {
		"nomFichierSonore": "",
		"volume": 0.80,
		"tempo": 1.00
	},
	"couche0": [
	[0146,0147,0009,0144,0145,0004,0005,0004,0005,0004,0005,0004,0146,0147,0036,0037,0016,0017,0018,0038,0039],
	[0154,0155,0009,0152,0153,0012,0013,0012,0013,0012,0013,0012,0154,0155,0044,0045,0024,0025,0026,0046,0047],
	[0036,0037,0005,0004,0005,0004,0005,0004,0005,0004,0005,0038,0039,0009,0020,0021,0009,0001,0009,0050,0051],
	[0044,0045,0013,0012,0013,0012,0013,0012,0013,0012,0013,0046,0047,0009,0028,0029,0001,0009,0001,0058,0059],
	[0020,0021,0009,0001,0009,-004,-004,-004,-004,-004,-004,0006,0007,0009,0020,0021,0009,0001,0009,0066,0067],
	[0028,0029,0008,0009,0001,-004,-006,-006,-006,-006,-006,0014,0015,0009,0052,0053,0023,0022,0023,0054,0055],
	[0020,0021,0000,0001,0009,0001,-006,-004,-004,-004,-006,0006,0007,0009,0060,0061,0031,0030,0031,0062,0063],
	[0052,0053,0023,0022,0130,0131,-004,-004,-006,-004,-006,0014,0015,0009,0009,0009,0009,0009,0009,0009,0009],
	[0060,0061,0031,0030,0138,0139,-006,-006,-006,-006,-006,0144,0145,0005,0005,0004,0005,0004,0005,0038,0039],
	[0002,0002,0002,0002,0028,0029,-006,-004,-006,-004,-004,0152,0153,0013,0013,0012,0013,0012,0013,0046,0047],
	[0002,0002,0002,0002,0020,0021,-006,-004,-004,-004,-006,0001,0009,0001,0009,0001,0009,0001,0009,0050,0051],
	[0002,0002,0002,0002,0028,0029,-006,-006,-006,-006,-006,-004,0001,0009,0001,0009,0001,0009,0001,0058,0059],
	[0002,0002,0002,0002,0020,0021,-004,-004,-004,-004,-004,-004,0009,0001,0009,0001,0009,0001,0009,0066,0067],
	[0002,0002,0002,0002,0052,0053,0023,0022,0023,0022,0023,0022,0023,0022,0022,0023,0022,0023,0022,0054,0055],
	[0002,0002,0002,0002,0060,0061,0031,0030,0031,0030,0031,0030,0031,0030,0030,0031,0030,0031,0030,0062,0063]
	],
	"couche1": [
	[-001,-001,-001,-001,-001,-001,-001,-001,-001,-001,-001,-001,-001,-001,-001,-001,0072,0073,0074,-001,-001],
	[-001,-001,-001,-001,-001,-001,-001,-001,-001,-001,-001,-001,-001,-001,-001,-001,0080,0081,0082,-001,-001],
	[-001,-001,-005,-001,-001,-001,-001,-001,-001,-001,-001,-001,-001,-001,-001,-001,-001,-001,-001,0106,0107],
	[-001,-001,-005,-001,-001,-001,-001,-001,-001,-001,-001,-001,-001,-001,-001,-001,-001,-001,-001,0114,0115],
	[-001,-001,-001,-001,-001,-001,-001,-001,-001,-001,-001,-001,-001,-001,-001,-001,-001,-001,-001,0122,0123],
	[-001,-001,-001,-001,-001,-001,-001,-001,-001,-001,-001,-001,-001,-001,-001,-001,-001,-001,-001,-001,-001],
	[-001,-001,-001,-001,-001,-001,-001,-001,-001,-001,-001,-001,-001,-001,-001,-001,-001,-001,-001,-001,-001],
	[-001,-001,-001,-001,-001,-001,-001,-001,-001,-001,-001,-001,-001,-001,-001,-001,-001,-001,-001,-001,-001],
	[-001,-001,-001,-001,-001,-001,-001,-001,-001,-001,-001,-001,-001,-001,-001,-001,-001,-001,-001,-001,-001],
	[-001,-001,-001,-001,-001,-001,-001,-001,-001,-001,-001,-001,-001,-001,-001,-001,-001,-001,-001,-001,-001],
	[-001,-001,-001,-001,-001,-001,-001,-001,-001,-001,-001,-001,-001,-001,-001,-001,-001,-001,-001,0106,0107],
	[-001,-001,-001,-001,-001,-001,-001,-001,-001,-001,-001,-001,-001,-001,-001,-001,-001,-001,-001,0114,0115],
	[-001,-001,-001,-001,-001,-001,-001,-001,-001,-001,-001,-001,-001,-001,-001,-001,-001,-001,-001,0122,0123],
	[-001,-001,-001,-001,-001,-001,-001,-001,-001,-001,-001,-001,-001,-001,-001,-001,-001,-001,-001,-001,-001],
	[-001,-001,-001,-001,-001,-001,-001,-001,-001,-001,-001,-001,-001,-001,-001,-001,-001,-001,-001,-001,-001]
	],
	"couche2": [
	[-001,-001,-001,-001,-001,-001,-001,-001,-001,-001,-001,-001,-001,-001,-001,-001,-001,-001,-001,-001,-001],
	[-001,-001,-001,-001,-001,-001,-001,-001,-001,-001,-001,-001,-001,-001,-001,-001,-001,-001,-001,-001,-001],
	[-001,-001,-001,-001,-001,-001,-001,-001,-001,-001,-001,-001,-001,-001,-001,-001,-001,-001,-001,-001,-001],
	[-001,-001,-001,-001,-001,-001,-001,-001,-001,-001,-001,-001,-001,-001,-001,-001,-001,-001,-001,-001,-001],
	[-001,-001,-001,-001,-001,-001,-001,-001,-001,-001,-001,-001,-001,-001,-001,-001,-001,-001,-001,-001,-001],
	[-001,-001,-001,-001,-001,-001,-001,-001,-001,-001,-001,-001,-001,-001,-001,-001,-001,-001,-001,-001,-001],
	[-001,-001,-001,-001,-001,-001,-001,-001,-001,-001,-001,-001,-001,-001,-001,-001,-001,-001,-001,-001,-001],
	[-001,-001,-001,-001,-001,-001,-001,-001,-001,-001,-001,-001,-001,-001,-001,-001,-001,-001,-001,-001,-001],
	[-001,-001,-001,-001,-001,-001,-001,-001,-001,-001,-001,-001,-001,-001,-001,-001,-001,-001,-001,-001,-001],
	[-001,-001,-001,-001,-001,-001,-001,-001,-001,-001,-001,-001,-001,-001,-001,-001,-001,-001,-001,-001,-001],
	[-001,-001,-001,-001,-001,-001,-001,-001,-001,-001,-001,-001,-001,-001,-001,-001,-001,-001,-001,-001,-001],
	[-001,-001,-001,-001,-001,-001,-001,-001,-001,-001,-001,-001,-001,-001,-001,-001,-001,-001,-001,-001,-001],
	[-001,-001,-001,-001,-001,-001,-001,-001,-001,-001,-001,-001,-001,-001,-001,-001,-001,-001,-001,-001,-001],
	[-001,-001,-001,-001,-001,-001,-001,-001,-001,-001,-001,-001,-001,-001,-001,-001,-001,-001,-001,-001,-001],
	[-001,-001,-001,-001,-001,-001,-001,-001,-001,-001,-001,-001,-001,-001,-001,-001,-001,-001,-001,-001,-001]
	],
	"events": [
	{
		"id": 5,
		"nom": "Clone[341][003]",
		"x": 15,
		"y": 10
	},
	{
		"id": 11,
		"nom": "EV011",
		"x": 20,
		"y": 3,
		"pages": [
		{
			"conditions": [
			{
				"nom": "ArriveeAuContact"
			}
			],
			"commandes": [
			{
				"nom": "ChangerDeMap",
				"variable": false,
				"numeroNouvelleMap": 713,
				"xDebutHeros": 1,
				"yDebutHeros": 3
			}
			],
			"vitesse": "moderee",
			"frequence": "basse",
			"animeEnMouvement": true,
			"animeALArret": false,
			"directionFixe": false,
			"traversable": false,
			"auDessusDeTout": false
		}
		]
	},
	{
		"id": 6,
		"nom": "Clone[341][003]",
		"x": 14,
		"y": 10
	},
	{
		"id": 1,
		"nom": "Clone[341][055]",
		"x": 8,
		"y": 8
	},
	{
		"id": 12,
		"nom": "EV012",
		"x": 17,
		"y": 0,
		"pages": [
		{
			"conditions": [
			{
				"nom": "ArriveeAuContact"
			}
			],
			"commandes": [
			{
				"nom": "ChangerDeMap",
				"variable": false,
				"numeroNouvelleMap": 706,
				"xDebutHeros": 17,
				"yDebutHeros": 13
			}
			],
			"vitesse": "moderee",
			"frequence": "basse",
			"animeEnMouvement": true,
			"animeALArret": false,
			"directionFixe": false,
			"traversable": false,
			"auDessusDeTout": false
		}
		]
	},
	{
		"id": 7,
		"nom": "Clone[341][003]",
		"x": 14,
		"y": 12
	},
	{
		"id": 2,
		"nom": "EV002",
		"x": 2,
		"y": 0,
		"pages": [
		{
			"conditions": [
			{
				"nom": "ArriveeAuContact"
			}
			],
			"commandes": [
			{
				"nom": "ChangerDeMap",
				"variable": false,
				"numeroNouvelleMap": 706,
				"xDebutHeros": 2,
				"yDebutHeros": 13
			}
			],
			"vitesse": "moderee",
			"frequence": "basse",
			"animeEnMouvement": true,
			"animeALArret": false,
			"directionFixe": false,
			"traversable": false,
			"auDessusDeTout": false
		}
		]
	},
	{
		"id": 8,
		"nom": "Clone[341][003]",
		"x": 15,
		"y": 12
	},
	{
		"id": 3,
		"nom": "EV003",
		"x": 20,
		"y": 11,
		"pages": [
		{
			"conditions": [
			{
				"nom": "ArriveeAuContact"
			}
			],
			"commandes": [
			{
				"nom": "ChangerDeMap",
				"variable": false,
				"numeroNouvelleMap": 713,
				"xDebutHeros": 1,
				"yDebutHeros": 11
			}
			],
			"vitesse": "moderee",
			"frequence": "basse",
			"animeEnMouvement": true,
			"animeALArret": false,
			"directionFixe": false,
			"traversable": false,
			"auDessusDeTout": false
		}
		]
	},
	{
		"id": 9,
		"nom": "Clone[341][003]",
		"x": 16,
		"y": 10
	},
	{
		"id": 10,
		"nom": "Clone[341][003]",
		"x": 16,
		"y": 12
	}
	]
}
