{
	"nom": "Fond du Puits",
	"tileset": "Puits",
	"largeur": 21,
	"hauteur": 15,
	"couche0": [
	[0000,0000,0000,0000,0000,0000,0000,0000,0000,0000,0000,0000,0000,0000,0000,0000,0000,0000,0000,0000,0000],
	[0000,0000,0000,0000,0000,0000,0000,0000,0000,0000,0000,0000,0000,0000,0000,0000,0000,0000,0000,0000,0000],
	[0000,0000,0000,0000,0000,0000,0000,0000,0000,0000,0000,0000,0000,0000,0000,0000,0000,0000,0000,0000,0000],
	[0000,0000,0000,0000,0000,0000,0000,0001,0002,0003,0004,0005,0006,0007,0144,0000,0000,0000,0000,0000,0000],
	[0000,0000,0000,0000,0000,0000,0008,0009,0010,0011,0012,0013,0014,0015,0152,0000,0000,0000,0000,0000,0000],
	[0000,0000,0000,0000,0000,0000,0016,0017,0018,0019,0020,0021,0022,0023,0160,0000,0000,0000,0000,0000,0000],
	[0000,0000,0000,0000,0000,0000,0024,0025,0026,0027,0028,0029,0030,0031,0168,0000,0000,0000,0000,0000,0000],
	[0000,0000,0000,0000,0000,0000,0032,0033,0034,0035,0036,0037,0038,0039,0176,0000,0000,0000,0000,0000,0000],
	[0000,0000,0000,0000,0000,0000,0040,0041,0042,0043,0044,0045,0046,0047,0184,0000,0000,0000,0000,0000,0000],
	[0000,0000,0000,0000,0000,0000,0048,0049,0050,0051,0052,0053,0054,0055,0192,0000,0000,0000,0000,0000,0000],
	[0000,0000,0000,0000,0000,0000,0056,0057,0058,0059,0060,0061,0062,0063,0200,0000,0000,0000,0000,0000,0000],
	[0000,0000,0000,0000,0000,0000,0064,0065,0066,0067,0068,0069,0070,0071,0208,0000,0000,0000,0000,0000,0000],
	[0000,0000,0000,0000,0000,0000,0000,0000,0000,0000,0000,0000,0000,0000,0144,0000,0000,0000,0000,0000,0000],
	[0000,0000,0000,0000,0000,0000,0000,0000,0000,0000,0000,0000,0000,0000,0000,0000,0000,0000,0000,0000,0000],
	[0000,0000,0000,0000,0000,0000,0000,0000,0000,0000,0000,0000,0000,0000,0000,0000,0000,0000,0000,0000,0000]
	],
	"couche1": [
	[-001,-001,-001,-001,-001,-001,-001,-001,-001,-001,-001,-001,-001,-001,-001,-001,-001,-001,-001,-001,-001],
	[-001,-001,-001,-001,-001,-001,-001,-001,-001,-001,-001,-001,-001,-001,-001,-001,-001,-001,-001,-001,-001],
	[-001,-001,-001,-001,-001,-001,-001,-001,-001,-001,-001,-001,-001,-001,-001,-001,-001,-001,-001,-001,-001],
	[-001,-001,-001,-001,-001,-001,0072,0073,0074,0075,0076,0077,0078,0079,-001,-001,-001,-001,-001,-001,-001],
	[-001,-001,-001,-001,-001,-001,0080,0081,0082,0083,0084,0085,0086,0087,-001,-001,-001,-001,-001,-001,-001],
	[-001,-001,-001,-001,-001,-001,0088,0089,0090,0091,0092,0093,0094,0095,-001,-001,-001,-001,-001,-001,-001],
	[-001,-001,-001,-001,-001,-001,0096,0097,0098,0099,0100,0101,0102,0103,-001,-001,-001,-001,-001,-001,-001],
	[-001,-001,-001,-001,-001,-001,0104,0105,0106,0107,0108,0109,0110,0111,-001,-001,-001,-001,-001,-001,-001],
	[-001,-001,-001,-001,-001,-001,0112,0113,0114,0115,0116,0117,0118,0119,-001,-001,-001,-001,-001,-001,-001],
	[-001,-001,-001,-001,-001,-001,0120,0121,0122,0123,0124,0125,0126,0127,-001,-001,-001,-001,-001,-001,-001],
	[-001,-001,-001,-001,-001,-001,0128,0129,0130,0131,0132,0133,0134,0135,-001,-001,-001,-001,-001,-001,-001],
	[-001,-001,-001,-001,-001,-001,0136,0137,0138,0139,0140,0141,0142,0143,-001,-001,-001,-001,-001,-001,-001],
	[-001,-001,-001,-001,-001,-001,-001,-001,-001,-001,-001,-001,-001,-001,-001,-001,-001,-001,-001,-001,-001],
	[-001,-001,-001,-001,-001,-001,-001,-001,-001,-001,-001,-001,-001,-001,-001,-001,-001,-001,-001,-001,-001],
	[-001,-001,-001,-001,-001,-001,-001,-001,-001,-001,-001,-001,-001,-001,-001,-001,-001,-001,-001,-001,-001]
	],
	"couche2": [
	[-001,-001,-001,-001,-001,-001,-001,-001,-001,-001,-001,-001,-001,-001,-001,-001,-001,-001,-001,-001,-001],
	[-001,-001,-001,-001,-001,-001,-001,-001,-001,-001,-001,-001,-001,-001,-001,-001,-001,-001,-001,-001,-001],
	[-001,-001,-001,-001,-001,-001,-001,-001,-001,-001,-001,-001,-001,-001,-001,-001,-001,-001,-001,-001,-001],
	[-001,-001,-001,-001,-001,-001,-001,-001,-001,-001,-001,-001,-001,-001,-001,-001,-001,-001,-001,-001,-001],
	[-001,-001,-001,-001,-001,-001,-001,-001,-001,-001,-001,-001,-001,-001,-001,-001,-001,-001,-001,-001,-001],
	[-001,-001,-001,-001,-001,-001,-001,-001,-001,-001,-001,-001,-001,-001,-001,-001,-001,-001,-001,-001,-001],
	[-001,-001,-001,-001,-001,-001,-001,-001,-001,-001,-001,-001,-001,-001,-001,-001,-001,-001,-001,-001,-001],
	[-001,-001,-001,-001,-001,-001,-001,-001,-001,-001,-001,-001,-001,-001,-001,-001,-001,-001,-001,-001,-001],
	[-001,-001,-001,-001,-001,-001,-001,-001,-001,-001,-001,-001,-001,-001,-001,-001,-001,-001,-001,-001,-001],
	[-001,-001,-001,-001,-001,-001,-001,-001,-001,-001,-001,-001,-001,-001,-001,-001,-001,-001,-001,-001,-001],
	[-001,-001,-001,-001,-001,-001,-001,-001,-001,-001,-001,-001,-001,-001,-001,-001,-001,-001,-001,-001,-001],
	[-001,-001,-001,-001,-001,-001,-001,-001,-001,-001,-001,-001,-001,-001,-001,-001,-001,-001,-001,-001,-001],
	[-001,-001,-001,-001,-001,-001,-001,-001,-001,-001,-001,-001,-001,-001,-001,-001,-001,-001,-001,-001,-001],
	[-001,-001,-001,-001,-001,-001,-001,-001,-001,-001,-001,-001,-001,-001,-001,-001,-001,-001,-001,-001,-001],
	[-001,-001,-001,-001,-001,-001,-001,-001,-001,-001,-001,-001,-001,-001,-001,-001,-001,-001,-001,-001,-001]
	],
	"events": [
	{
		"id": 5,
		"nom": "Viking",
		"x": 9,
		"y": 6,
		"pages": [
		{
			"conditions": [
			{
				"nom": "Parler"
			}
			],
			"commandes": [
			{
				"nom": "ModifierInterrupteur",
				"numeroInterrupteur": 12,
				"valeur": true
			},
			{
				"nom": "JouerEffetSonore",
				"nomFichierSonore": "Viking1.wav",
				"volume": 1.00,
				"tempo": 1.00
			},
			{
				"nom": "AppelerUnScript",
				"script": "$game_temp.faceset = \"viking rouge\""
			},
			{
				"nom": "Commentaire",
				"texte": "(en) Someone says \"Hello\" from the top of the well."
			},
			{
				"nom": "Message",
				"texte": "Il y a quelqu'un qui me dit \"Coucou\" en \\nhaut du puits."
			},
			{
				"nom": "JouerEffetSonore",
				"nomFichierSonore": "Viking2.wav",
				"volume": 1.00,
				"tempo": 1.00
			},
			{
				"nom": "Commentaire",
				"texte": "(en) Thus I answser \"Hello\"."
			},
			{
				"nom": "Message",
				"texte": "Alors je lui réponds \"Coucou\"."
			},
			{
				"nom": "Commentaire",
				"texte": "(en) I'm the polite type."
			},
			{
				"nom": "Message",
				"texte": "Je suis du genre poli."
			},
			{
				"nom": "Attendre",
				"nombreDeFrames": 8
			},
			{
				"nom": "ModifierInterrupteur",
				"numeroInterrupteur": 12,
				"valeur": false
			}
			],
			"image": "viking petit character",
			"vitesse": "lente",
			"frequence": "tres basse",
			"animeEnMouvement": true,
			"animeALArret": false,
			"directionFixe": false,
			"traversable": false,
			"auDessusDeTout": false
		}
		]
	},
	{
		"id": 2,
		"nom": "EV002",
		"x": 7,
		"y": 7,
		"pages": [
		{
			"conditions": [
			{
				"nom": "ArriveeAuContact"
			}
			],
			"commandes": [
			{
				"nom": "ChangerDeMap",
				"variable": false,
				"numeroNouvelleMap": 731,
				"xDebutHeros": 11,
				"yDebutHeros": 8
			}
			],
			"vitesse": "moderee",
			"frequence": "basse",
			"animeEnMouvement": true,
			"animeALArret": false,
			"directionFixe": false,
			"traversable": false,
			"auDessusDeTout": false
		}
		]
	},
	{
		"id": 3,
		"nom": "EV003",
		"x": 13,
		"y": 7,
		"pages": [
		{
			"conditions": [
			{
				"nom": "ArriveeAuContact"
			}
			],
			"commandes": [
			{
				"nom": "ChangerDeMap",
				"variable": false,
				"numeroNouvelleMap": 735,
				"xDebutHeros": 6,
				"yDebutHeros": 9
			}
			],
			"vitesse": "moderee",
			"frequence": "basse",
			"animeEnMouvement": true,
			"animeALArret": false,
			"directionFixe": false,
			"traversable": false,
			"auDessusDeTout": false
		}
		]
	}
	]
}
