{
	"nom": "Salle 4 (miroirs)",
	"tileset": "Pyramide",
	"largeur": 21,
	"hauteur": 15,
	"couche0": [
	[0036,0037,0088,0089,0090,0005,0004,0005,0004,0005,0004,0005,0004,0005,0004,0005,0004,0005,0004,0038,0039],
	[0044,0045,0096,0097,0098,0013,0012,0013,0012,0013,0012,0013,0012,0013,0012,0013,0012,0013,0012,0046,0047],
	[0006,0007,0085,0077,0085,0077,0085,0000,0019,0000,0019,0000,0019,0002,0002,0002,0002,0002,0035,0020,0021],
	[0014,0015,0077,0085,0077,0085,0077,0019,0068,0035,0000,0019,0068,0000,0019,0002,0002,0002,0043,0028,0029],
	[0006,0007,0085,0077,0085,0077,0085,0027,0035,0000,0019,0068,0002,0002,0068,0035,0000,0019,0043,0020,0021],
	[0014,0015,0077,0085,0077,0085,0077,0027,0069,0002,0068,0002,0002,0002,0002,0069,0002,0068,0043,0028,0029],
	[0006,0007,0085,0077,-004,0077,0085,0027,0002,0035,0000,0019,0035,0000,0019,0002,0002,0002,0043,0020,0021],
	[0014,0015,0019,0002,0000,0019,0035,0000,0019,0069,0002,0068,0069,0002,0068,0002,0002,0002,0043,0028,0029],
	[0006,0007,0000,0019,0002,0068,0069,0035,0000,0019,0002,0002,0002,0035,-004,-004,0077,-004,-004,0020,0021],
	[0014,0015,0019,0068,0002,0002,0002,0069,0002,0068,0002,0002,0002,0043,-004,0077,0085,0077,-004,0028,0029],
	[0006,0007,0027,0035,0000,0019,0002,0002,0002,0002,0035,0000,0019,0043,-004,0085,0077,0085,-004,0020,0021],
	[0014,0015,0027,0069,0002,0068,0002,0002,0002,0002,0069,0002,0068,0043,-004,0077,0085,0077,-004,0028,0029],
	[0006,0007,0071,0000,0019,0002,0002,0035,0000,0019,0002,0002,0002,0070,-004,-004,-004,-004,-004,0020,0021],
	[0052,0053,0022,0023,0022,0023,0022,0023,0022,0023,0022,0023,0022,0023,0022,0023,0022,0023,0022,0054,0055],
	[0060,0061,0030,0031,0030,0031,0030,0031,0030,0031,0030,0031,0030,0031,0030,0031,0030,0031,0030,0062,0063]
	],
	"couche1": [
	[-001,-001,-001,-001,-001,-001,-001,-001,-001,-001,-001,-001,-001,-001,-001,-001,-001,-001,-001,-001,-001],
	[-001,-001,-001,-001,-001,-001,-001,-001,-001,-001,-001,-001,-001,-001,-001,-001,-001,-001,-001,-001,-001],
	[-001,-001,-001,-001,-001,-001,-001,-001,-001,-001,-001,-001,-001,-001,-001,-001,-001,-001,-001,-001,-001],
	[-001,-001,-001,-001,-001,-001,-001,-001,-001,-001,-001,-001,-001,-001,-001,-001,-001,-001,-001,-001,-001],
	[-001,-001,-001,-001,-001,-001,-001,-001,-001,-001,-001,-001,-001,-001,-001,-001,-001,-001,-001,-001,-001],
	[-001,-001,-001,-001,-001,-001,-001,-001,-001,-001,-001,-001,-001,-001,-001,-001,-001,-001,-001,-001,-001],
	[-001,-001,-001,-001,-001,-001,-001,-001,-001,-001,-001,-001,-001,-001,-001,-001,-001,-001,-001,-001,-001],
	[-001,-001,-001,-001,-001,-001,-001,-001,-001,-001,-001,-001,-001,-001,-001,-001,-001,-001,-001,-001,-001],
	[-001,-001,-001,-001,-001,-001,-001,-001,-001,-001,-001,-001,-001,-001,-001,-001,-001,-001,-001,-001,-001],
	[-001,-001,-001,-001,-001,-001,-001,-001,-001,-001,-001,-001,-001,-001,-001,-001,-001,-001,-001,-001,-001],
	[-001,-001,-001,-001,-001,-001,-001,-001,-001,-001,-001,-001,-001,-001,-001,-001,-001,-001,-001,-001,-001],
	[-001,-001,-001,-001,-001,-001,-001,-001,-001,-001,-001,-001,-001,-001,-001,-001,-001,-001,-001,-001,-001],
	[-001,-001,-001,-001,-001,-001,-001,-001,-001,-001,-001,-001,-001,-001,-001,-001,-001,-001,-001,-001,-001],
	[-001,-001,-001,-001,-001,-001,-001,-001,-001,-001,-001,-001,-001,-001,-001,-001,-001,-001,-001,-001,-001],
	[-001,-001,-001,-001,-001,-001,-001,-001,-001,-001,-001,-001,-001,-001,-001,-001,-001,-001,-001,-001,-001]
	],
	"couche2": [
	[-001,-001,-001,-001,-001,-001,-001,-001,-001,-001,-001,-001,-001,-001,-001,-001,-001,-001,-001,-001,-001],
	[-001,-001,-001,-001,-001,-001,-001,-001,-001,-001,-001,-001,-001,-001,-001,-001,-001,-001,-001,-001,-001],
	[-001,-001,-001,-001,-001,-001,-001,-001,-001,-001,-001,-001,-001,-001,-001,-001,-001,-001,-001,-001,-001],
	[-001,-001,-001,-001,-001,-001,-001,-001,-001,-001,-001,-001,-001,-001,-001,-001,-001,-001,-001,-001,-001],
	[-001,-001,-001,-001,-001,-001,-001,-001,-001,-001,-001,-001,-001,-001,-001,-001,-001,-001,-001,-001,-001],
	[-001,-001,-001,-001,-001,-001,-001,-001,-001,-001,-001,-001,-001,-001,-001,-001,-001,-001,-001,-001,-001],
	[-001,-001,-001,-001,-001,-001,-001,-001,-001,-001,-001,-001,-001,-001,-001,-001,-001,-001,-001,-001,-001],
	[-001,-001,-001,-001,-001,-001,-001,-001,-001,-001,-001,-001,-001,-001,-001,-001,-001,-001,-001,-001,-001],
	[-001,-001,-001,-001,-001,-001,-001,-001,-001,-001,-001,-001,-001,-001,-001,-001,-001,-001,-001,-001,-001],
	[-001,-001,-001,-001,-001,-001,-001,-001,-001,-001,-001,-001,-001,-001,-001,-001,-001,-001,-001,-001,-001],
	[-001,-001,-001,-001,-001,-001,-001,-001,-001,-001,-001,-001,-001,-001,-001,-001,-001,-001,-001,-001,-001],
	[-001,-001,-001,-001,-001,-001,-001,-001,-001,-001,-001,-001,-001,-001,-001,-001,-001,-001,-001,-001,-001],
	[-001,-001,-001,-001,-001,-001,-001,-001,-001,-001,-001,-001,-001,-001,-001,-001,-001,-001,-001,-001,-001],
	[-001,-001,-001,-001,-001,-001,-001,-001,-001,-001,-001,-001,-001,-001,-001,-001,-001,-001,-001,-001,-001],
	[-001,-001,-001,-001,-001,-001,-001,-001,-001,-001,-001,-001,-001,-001,-001,-001,-001,-001,-001,-001,-001]
	],
	"events": [
	{
		"id": 5,
		"nom": "Clone[341][172]",
		"x": 9,
		"y": 4
	},
	{
		"id": 16,
		"nom": "Clone[341][171]",
		"x": 3,
		"y": 12
	},
	{
		"id": 11,
		"nom": "Clone[341][171]",
		"x": 4,
		"y": 7
	},
	{
		"id": 17,
		"nom": "Clone[341][171]",
		"x": 10,
		"y": 3
	},
	{
		"id": 6,
		"nom": "Clone[341][171]",
		"x": 9,
		"y": 2
	},
	{
		"id": 1,
		"nom": "EV001",
		"x": 3,
		"y": 0,
		"pages": [
		{
			"conditions": [
			{
				"nom": "ArriveeAuContact"
			}
			],
			"commandes": [
			{
				"nom": "ChangerDeMap",
				"variable": false,
				"numeroNouvelleMap": 71,
				"xDebutHeros": 2,
				"yDebutHeros": 5
			}
			],
			"vitesse": "moderee",
			"frequence": "basse",
			"animeEnMouvement": true,
			"animeALArret": false,
			"directionFixe": false,
			"traversable": false,
			"auDessusDeTout": false
		}
		]
	},
	{
		"id": 12,
		"nom": "Clone[341][172]",
		"x": 7,
		"y": 7
	},
	{
		"id": 18,
		"nom": "Clone[341][171]",
		"x": 10,
		"y": 6
	},
	{
		"id": 7,
		"nom": "Clone[341][172]",
		"x": 7,
		"y": 2
	},
	{
		"id": 13,
		"nom": "Clone[341][171]",
		"x": 2,
		"y": 8
	},
	{
		"id": 19,
		"nom": "Clone[341][172]",
		"x": 13,
		"y": 6
	},
	{
		"id": 8,
		"nom": "Clone[341][171]",
		"x": 11,
		"y": 2
	},
	{
		"id": 14,
		"nom": "Clone[341][171]",
		"x": 8,
		"y": 8
	},
	{
		"id": 3,
		"nom": "Clone[341][183]",
		"x": 16,
		"y": 10
	},
	{
		"id": 20,
		"nom": "Clone[341][171]",
		"x": 13,
		"y": 3
	},
	{
		"id": 9,
		"nom": "Clone[341][172]",
		"x": 11,
		"y": 10
	},
	{
		"id": 15,
		"nom": "Clone[341][172]",
		"x": 8,
		"y": 12
	},
	{
		"id": 4,
		"nom": "Clone[341][171]",
		"x": 16,
		"y": 4
	},
	{
		"id": 10,
		"nom": "Clone[341][171]",
		"x": 4,
		"y": 10
	},
	{
		"id": 21,
		"nom": "EV021",
		"x": 17,
		"y": 9,
		"pages": [
		{
			"conditions": [
			],
			"commandes": [
			{
				"nom": "ConditionDirection",
				"idEventConcerne": 3,
				"direction": 0,
				"numero": 0
			},
			{
				"nom": "ModifierInterrupteur",
				"numeroInterrupteur": 145,
				"valeur": true
			},
			{
				"nom": "SupprimerEvent"
			},
			{
				"nom": "ConditionFin",
				"numero": 0
			},
			{
				"nom": "Attendre",
				"nombreDeFrames": 16
			}
			],
			"vitesse": "moderee",
			"frequence": "basse",
			"animeEnMouvement": true,
			"animeALArret": false,
			"directionFixe": false,
			"traversable": false,
			"auDessusDeTout": false
		}
		]
	}
	]
}
