{
	"nom": "Salle 13 (torches droite)",
	"tileset": "Pyramide",
	"largeur": 42,
	"hauteur": 15,
	"musique": {
		"nomFichierSonore": "",
		"volume": 1.00,
		"tempo": 1.00
	},
	"fondSonore": {
		"nomFichierSonore": "",
		"volume": 0.80,
		"tempo": 1.00
	},
	"couche0": [
	[0036,0037,0004,0005,0004,0005,0004,0005,0004,0005,0004,0005,0004,0005,0004,0005,0004,0005,0004,0005,0004,0005,0004,0005,0004,0005,0004,0005,0004,0005,0004,0005,0004,0005,0004,0005,0004,0005,0004,0005,0038,0039],
	[0044,0045,0012,0013,0012,0013,0012,0013,0012,0013,0012,0013,0012,0013,0012,0013,0012,0013,0012,0013,0012,0013,0012,0013,0012,0013,0012,0013,0012,0013,0012,0013,0012,0013,0012,0013,0012,0013,0012,0013,0046,0047],
	[0006,0007,0008,0008,0008,0008,0008,0019,0002,0002,0002,0002,0002,0002,0002,0002,0002,0002,0002,0002,0002,0002,0002,0002,0002,0002,0002,0002,0002,0002,0002,0002,0035,0008,0008,0008,0008,0008,0008,0008,0020,0021],
	[0014,0015,0008,0008,0008,0008,0008,0027,0002,0002,0002,0002,0002,0002,0002,0002,0002,0002,0002,0002,0002,0002,0002,0002,0002,0002,0002,0002,0002,0002,0002,0002,0043,0008,0008,0008,0008,0008,0008,0010,0028,0029],
	[0006,0007,0008,0008,0008,0008,0008,0027,0002,0002,0002,0002,0002,0002,0002,0002,0002,0002,0002,0002,0002,0002,0002,0002,0002,0002,0002,0002,0002,0002,0002,0002,0043,0008,0008,0008,0008,0008,0008,0008,0020,0021],
	[0014,0015,0008,0008,0008,0008,0008,0027,0002,0002,0002,0002,0002,0002,0002,0002,0002,0002,0002,0002,0002,0002,0002,0002,0002,0002,0002,0002,0002,0002,0002,0002,0043,0008,-004,-004,-004,-004,-004,0010,0028,0029],
	[0048,0049,0008,0008,0008,0008,0008,0027,0002,0002,0002,0002,0002,0002,0002,0002,0002,0002,0002,0002,0002,0002,0002,0002,0002,0002,0002,0002,0002,0002,0002,0002,0043,0008,-004,0008,0008,0008,-004,0010,0020,0021],
	[0056,0057,0008,0008,0008,0008,0010,0027,0002,0002,0002,0002,0002,0002,0002,0002,0002,0002,0002,0002,0002,0002,0002,0002,0002,0002,0002,0002,0002,0002,0002,0002,0043,0008,-004,0008,0008,0008,-004,0008,0028,0029],
	[0064,0065,0008,0008,0008,0008,0008,0027,0002,0002,0002,0002,0002,0002,0002,0002,0002,0002,0002,0002,0002,0002,0002,0002,0002,0002,0002,0002,0002,0002,0002,0002,0043,0008,-004,0008,0008,0008,-004,0010,0020,0021],
	[0014,0015,0008,0008,0008,0008,0008,0027,0002,0002,0002,0002,0002,0002,0002,0002,0002,0002,0002,0002,0002,0002,0002,0002,0002,0002,0002,0002,0002,0002,0002,0002,0043,0008,-004,-004,0008,-004,-004,0010,0028,0029],
	[0006,0007,0008,0008,0008,0008,0008,0027,0002,0002,0002,0002,0002,0002,0002,0002,0002,0002,0002,0002,0002,0002,0002,0002,0002,0002,0002,0002,0002,0002,0002,0002,0043,0008,0008,0008,0008,0008,0008,0010,0020,0021],
	[0014,0015,0008,0008,0008,0008,0008,0071,0002,0002,0002,0002,0002,0002,0002,0002,0002,0002,0002,0002,0002,0002,0002,0002,0002,0002,0002,0002,0002,0002,0002,0002,0070,0008,0008,0008,0008,0008,0008,0008,0028,0029],
	[0006,0007,0008,0008,0008,0008,0008,0008,0008,0008,0008,0008,0008,0008,0008,0008,0008,0008,0008,0008,0008,0008,0008,0008,0008,0008,0008,0008,0008,0008,0008,0008,0008,0008,0008,0008,0008,0008,0008,-004,0020,0021],
	[0052,0053,0022,0023,0022,0023,0022,0023,0022,0023,0022,0023,0022,0023,0022,0023,0022,0023,0022,0023,0022,0023,0022,0023,0022,0023,0022,0023,0022,0023,0022,0023,0022,0023,0022,0023,0022,0023,0022,0023,0054,0055],
	[0060,0061,0030,0031,0030,0031,0030,0031,0030,0031,0030,0031,0030,0031,0030,0031,0030,0031,0030,0031,0030,0031,0030,0031,0030,0031,0030,0031,0030,0031,0030,0031,0030,0031,0030,0031,0030,0031,0030,0031,0062,0063]
	],
	"couche1": [
	[-001,-001,-001,-001,-001,-001,-001,-001,-001,-001,-001,-001,-001,-001,-001,-001,-001,-001,-001,-001,-001,-001,-001,-001,-001,-001,-001,-001,-001,-001,-001,-001,-001,-001,-001,-001,-001,-001,-001,-001,-001,-001],
	[-001,-001,-001,-001,-001,-001,-001,-001,-001,-001,-001,-001,-001,-001,-001,-001,-001,-001,-001,-001,-001,-001,-001,-001,-001,-001,-001,-001,-001,-001,-001,-001,-001,-001,-001,-001,-001,-001,-001,-001,-001,-001],
	[-001,-001,-001,-001,-001,-001,-001,-001,-001,-001,-001,-001,-001,-001,-001,-001,-001,-001,-001,-001,-001,-001,-001,-001,-001,-001,-001,-001,-001,-001,-001,-001,-001,-001,-001,-001,-001,-001,-001,-001,-001,-001],
	[-001,-001,-001,-001,-001,-001,-001,-001,-001,-001,-001,-001,-001,-001,-001,-001,-001,-001,-001,-001,-001,-001,-001,-001,-001,-001,-001,-001,-001,-001,-001,-001,-001,-001,-001,-001,-001,-001,-001,-001,-001,-001],
	[-001,-001,-001,-001,-001,-001,-001,-001,-001,-001,-001,-001,-001,-001,-001,-001,-001,-001,-001,-001,-001,-001,-001,-001,-001,-001,-001,-001,-001,-001,-001,-001,-001,-001,-001,-001,-001,-001,-001,-001,-001,-001],
	[-001,-001,-001,-001,-001,-001,-001,-001,-001,-001,-001,-001,-001,-001,-001,-001,-001,-001,-001,-001,-001,-001,-001,-001,-001,-001,-001,-001,-001,-001,-001,-001,-001,-001,-001,-001,-001,-001,-001,-001,-001,-001],
	[-001,-001,-001,-001,-001,-001,-001,-001,-001,-001,-001,-001,-001,-001,-001,-001,-001,-001,-001,-001,-001,-001,-001,-001,-001,-001,-001,-001,-001,-001,-001,-001,-001,-001,-001,-001,-001,-001,-001,-001,-001,-001],
	[-001,-001,-001,-001,-001,-001,-001,-001,-001,-001,-001,-001,-001,-001,-001,-001,-001,-001,-001,-001,-001,-001,-001,-001,-001,-001,-001,-001,-001,-001,-001,-001,-001,-001,-001,-001,-001,-001,-001,-001,-001,-001],
	[-001,-001,-001,-001,-001,-001,-001,-001,-001,-001,-001,-001,-001,-001,-001,-001,-001,-001,-001,-001,-001,-001,-001,-001,-001,-001,-001,-001,-001,-001,-001,-001,-001,-001,-001,-001,-001,-001,-001,-001,-001,-001],
	[-001,-001,-001,-001,-001,-001,-001,-001,-001,-001,-001,-001,-001,-001,-001,-001,-001,-001,-001,-001,-001,-001,-001,-001,-001,-001,-001,-001,-001,-001,-001,-001,-001,-001,-001,-001,-001,-001,-001,-001,-001,-001],
	[-001,-001,-001,-001,-001,-001,-001,-001,-001,-001,-001,-001,-001,-001,-001,-001,-001,-001,-001,-001,-001,-001,-001,-001,-001,-001,-001,-001,-001,-001,-001,-001,-001,-001,-001,-001,-001,-001,-001,-001,-001,-001],
	[-001,-001,-001,-001,-001,-001,-001,-001,-001,-001,-001,-001,-001,-001,-001,-001,-001,-001,-001,-001,-001,-001,-001,-001,-001,-001,-001,-001,-001,-001,-001,-001,-001,-001,-001,-001,-001,-001,-001,-001,-001,-001],
	[-001,-001,-001,-001,-001,-001,-001,-001,-001,-001,-001,-001,-001,-001,-001,-001,-001,-001,-001,-001,-001,-001,-001,-001,-001,-001,-001,-001,-001,-001,-001,-001,-001,-001,-001,-001,-001,-001,-001,-001,-001,-001],
	[-001,-001,-001,-001,-001,-001,-001,-001,-001,-001,-001,-001,-001,-001,-001,-001,-001,-001,-001,-001,-001,-001,-001,-001,-001,-001,-001,-001,-001,-001,-001,-001,-001,-001,-001,-001,-001,-001,-001,-001,-001,-001],
	[-001,-001,-001,-001,-001,-001,-001,-001,-001,-001,-001,-001,-001,-001,-001,-001,-001,-001,-001,-001,-001,-001,-001,-001,-001,-001,-001,-001,-001,-001,-001,-001,-001,-001,-001,-001,-001,-001,-001,-001,-001,-001]
	],
	"couche2": [
	[-001,-001,-001,-001,-001,-001,-001,-001,-001,-001,-001,-001,-001,-001,-001,-001,-001,-001,-001,-001,-001,-001,-001,-001,-001,-001,-001,-001,-001,-001,-001,-001,-001,-001,-001,-001,-001,-001,-001,-001,-001,-001],
	[-001,-001,-001,-001,-001,-001,-001,-001,-001,-001,-001,-001,-001,-001,-001,-001,-001,-001,-001,-001,-001,-001,-001,-001,-001,-001,-001,-001,-001,-001,-001,-001,-001,-001,-001,-001,-001,-001,-001,-001,-001,-001],
	[-001,-001,-001,-001,-001,-001,-001,-001,-001,-001,-001,-001,-001,-001,-001,-001,-001,-001,-001,-001,-001,-001,-001,-001,-001,-001,-001,-001,-001,-001,-001,-001,-001,-001,-001,-001,-001,-001,-001,-001,-001,-001],
	[-001,-001,-001,-001,-001,-001,-001,-001,-001,-001,-001,-001,-001,-001,-001,-001,-001,-001,-001,-001,-001,-001,-001,-001,-001,-001,-001,-001,-001,-001,-001,-001,-001,-001,-001,-001,-001,-001,-001,-001,-001,-001],
	[-001,-001,-001,-001,-001,-001,-001,-001,-001,-001,-001,-001,-001,-001,-001,-001,-001,-001,-001,-001,-001,-001,-001,-001,-001,-001,-001,-001,-001,-001,-001,-001,-001,-001,-001,-001,-001,-001,-001,-001,-001,-001],
	[-001,-001,-001,-001,-001,-001,-001,-001,-001,-001,-001,-001,-001,-001,-001,-001,-001,-001,-001,-001,-001,-001,-001,-001,-001,-001,-001,-001,-001,-001,-001,-001,-001,-001,-001,-001,-001,-001,-001,-001,-001,-001],
	[-001,-001,-001,-001,-001,-001,-001,-001,-001,-001,-001,-001,-001,-001,-001,-001,-001,-001,-001,-001,-001,-001,-001,-001,-001,-001,-001,-001,-001,-001,-001,-001,-001,-001,-001,-001,-001,-001,-001,-001,-001,-001],
	[-001,-001,-001,-001,-001,-001,-001,-001,-001,-001,-001,-001,-001,-001,-001,-001,-001,-001,-001,-001,-001,-001,-001,-001,-001,-001,-001,-001,-001,-001,-001,-001,-001,-001,-001,-001,-001,-001,-001,-001,-001,-001],
	[-001,-001,-001,-001,-001,-001,-001,-001,-001,-001,-001,-001,-001,-001,-001,-001,-001,-001,-001,-001,-001,-001,-001,-001,-001,-001,-001,-001,-001,-001,-001,-001,-001,-001,-001,-001,-001,-001,-001,-001,-001,-001],
	[-001,-001,-001,-001,-001,-001,-001,-001,-001,-001,-001,-001,-001,-001,-001,-001,-001,-001,-001,-001,-001,-001,-001,-001,-001,-001,-001,-001,-001,-001,-001,-001,-001,-001,-001,-001,-001,-001,-001,-001,-001,-001],
	[-001,-001,-001,-001,-001,-001,-001,-001,-001,-001,-001,-001,-001,-001,-001,-001,-001,-001,-001,-001,-001,-001,-001,-001,-001,-001,-001,-001,-001,-001,-001,-001,-001,-001,-001,-001,-001,-001,-001,-001,-001,-001],
	[-001,-001,-001,-001,-001,-001,-001,-001,-001,-001,-001,-001,-001,-001,-001,-001,-001,-001,-001,-001,-001,-001,-001,-001,-001,-001,-001,-001,-001,-001,-001,-001,-001,-001,-001,-001,-001,-001,-001,-001,-001,-001],
	[-001,-001,-001,-001,-001,-001,-001,-001,-001,-001,-001,-001,-001,-001,-001,-001,-001,-001,-001,-001,-001,-001,-001,-001,-001,-001,-001,-001,-001,-001,-001,-001,-001,-001,-001,-001,-001,-001,-001,-001,-001,-001],
	[-001,-001,-001,-001,-001,-001,-001,-001,-001,-001,-001,-001,-001,-001,-001,-001,-001,-001,-001,-001,-001,-001,-001,-001,-001,-001,-001,-001,-001,-001,-001,-001,-001,-001,-001,-001,-001,-001,-001,-001,-001,-001],
	[-001,-001,-001,-001,-001,-001,-001,-001,-001,-001,-001,-001,-001,-001,-001,-001,-001,-001,-001,-001,-001,-001,-001,-001,-001,-001,-001,-001,-001,-001,-001,-001,-001,-001,-001,-001,-001,-001,-001,-001,-001,-001]
	],
	"events": [
	{
		"id": 5,
		"nom": "EV005",
		"x": 37,
		"y": 6,
		"pages": [
		{
			"conditions": [
			],
			"commandes": [
			{
				"nom": "ConditionDirection",
				"idEventConcerne": 4,
				"direction": 0,
				"numero": 0
			},
			{
				"nom": "ModifierInterrupteur",
				"numeroInterrupteur": 143,
				"valeur": true
			},
			{
				"nom": "SupprimerEvent"
			},
			{
				"nom": "ConditionFin",
				"numero": 0
			},
			{
				"nom": "Attendre",
				"nombreDeFrames": 16
			}
			],
			"vitesse": "moderee",
			"frequence": "basse",
			"animeEnMouvement": true,
			"animeALArret": false,
			"directionFixe": false,
			"traversable": false,
			"auDessusDeTout": false
		}
		]
	},
	{
		"id": 1,
		"nom": "EV001",
		"x": 0,
		"y": 7,
		"pages": [
		{
			"conditions": [
			{
				"nom": "ArriveeAuContact"
			}
			],
			"commandes": [
			{
				"nom": "ChangerDeMap",
				"variable": false,
				"numeroNouvelleMap": 683,
				"xDebutHeros": 17,
				"yDebutHeros": 7
			}
			],
			"vitesse": "moderee",
			"frequence": "basse",
			"animeEnMouvement": true,
			"animeALArret": false,
			"directionFixe": false,
			"traversable": false,
			"auDessusDeTout": false
		}
		]
	},
	{
		"id": 2,
		"nom": "Clone[341][040]",
		"x": 33,
		"y": 7
	},
	{
		"id": 3,
		"nom": "rocher",
		"x": 7,
		"y": 12,
		"pages": [
		{
			"conditions": [
			],
			"commandes": [
			{
				"nom": "ConditionDirection",
				"idEventConcerne": 2,
				"direction": 0,
				"numero": 0
			},
			{
				"nom": "ModifierInterrupteurLocal",
				"numeroInterrupteurLocal": 0,
				"valeurADonner": true
			},
			{
				"nom": "ConditionFin",
				"numero": 0
			}
			],
			"image": "rocher gris character",
			"directionInitiale": 3,
			"vitesse": "moderee",
			"frequence": "basse",
			"animeEnMouvement": false,
			"animeALArret": false,
			"directionFixe": true,
			"traversable": false,
			"auDessusDeTout": false
		},
		{
			"conditions": [
			{
				"nom": "InterrupteurLocal",
				"numeroEvent": 3,
				"numeroInterrupteurLocal": 0,
				"valeurQuIlEstCenseAvoir": true
			}
			],
			"commandes": [
			{
				"nom": "Deplacement",
				"ignorerLesMouvementsImpossibles": false,
				"repeterLeDeplacement": false,
				"attendreLaFinDuDeplacement": false,
				"mouvements": [
				{
					"nom": "ModifierApparence",
					"image": "rocher gris character",
					"direction": 3,
					"animation": 0,
					"teinte": 0
				},
				{
					"nom": "AppelerUneCommande",
					"nomCommande": "Attendre",
					"nombreDeFrames": 1
				},
				{
					"nom": "ModifierApparence",
					"image": "rocher gris character",
					"direction": 3,
					"animation": 1,
					"teinte": 0
				},
				{
					"nom": "AppelerUneCommande",
					"nomCommande": "Attendre",
					"nombreDeFrames": 1
				},
				{
					"nom": "ModifierApparence",
					"image": "rocher gris character",
					"direction": 3,
					"animation": 2,
					"teinte": 0
				},
				{
					"nom": "AppelerUneCommande",
					"nomCommande": "Attendre",
					"nombreDeFrames": 1
				},
				{
					"nom": "ModifierApparence",
					"image": "rocher gris character",
					"direction": 3,
					"animation": 3,
					"teinte": 0
				}
				]
			},
			{
				"nom": "AppelerUnScript",
				"script": "wait_for_event(@event_id)"
			},
			{
				"nom": "JouerEffetMusical",
				"nomFichierSonore": "Fanfare (paquerette).mp3",
				"volume": 1.00,
				"tempo": 1.00
			},
			{
				"nom": "ModifierInterrupteurLocal",
				"numeroInterrupteurLocal": 1,
				"valeurADonner": true
			}
			],
			"image": "rocher gris character",
			"directionInitiale": 3,
			"vitesse": "moderee",
			"frequence": "basse",
			"figerLesAutresEvents": true,
			"animeEnMouvement": false,
			"animeALArret": false,
			"directionFixe": true,
			"traversable": false,
			"auDessusDeTout": false
		},
		{
			"conditions": [
			{
				"nom": "Parler"
			},
			{
				"nom": "InterrupteurLocal",
				"numeroEvent": 3,
				"numeroInterrupteurLocal": 1,
				"valeurQuIlEstCenseAvoir": true
			}
			],
			"commandes": [
			],
			"image": "rocher gris character",
			"directionInitiale": 3,
			"animationInitiale": 3,
			"vitesse": "moderee",
			"frequence": "basse",
			"animeEnMouvement": false,
			"animeALArret": false,
			"directionFixe": true,
			"traversable": true,
			"auDessusDeTout": false
		}
		]
	},
	{
		"id": 4,
		"nom": "Clone[341][183]",
		"x": 36,
		"y": 7
	}
	]
}
