{
	"nom": "Salle 15 (statue)",
	"tileset": "Sanctuaire de Kakeru",
	"largeur": 21,
	"hauteur": 15,
	"musique": {
		"nomFichierSonore": "",
		"volume": 1.00,
		"tempo": 1.00
	},
	"fondSonore": {
		"nomFichierSonore": "",
		"volume": 0.80,
		"tempo": 1.00
	},
	"couche0": [
	[0002,0002,0036,0037,0005,0004,0005,0004,0005,0004,0038,0039,0002,0002,0002,0002,0002,0002,0002,0002,0002],
	[0002,0002,0044,0045,0013,0012,0013,0012,0013,0012,0046,0047,0002,0002,0002,0002,0002,0002,0002,0002,0002],
	[0002,0002,0028,0029,0036,0037,0005,0004,0038,0039,0144,0145,0004,0005,0004,0005,0004,0038,0039,0002,0002],
	[0002,0002,0020,0021,0044,0045,0013,0012,0046,0047,0152,0153,0012,0013,0012,0013,0012,0046,0047,0002,0002],
	[0002,0002,0028,0029,0028,0029,-004,-004,0144,0145,0004,0005,0004,0005,0004,0038,0039,0014,0015,0002,0002],
	[0002,0002,0028,0029,0020,0021,-004,0000,0152,0153,0012,0013,0012,0013,0012,0046,0047,0006,0007,0002,0002],
	[0002,0002,0020,0021,0028,0029,0000,0000,0000,0000,0000,0000,0000,0000,-004,0014,0015,0006,0007,0002,0002],
	[0002,0002,0028,0029,0028,0029,0233,0233,0233,0233,0233,0233,0000,0128,0129,0054,0055,0014,0015,0002,0002],
	[0002,0002,0020,0021,0020,0021,0002,0002,0002,0002,0002,0002,0000,0136,0137,0062,0063,0006,0007,0002,0002],
	[0002,0002,0028,0029,0028,0029,-004,-004,-004,0010,0010,-004,0000,0006,0007,0128,0129,0054,0055,0002,0002],
	[0002,0002,0020,0021,0048,0049,0000,0000,0000,0000,0000,0000,0000,0006,0007,0136,0137,0062,0063,0002,0002],
	[0002,0002,0028,0029,0056,0057,0000,0000,0000,0000,0000,0000,0000,0014,0015,0006,0007,0002,0002,0002,0002],
	[0002,0002,0020,0021,0064,0065,0000,0000,0000,0000,0000,0000,0000,0006,0007,0006,0007,0002,0002,0002,0002],
	[0002,0002,0028,0029,0052,0053,0023,0022,0023,0022,0022,0023,0022,0054,0055,0014,0015,0002,0002,0002,0002],
	[0002,0002,0020,0021,0060,0061,0031,0030,0031,0030,0030,0031,0030,0062,0063,0006,0007,0002,0002,0002,0002]
	],
	"couche1": [
	[-001,-001,0322,0323,-001,-001,-001,-001,-001,-001,-001,-001,-001,-001,-001,-001,-001,-001,-001,-001,-001],
	[-001,-001,0330,0331,-001,-001,-001,-001,-001,-001,-001,-001,-001,-001,-001,-001,-001,-001,-001,-001,-001],
	[-001,-001,-001,-001,-001,-001,-001,-001,-001,-001,-001,-001,-001,-001,-001,-001,-001,-001,-001,-001,-001],
	[-001,-001,-001,-001,-001,-001,-001,-001,-001,-001,-001,-001,-001,-001,-001,-001,-001,-001,-001,-001,-001],
	[-001,-001,-001,-001,-001,-001,-001,-001,-001,-001,-001,0071,0069,0071,-001,0324,0325,-001,-001,-001,-001],
	[-001,-001,-001,-001,-001,-001,-001,-001,-001,-001,-001,0079,0077,0079,-001,0332,0333,-001,-001,-001,-001],
	[-001,-001,-001,-001,0132,0133,-001,-001,-001,-001,-001,-001,-001,-001,-001,-001,-001,-001,-001,-001,-001],
	[-001,-001,-001,-001,-001,-001,-001,-001,-001,-001,-001,-001,-001,-001,-001,-001,-001,-001,-001,-001,-001],
	[-001,-001,-001,-001,-001,-001,-001,-001,-001,-001,-001,-001,0234,-001,-001,-001,-001,-001,-001,-001,-001],
	[-001,-001,-001,-001,-001,-001,-001,-001,-001,-001,-001,-001,-001,-001,-001,-001,-001,0326,0327,-001,-001],
	[-001,-001,-001,-001,0104,0105,0234,-001,-001,-001,0234,-001,-001,-001,-001,-001,-001,0334,0335,-001,-001],
	[-001,-001,-001,-001,0112,0113,-001,-001,-001,0234,-001,-001,-001,0150,0151,-001,-001,-001,-001,-001,-001],
	[-001,-001,-001,-001,0120,0121,-001,-001,-001,-001,-001,-001,-001,-001,-001,-001,-001,-001,-001,-001,-001],
	[-001,-001,-001,-001,0320,0321,-001,0085,0087,0086,0085,0087,-001,-001,-001,-001,-001,-001,-001,-001,-001],
	[-001,-001,-001,-001,0328,0329,-001,0093,0095,0094,0093,0095,-001,-001,-001,-001,-001,-001,-001,-001,-001]
	],
	"couche2": [
	[-001,-001,-001,0161,0162,0163,0164,-001,0185,0186,0187,0188,-001,-001,-001,-001,-001,-001,-001,-001,-001],
	[-001,-001,-001,0169,0170,0171,0172,-001,0185,0186,0187,0188,-001,-001,-001,-001,-001,-001,-001,-001,-001],
	[-001,-001,-001,0177,0178,0179,0180,-001,0185,0186,0187,0188,-001,-001,-001,-001,-001,-001,-001,-001,-001],
	[-001,-001,-001,-001,-001,-001,-001,-001,0193,0194,0195,0196,-001,-001,-001,-001,-001,-001,-001,-001,-001],
	[-001,-001,-001,-001,-001,-001,-001,-001,0201,0202,0203,0204,-001,-001,-001,-001,-001,-001,-001,-001,-001],
	[-001,-001,-001,-001,-001,-001,-001,-001,-001,-001,-001,-001,-001,-001,-001,-001,-001,-001,-001,-001,-001],
	[-001,-001,-001,-001,-001,-001,-001,-001,-001,-001,-001,-001,-001,-001,-001,-001,-001,-001,-001,-001,-001],
	[-001,-001,-001,-001,-001,-001,-001,-001,-001,-001,-001,-001,-001,-001,-001,-001,-001,-001,-001,-001,-001],
	[-001,-001,-001,-001,-001,-001,-001,-001,-001,-001,-001,-001,-001,-001,-001,-001,-001,-001,-001,-001,-001],
	[-001,-001,-001,-001,-001,-001,-001,-001,-001,-001,-001,-001,-001,-001,-001,-001,-001,-001,-001,-001,-001],
	[-001,-001,-001,-001,-001,-001,-001,-001,-001,-001,-001,-001,-001,-001,-001,-001,-001,-001,-001,-001,-001],
	[-001,-001,-001,-001,-001,-001,-001,-001,-001,-001,-001,-001,-001,-001,-001,-001,-001,-001,-001,-001,-001],
	[-001,-001,-001,-001,-001,-001,-001,-001,-001,-001,-001,-001,-001,-001,-001,-001,-001,-001,-001,-001,-001],
	[-001,-001,-001,-001,-001,-001,-001,-001,-001,-001,-001,-001,-001,-001,-001,-001,-001,-001,-001,-001,-001],
	[-001,-001,-001,-001,-001,-001,-001,-001,-001,-001,-001,-001,-001,-001,-001,-001,-001,-001,-001,-001,-001]
	],
	"events": [
	{
		"id": 5,
		"nom": "Réglages initiaux",
		"x": 20,
		"y": 0,
		"pages": [
		{
			"conditions": [
			],
			"commandes": [
			{
				"nom": "EffacerImage",
				"numero": 9
			},
			{
				"nom": "ConditionInterrupteur",
				"numeroInterrupteur": 1,
				"valeurQuIlEstCenseAvoir": false,
				"numero": 0
			},
			{
				"nom": "ModifierVariable",
				"numeroVariable": 5,
				"operationAFaire": "rendre egal a",
				"valeurADonner": 10,
				"operationAFaire2": "valeur brute"
			},
			{
				"nom": "ModifierVariable",
				"numeroVariable": 4,
				"operationAFaire": "rendre egal a",
				"valeurADonner": 10,
				"operationAFaire2": "valeur brute"
			},
			{
				"nom": "AjouterArme",
				"idArme": 0
			},
			{
				"nom": "AjouterArme",
				"idArme": 1
			},
			{
				"nom": "AjouterArme",
				"idArme": 4
			},
			{
				"nom": "AjouterArme",
				"idArme": 5
			},
			{
				"nom": "ModifierInterrupteur",
				"numeroInterrupteur": 1,
				"valeur": true
			},
			{
				"nom": "AjouterObjet",
				"idObjet": 0,
				"variable": false,
				"quantite": 1
			},
			{
				"nom": "AjouterObjet",
				"idObjet": 2,
				"variable": false,
				"quantite": 1
			},
			{
				"nom": "AjouterObjet",
				"idObjet": 3,
				"variable": false,
				"quantite": 1
			},
			{
				"nom": "AjouterObjet",
				"idObjet": 4,
				"variable": false,
				"quantite": 1
			},
			{
				"nom": "AjouterGadget",
				"idGadget": 1
			},
			{
				"nom": "AjouterObjet",
				"idObjet": 30,
				"variable": false,
				"quantite": 20
			},
			{
				"nom": "AjouterGadget",
				"idGadget": 3
			},
			{
				"nom": "AjouterObjet",
				"idObjet": 31,
				"variable": false,
				"quantite": 1
			},
			{
				"nom": "AjouterGadget",
				"idGadget": 0
			},
			{
				"nom": "ConditionSinon",
				"numero": 0
			},
			{
				"nom": "ConditionFin",
				"numero": 0
			},
			{
				"nom": "Deplacement",
				"idEventADeplacer": 0,
				"ignorerLesMouvementsImpossibles": false,
				"repeterLeDeplacement": false,
				"attendreLaFinDuDeplacement": false,
				"mouvements": [
				{
					"nom": "ModifierApparence",
					"image": "Jiyounasu character",
					"direction": 0,
					"animation": 0,
					"teinte": 0
				},
				{
					"nom": "AppelerUneCommande",
					"nomCommande": "Attendre",
					"nombreDeFrames": 8
				},
				{
					"nom": "ModifierApparence",
					"image": "Jiyounasu character",
					"direction": 0,
					"animation": 0,
					"teinte": 0
				},
				{
					"nom": "RendreDirectionFixe",
					"directionFixe": false
				}
				]
			},
			{
				"nom": "EffacerImage",
				"numero": 3
			},
			{
				"nom": "SupprimerEvent"
			}
			],
			"vitesse": "tres rapide",
			"frequence": "la plus haute",
			"animeEnMouvement": false,
			"animeALArret": false,
			"directionFixe": false,
			"traversable": false,
			"auDessusDeTout": false
		}
		]
	},
	{
		"id": 6,
		"nom": "EV006",
		"x": 4,
		"y": 11,
		"pages": [
		{
			"conditions": [
			{
				"nom": "ArriveeAuContact"
			}
			],
			"commandes": [
			{
				"nom": "ChangerDeMap",
				"variable": false,
				"numeroNouvelleMap": 769,
				"xDebutHeros": 19,
				"yDebutHeros": 11
			}
			],
			"vitesse": "moderee",
			"frequence": "basse",
			"animeEnMouvement": true,
			"animeALArret": false,
			"directionFixe": false,
			"traversable": false,
			"auDessusDeTout": false
		}
		]
	},
	{
		"id": 1,
		"nom": "Clone[341][0021]",
		"x": 11,
		"y": 6
	},
	{
		"id": 7,
		"nom": "Clone[21][3]",
		"x": 12,
		"y": 10
	},
	{
		"id": 2,
		"nom": "Clone[341][001]",
		"x": 9,
		"y": 6
	},
	{
		"id": 8,
		"nom": "Clone[21][3]",
		"x": 11,
		"y": 12
	},
	{
		"id": 3,
		"nom": "Clone[341][001]",
		"x": 10,
		"y": 6
	},
	{
		"id": 4,
		"nom": "Clone[341][023]",
		"x": 7,
		"y": 5
	}
	]
}
