{
	"nom": "Spirale verte (héros)",
	"tileset": "Ventre",
	"largeur": 20,
	"hauteur": 15,
	"musique": {
		"nomFichierSonore": "Avale par la baleine.ogg",
		"volume": 0.80,
		"tempo": 1.00
	},
	"fondSonore": {
		"nomFichierSonore": "wahwah.ogg",
		"volume": 0.80,
		"tempo": 1.00
	},
	"couche0": [
	[0000,0000,0000,0000,0000,0000,0000,0000,0000,0000,0000,0000,0000,0000,0000,0000,0000,0000,0000,0000],
	[0000,0000,0000,0000,0000,0000,0000,0000,0000,0000,0000,0000,0000,0000,0000,0000,0000,0000,0000,0000],
	[0000,0000,0000,0000,0000,0000,0000,0000,0000,0000,0000,0000,0000,0000,0000,0000,0000,0000,0000,0000],
	[0000,0000,0000,0000,0000,0000,0000,0000,0000,0000,0000,0000,0000,0000,0000,0000,0000,0000,0000,0000],
	[0000,0000,0000,0000,0000,0000,0000,0000,0000,0000,0000,0000,0000,0000,0000,0000,0000,0000,0000,0000],
	[0000,0000,0000,0000,0000,0000,0000,0000,0000,0000,0000,0000,0000,0000,0000,0000,0000,0000,0000,0000],
	[0000,0000,0000,0000,0000,0000,0000,0000,0000,0008,0000,0000,0000,0000,0000,0000,0000,0000,0000,0000],
	[0000,0000,0000,0000,0000,0000,0000,0000,0008,0000,0008,0000,0000,0000,0000,0000,0000,0000,0000,0000],
	[0000,0000,0000,0000,0000,0000,0000,0000,0000,0008,0000,0000,0000,0000,0000,0000,0000,0000,0000,0000],
	[0000,0000,0000,0000,0000,0000,0000,0000,0000,0000,0000,0000,0000,0000,0000,0000,0000,0000,0000,0000],
	[0000,0000,0000,0000,0000,0000,0000,0000,0000,0000,0000,0000,0000,0000,0000,0000,0000,0000,0000,0000],
	[0000,0000,0000,0000,0000,0000,0000,0000,0000,0000,0000,0000,0000,0000,0000,0000,0000,0000,0000,0000],
	[0000,0000,0000,0000,0000,0000,0000,0000,0000,0000,0000,0000,0000,0000,0000,0000,0000,0000,0000,0000],
	[0000,0000,0000,0000,0000,0000,0000,0000,0000,0000,0000,0000,0000,0000,0000,0000,0000,0000,0000,0000],
	[0000,0000,0000,0000,0000,0000,0000,0000,0000,0000,0000,0000,0000,0000,0000,0000,0000,0000,0000,0000]
	],
	"couche1": [
	[-001,-001,-001,-001,-001,-001,-001,-001,-001,-001,-001,-001,-001,-001,-001,-001,-001,-001,-001,-001],
	[-001,-001,-001,-001,-001,-001,-001,-001,-001,-001,-001,-001,-001,-001,-001,-001,-001,-001,-001,-001],
	[-001,-001,-001,-001,-001,-001,-001,-001,-001,-001,-001,-001,-001,-001,-001,-001,-001,-001,-001,-001],
	[-001,-001,-001,-001,-001,-001,-001,-001,-001,-001,-001,-001,-001,-001,-001,-001,-001,-001,-001,-001],
	[-001,-001,-001,-001,-001,-001,-001,-001,-001,-001,-001,-001,-001,-001,-001,-001,-001,-001,-001,-001],
	[-001,-001,-001,-001,-001,-001,-001,-001,-001,-001,-001,-001,-001,-001,-001,-001,-001,-001,-001,-001],
	[-001,-001,-001,-001,-001,-001,-001,-001,-001,-001,-001,-001,-001,-001,-001,-001,-001,-001,-001,-001],
	[-001,-001,-001,-001,-001,-001,-001,-001,-001,-001,-001,-001,-001,-001,-001,-001,-001,-001,-001,-001],
	[-001,-001,-001,-001,-001,-001,-001,-001,-001,-001,-001,-001,-001,-001,-001,-001,-001,-001,-001,-001],
	[-001,-001,-001,-001,-001,-001,-001,-001,-001,-001,-001,-001,-001,-001,-001,-001,-001,-001,-001,-001],
	[-001,-001,-001,-001,-001,-001,-001,-001,-001,-001,-001,-001,-001,-001,-001,-001,-001,-001,-001,-001],
	[-001,-001,-001,-001,-001,-001,-001,-001,-001,-001,-001,-001,-001,-001,-001,-001,-001,-001,-001,-001],
	[-001,-001,-001,-001,-001,-001,-001,-001,-001,-001,-001,-001,-001,-001,-001,-001,-001,-001,-001,-001],
	[-001,-001,-001,-001,-001,-001,-001,-001,-001,-001,-001,-001,-001,-001,-001,-001,-001,-001,-001,-001],
	[-001,-001,-001,-001,-001,-001,-001,-001,-001,-001,-001,-001,-001,-001,-001,-001,-001,-001,-001,-001]
	],
	"couche2": [
	[-001,-001,-001,-001,-001,-001,-001,-001,-001,-001,-001,-001,-001,-001,-001,-001,-001,-001,-001,-001],
	[-001,-001,-001,-001,-001,-001,-001,-001,-001,-001,-001,-001,-001,-001,-001,-001,-001,-001,-001,-001],
	[-001,-001,-001,-001,-001,-001,-001,-001,-001,-001,-001,-001,-001,-001,-001,-001,-001,-001,-001,-001],
	[-001,-001,-001,-001,-001,-001,-001,-001,-001,-001,-001,-001,-001,-001,-001,-001,-001,-001,-001,-001],
	[-001,-001,-001,-001,-001,-001,-001,-001,-001,-001,-001,-001,-001,-001,-001,-001,-001,-001,-001,-001],
	[-001,-001,-001,-001,-001,-001,-001,-001,-001,-001,-001,-001,-001,-001,-001,-001,-001,-001,-001,-001],
	[-001,-001,-001,-001,-001,-001,-001,-001,-001,-001,-001,-001,-001,-001,-001,-001,-001,-001,-001,-001],
	[-001,-001,-001,-001,-001,-001,-001,-001,-001,-001,-001,-001,-001,-001,-001,-001,-001,-001,-001,-001],
	[-001,-001,-001,-001,-001,-001,-001,-001,-001,-001,-001,-001,-001,-001,-001,-001,-001,-001,-001,-001],
	[-001,-001,-001,-001,-001,-001,-001,-001,-001,-001,-001,-001,-001,-001,-001,-001,-001,-001,-001,-001],
	[-001,-001,-001,-001,-001,-001,-001,-001,-001,-001,-001,-001,-001,-001,-001,-001,-001,-001,-001,-001],
	[-001,-001,-001,-001,-001,-001,-001,-001,-001,-001,-001,-001,-001,-001,-001,-001,-001,-001,-001,-001],
	[-001,-001,-001,-001,-001,-001,-001,-001,-001,-001,-001,-001,-001,-001,-001,-001,-001,-001,-001,-001],
	[-001,-001,-001,-001,-001,-001,-001,-001,-001,-001,-001,-001,-001,-001,-001,-001,-001,-001,-001,-001],
	[-001,-001,-001,-001,-001,-001,-001,-001,-001,-001,-001,-001,-001,-001,-001,-001,-001,-001,-001,-001]
	],
	"events": [
	{
		"id": 1,
		"nom": "EV001",
		"x": 9,
		"y": 6,
		"pages": [
		{
			"conditions": [
			],
			"commandes": [
			{
				"nom": "AfficherImage",
				"numero": 11,
				"nomImage": "ecran noir",
				"centre": false,
				"variables": false,
				"x": 0,
				"y": 0,
				"zoomX": 100,
				"zoomY": 100,
				"opacite": 255,
				"modeDeFusion": "normal"
			},
			{
				"nom": "DeplacerImage",
				"numero": 11,
				"nombreDeFrames": 100,
				"centre": false,
				"variables": false,
				"x": 0,
				"y": 0,
				"zoomX": 100,
				"zoomY": 100,
				"opacite": 0,
				"modeDeFusion": "normal"
			},
			{
				"nom": "AfficherImage",
				"numero": 5,
				"nomImage": "spirale verte",
				"centre": true,
				"variables": false,
				"x": 320,
				"y": 240,
				"zoomX": 100,
				"zoomY": 100,
				"opacite": 255,
				"modeDeFusion": "normal"
			},
			{
				"nom": "DeplacerImage",
				"numero": 5,
				"angle": 5,
				"nombreDeFrames": 2,
				"repeterLeDeplacement": true
			},
			{
				"nom": "AfficherImage",
				"numero": 6,
				"nomImage": "kujira intro04 jiyo",
				"centre": true,
				"variables": false,
				"x": 320,
				"y": 240,
				"zoomX": 50,
				"zoomY": 50,
				"opacite": 255,
				"modeDeFusion": "normal"
			},
			{
				"nom": "DeplacerImage",
				"numero": 6,
				"nombreDeFrames": 450,
				"centre": true,
				"variables": false,
				"x": 320,
				"y": 240,
				"zoomX": 150,
				"zoomY": 150,
				"opacite": 255,
				"modeDeFusion": "normal"
			},
			{
				"nom": "DeplacerImage",
				"numero": 6,
				"angle": -1,
				"nombreDeFrames": 2,
				"repeterLeDeplacement": true
			},
			{
				"nom": "Attendre",
				"nombreDeFrames": 100
			},
			{
				"nom": "EffacerImage",
				"numero": 11
			},
			{
				"nom": "Attendre",
				"nombreDeFrames": 250
			},
			{
				"nom": "AfficherImage",
				"numero": 11,
				"nomImage": "ecran noir",
				"centre": false,
				"variables": false,
				"x": 0,
				"y": 0,
				"zoomX": 100,
				"zoomY": 100,
				"opacite": 0,
				"modeDeFusion": "normal"
			},
			{
				"nom": "DeplacerImage",
				"numero": 11,
				"nombreDeFrames": 100,
				"centre": false,
				"variables": false,
				"x": 0,
				"y": 0,
				"zoomX": 100,
				"zoomY": 100,
				"opacite": 255,
				"modeDeFusion": "normal"
			},
			{
				"nom": "Attendre",
				"nombreDeFrames": 100
			},
			{
				"nom": "EffacerImage",
				"numero": 5
			},
			{
				"nom": "EffacerImage",
				"numero": 6
			},
			{
				"nom": "Deplacement",
				"idEventADeplacer": 0,
				"ignorerLesMouvementsImpossibles": false,
				"repeterLeDeplacement": false,
				"attendreLaFinDuDeplacement": false,
				"mouvements": [
				{
					"nom": "ModifierOpacite",
					"opacite": 0
				},
				{
					"nom": "ModifierApparence",
					"image": "vide mais pas invisible",
					"direction": 0,
					"animation": 0,
					"teinte": 0
				}
				]
			},
			{
				"nom": "ChangerDeMap",
				"variable": false,
				"numeroNouvelleMap": 784,
				"directionDebutHeros": 3,
				"xDebutHeros": 19,
				"yDebutHeros": 29
			}
			],
			"vitesse": "moderee",
			"frequence": "basse",
			"figerLesAutresEvents": true,
			"animeEnMouvement": true,
			"animeALArret": false,
			"directionFixe": false,
			"traversable": false,
			"auDessusDeTout": false
		}
		]
	}
	]
}
