{
	"nom": "salle 1 (passerelle)",
	"tileset": "Sanctuaire de Jishin",
	"largeur": 21,
	"hauteur": 30,
	"musique": {
		"nomFichierSonore": "",
		"volume": 1.00,
		"tempo": 1.00
	},
	"fondSonore": {
		"nomFichierSonore": "",
		"volume": 0.80,
		"tempo": 1.00
	},
	"couche0": [
	[0140,0141,0197,0198,0199,0109,0108,0109,0108,0109,0108,0109,0108,0109,0108,0109,0108,0109,0108,0142,0143],
	[0148,0149,0205,0206,0207,0117,0116,0117,0116,0117,0116,0117,0116,0117,0116,0117,0116,0117,0116,0150,0151],
	[0118,0119,0175,0161,0161,0161,0161,0140,0141,0108,0109,0108,0142,0143,0161,0161,0161,0161,0161,0124,0125],
	[0156,0157,0126,0127,0130,0131,0161,0148,0149,0116,0117,0116,0150,0151,0161,0128,0129,0126,0127,0158,0159],
	[0164,0165,0134,0135,0138,0139,0161,0110,0111,0234,0162,0234,0132,0133,0161,0136,0137,0134,0135,0166,0167],
	[0162,0162,0162,0162,0118,0119,0161,0118,0119,0162,0162,0162,0124,0125,0161,0132,0133,0162,0162,0162,0162],
	[0162,0162,0162,0162,0118,0119,0161,0110,0111,0162,0162,0162,0132,0133,0161,0132,0133,0162,0162,0162,0162],
	[0162,0162,0162,0162,0118,0119,0161,0118,0119,0162,0162,0162,0124,0125,0161,0132,0133,0162,0162,0162,0162],
	[0162,0162,0162,0162,0118,0119,0161,0110,0111,0162,0162,0162,0132,0133,0161,0132,0133,0162,0162,0162,0162],
	[0162,0162,0162,0162,0118,0119,0161,0118,0119,0162,0162,0162,0124,0125,0161,0132,0133,0162,0162,0162,0162],
	[0162,0162,0162,0162,0110,0111,0161,0110,0111,0162,0162,0162,0132,0133,0161,0124,0125,0162,0162,0162,0162],
	[0162,0162,0162,0162,0118,0119,0161,0118,0119,0162,0162,0162,0124,0125,0161,0132,0133,0162,0162,0162,0162],
	[0162,0162,0162,0162,0110,0111,0161,0110,0111,0162,0162,0162,0132,0133,0161,0124,0125,0162,0162,0162,0162],
	[0162,0162,0162,0162,0118,0119,0161,0118,0119,0162,0162,0162,0124,0125,0161,0132,0133,0162,0162,0162,0162],
	[0162,0162,0162,0162,0110,0111,0161,0110,0111,0162,0162,0162,0132,0133,0161,0124,0125,0162,0162,0162,0162],
	[0162,0162,0162,0162,0118,0119,0161,0118,0119,0162,0162,0162,0124,0125,0161,0132,0133,0162,0162,0162,0162],
	[0162,0162,0162,0162,0110,0111,0161,0110,0111,0162,0162,0162,0132,0133,0161,0124,0125,0162,0162,0162,0162],
	[0162,0162,0162,0162,0110,0111,0161,0118,0119,0162,0162,0162,0124,0125,0161,0132,0133,0162,0162,0162,0162],
	[0162,0162,0162,0162,0118,0119,0161,0110,0111,0162,0162,0162,0132,0133,0161,0124,0125,0162,0162,0162,0162],
	[0162,0162,0162,0162,0110,0111,0161,0118,0119,0162,0162,0162,0124,0125,0161,0132,0133,0162,0162,0162,0162],
	[0162,0162,0162,0162,0118,0119,0161,0110,0111,0162,0162,0162,0132,0133,0161,0124,0125,0162,0162,0162,0162],
	[0162,0162,0162,0162,0110,0111,0161,0118,0119,0162,0162,0162,0124,0125,0161,0132,0133,0162,0162,0162,0162],
	[0162,0162,0162,0162,0118,0119,0161,0110,0111,0162,0162,0162,0132,0133,0161,0124,0125,0162,0162,0162,0162],
	[0162,0162,0162,0162,0110,0111,0161,0118,0119,0162,0162,0162,0124,0125,0161,0132,0133,0162,0162,0162,0162],
	[0162,0162,0162,0162,0118,0119,0161,0110,0111,0162,0162,0162,0132,0133,0161,0124,0125,0162,0162,0162,0162],
	[0162,0162,0162,0162,0110,0111,0161,0118,0119,0162,0162,0162,0124,0125,0161,0132,0133,0162,0162,0162,0162],
	[0162,0162,0162,0162,0118,0119,0161,0156,0157,0127,0126,0127,0158,0159,0161,0124,0125,0162,0162,0162,0162],
	[0162,0162,0162,0162,0110,0111,0161,0164,0165,0135,0134,0135,0166,0167,0161,0132,0133,0162,0162,0162,0162],
	[0162,0162,0162,0162,0156,0157,0126,0127,0127,0126,0160,0127,0126,0127,0126,0158,0159,0162,0162,0162,0162],
	[0162,0162,0162,0162,0164,0165,0134,0135,0135,0134,0160,0135,0134,0135,0134,0166,0167,0162,0162,0162,0162]
	],
	"couche1": [
	[-001,-001,-001,-001,-001,-001,-001,-001,-001,-001,-005,-001,-001,-001,-001,-001,-001,-001,-001,-001,-001],
	[-001,-001,-001,-001,-001,-001,-001,-001,-001,-001,-005,-001,-001,-001,-001,-001,-001,-001,-001,-001,-001],
	[-001,-001,-001,-001,-001,-001,-001,-001,-001,-001,0043,-001,-001,-001,-001,-001,-001,-001,-001,-001,-001],
	[-001,-001,-001,-001,-001,-001,-001,-001,-001,-001,0043,-001,-001,-001,-001,-001,-001,-001,-001,-001,-001],
	[-001,-001,-001,-001,-001,-001,-001,-001,-001,-001,0043,-001,-001,-001,-001,-001,-001,-001,-001,-001,-001],
	[-001,-001,-001,-001,-001,-001,-001,-001,-001,-001,0043,-001,-001,-001,-001,-001,-001,-001,-001,-001,-001],
	[-001,-001,-001,-001,-001,-001,-001,-001,-001,-001,0043,-001,-001,-001,-001,-001,-001,-001,-001,-001,-001],
	[-001,-001,-001,-001,-001,-001,-001,-001,-001,-001,0043,-001,-001,-001,-001,-001,-001,-001,-001,-001,-001],
	[-001,-001,-001,-001,-001,-001,-001,-001,-001,-001,0043,-001,-001,-001,-001,-001,-001,-001,-001,-001,-001],
	[-001,-001,-001,-001,-001,-001,-001,-001,-001,-001,0043,-001,-001,-001,-001,-001,-001,-001,-001,-001,-001],
	[-001,-001,-001,-001,-001,-001,-001,-001,-001,-001,0043,-001,-001,-001,-001,-001,-001,-001,-001,-001,-001],
	[-001,-001,-001,-001,-001,-001,-001,-001,-001,-001,0043,-001,-001,-001,-001,-001,-001,-001,-001,-001,-001],
	[-001,-001,-001,-001,-001,-001,-001,-001,-001,-001,0043,-001,-001,-001,-001,-001,-001,-001,-001,-001,-001],
	[-001,-001,-001,-001,-001,-001,-001,-001,-001,-001,0043,-001,-001,-001,-001,-001,-001,-001,-001,-001,-001],
	[-001,-001,-001,-001,-001,-001,-001,-001,-001,-001,0043,-001,-001,-001,-001,-001,-001,-001,-001,-001,-001],
	[-001,-001,-001,-001,-001,-001,-001,-001,-001,-001,0043,-001,-001,-001,-001,-001,-001,-001,-001,-001,-001],
	[-001,-001,-001,-001,-001,-001,-001,-001,-001,-001,0043,-001,-001,-001,-001,-001,-001,-001,-001,-001,-001],
	[-001,-001,-001,-001,-001,-001,-001,-001,-001,-001,0043,-001,-001,-001,-001,-001,-001,-001,-001,-001,-001],
	[-001,-001,-001,-001,-001,-001,-001,-001,-001,-001,0043,-001,-001,-001,-001,-001,-001,-001,-001,-001,-001],
	[-001,-001,-001,-001,-001,-001,-001,-001,-001,-001,0043,-001,-001,-001,-001,-001,-001,-001,-001,-001,-001],
	[-001,-001,-001,-001,-001,-001,-001,-001,-001,-001,0043,-001,-001,-001,-001,-001,-001,-001,-001,-001,-001],
	[-001,-001,-001,-001,-001,-001,-001,-001,-001,-001,0043,-001,-001,-001,-001,-001,-001,-001,-001,-001,-001],
	[-001,-001,-001,-001,-001,-001,-001,-001,-001,-001,0043,-001,-001,-001,-001,-001,-001,-001,-001,-001,-001],
	[-001,-001,-001,-001,-001,-001,-001,-001,-001,-001,0043,-001,-001,-001,-001,-001,-001,-001,-001,-001,-001],
	[-001,-001,-001,-001,-001,-001,-001,-001,-001,-001,0043,-001,-001,-001,-001,-001,-001,-001,-001,-001,-001],
	[-001,-001,-001,-001,-001,-001,-001,-001,-001,-001,0043,-001,-001,-001,-001,-001,-001,-001,-001,-001,-001],
	[-001,-001,-001,-001,-001,-001,-001,-001,-001,-001,0043,-001,-001,-001,-001,-001,-001,-001,-001,-001,-001],
	[-001,-001,-001,-001,-001,-001,-001,-001,-001,-001,0043,-001,-001,-001,-001,-001,-001,-001,-001,-001,-001],
	[-001,-001,-001,-001,-001,-001,-001,-001,-001,0184,0185,0186,-001,-001,-001,-001,-001,-001,-001,-001,-001],
	[-001,-001,-001,-001,-001,-001,-001,-001,-001,0192,0193,0194,-001,-001,-001,-001,-001,-001,-001,-001,-001]
	],
	"couche2": [
	[-001,-001,-001,-001,-001,-001,-001,-001,-001,-001,-001,-001,-001,-001,-001,-001,-001,-001,-001,-001,-001],
	[-001,-001,-001,-001,-001,-001,-001,-001,-001,-001,-001,-001,-001,-001,-001,-001,-001,-001,-001,-001,-001],
	[-001,-001,-001,-001,-001,-001,-001,-001,-001,-001,-001,-001,-001,-001,-001,-001,-001,-001,-001,-001,-001],
	[-001,-001,-001,-001,-001,-001,-001,-001,-001,-001,-001,-001,-001,-001,-001,-001,-001,-001,-001,-001,-001],
	[-001,-001,-001,-001,-001,-001,-001,-001,-001,-001,-001,-001,-001,-001,-001,-001,-001,-001,-001,-001,-001],
	[-001,-001,-001,-001,-001,-001,-001,-001,-001,-001,-001,-001,-001,-001,-001,-001,-001,-001,-001,-001,-001],
	[-001,-001,-001,-001,-001,-001,-001,-001,-001,-001,-001,-001,-001,-001,-001,-001,-001,-001,-001,-001,-001],
	[-001,-001,-001,-001,-001,-001,-001,-001,-001,-001,-001,-001,-001,-001,-001,-001,-001,-001,-001,-001,-001],
	[-001,-001,-001,-001,-001,-001,-001,-001,-001,-001,-001,-001,-001,-001,-001,-001,-001,-001,-001,-001,-001],
	[-001,-001,-001,-001,-001,-001,-001,-001,-001,-001,-001,-001,-001,-001,-001,-001,-001,-001,-001,-001,-001],
	[-001,-001,-001,-001,-001,-001,-001,-001,-001,-001,-001,-001,-001,-001,-001,-001,-001,-001,-001,-001,-001],
	[-001,-001,-001,-001,-001,-001,-001,-001,-001,-001,-001,-001,-001,-001,-001,-001,-001,-001,-001,-001,-001],
	[-001,-001,-001,-001,-001,-001,-001,-001,-001,-001,-001,-001,-001,-001,-001,-001,-001,-001,-001,-001,-001],
	[-001,-001,-001,-001,-001,-001,-001,-001,-001,-001,-001,-001,-001,-001,-001,-001,-001,-001,-001,-001,-001],
	[-001,-001,-001,-001,-001,-001,-001,-001,-001,-001,-001,-001,-001,-001,-001,-001,-001,-001,-001,-001,-001],
	[-001,-001,-001,-001,-001,-001,-001,-001,-001,-001,-001,-001,-001,-001,-001,-001,-001,-001,-001,-001,-001],
	[-001,-001,-001,-001,-001,-001,-001,-001,-001,-001,-001,-001,-001,-001,-001,-001,-001,-001,-001,-001,-001],
	[-001,-001,-001,-001,-001,-001,-001,-001,-001,-001,-001,-001,-001,-001,-001,-001,-001,-001,-001,-001,-001],
	[-001,-001,-001,-001,-001,-001,-001,-001,-001,-001,-001,-001,-001,-001,-001,-001,-001,-001,-001,-001,-001],
	[-001,-001,-001,-001,-001,-001,-001,-001,-001,-001,-001,-001,-001,-001,-001,-001,-001,-001,-001,-001,-001],
	[-001,-001,-001,-001,-001,-001,-001,-001,-001,-001,-001,-001,-001,-001,-001,-001,-001,-001,-001,-001,-001],
	[-001,-001,-001,-001,-001,-001,-001,-001,-001,-001,-001,-001,-001,-001,-001,-001,-001,-001,-001,-001,-001],
	[-001,-001,-001,-001,-001,-001,-001,-001,-001,-001,-001,-001,-001,-001,-001,-001,-001,-001,-001,-001,-001],
	[-001,-001,-001,-001,-001,-001,-001,-001,-001,-001,-001,-001,-001,-001,-001,-001,-001,-001,-001,-001,-001],
	[-001,-001,-001,-001,-001,-001,-001,-001,-001,-001,-001,-001,-001,-001,-001,-001,-001,-001,-001,-001,-001],
	[-001,-001,-001,-001,-001,-001,-001,-001,-001,-001,-001,-001,-001,-001,-001,-001,-001,-001,-001,-001,-001],
	[-001,-001,-001,-001,-001,-001,-001,-001,-001,-001,-001,-001,-001,-001,-001,-001,-001,-001,-001,-001,-001],
	[-001,-001,-001,-001,-001,-001,-001,-001,-001,-001,-001,-001,-001,-001,-001,-001,-001,-001,-001,-001,-001],
	[-001,-001,-001,-001,-001,-001,-001,-001,-001,-001,-001,-001,-001,-001,-001,-001,-001,-001,-001,-001,-001],
	[-001,-001,-001,-001,-001,-001,-001,-001,-001,-001,-001,-001,-001,-001,-001,-001,-001,-001,-001,-001,-001]
	],
	"events": [
	{
		"id": 5,
		"nom": "Clone[446][2]",
		"x": 6,
		"y": 3
	},
	{
		"id": 11,
		"nom": "porte",
		"x": 3,
		"y": 1,
		"pages": [
		{
			"conditions": [
			{
				"nom": "Parler"
			}
			],
			"commandes": [
			],
			"image": "mur casse character",
			"vitesse": "moderee",
			"frequence": "basse",
			"animeEnMouvement": false,
			"animeALArret": false,
			"directionFixe": true,
			"traversable": true,
			"auDessusDeTout": true
		}
		]
	},
	{
		"id": 6,
		"nom": "EV006",
		"x": 10,
		"y": 29,
		"pages": [
		{
			"conditions": [
			{
				"nom": "ArriveeAuContact"
			}
			],
			"commandes": [
			{
				"nom": "ChangerDeMap",
				"variable": false,
				"numeroNouvelleMap": 800,
				"xDebutHeros": 10,
				"yDebutHeros": 1
			}
			],
			"vitesse": "moderee",
			"frequence": "basse",
			"animeEnMouvement": true,
			"animeALArret": false,
			"directionFixe": false,
			"traversable": false,
			"auDessusDeTout": false
		}
		]
	},
	{
		"id": 1,
		"nom": "Clone[446][2]",
		"x": 6,
		"y": 24
	},
	{
		"id": 7,
		"nom": "blocage",
		"x": 10,
		"y": 2,
		"pages": [
		{
			"conditions": [
			],
			"commandes": [
			{
				"nom": "ConditionVariable",
				"numeroVariable": 137,
				"inegalite": ">=",
				"valeurQuIlEstCenseAvoir": 5,
				"comparerAUneAutreVariable": false,
				"numero": 0
			},
			{
				"nom": "Deplacement",
				"ignorerLesMouvementsImpossibles": false,
				"repeterLeDeplacement": false,
				"attendreLaFinDuDeplacement": false,
				"mouvements": [
				{
					"nom": "ModifierApparence",
					"image": "rocher gris character",
					"direction": 3,
					"animation": 0,
					"teinte": 0
				},
				{
					"nom": "AppelerUneCommande",
					"nomCommande": "Attendre",
					"nombreDeFrames": 1
				},
				{
					"nom": "ModifierApparence",
					"image": "rocher gris character",
					"direction": 3,
					"animation": 1,
					"teinte": 0
				},
				{
					"nom": "AppelerUneCommande",
					"nomCommande": "Attendre",
					"nombreDeFrames": 1
				},
				{
					"nom": "ModifierApparence",
					"image": "rocher gris character",
					"direction": 3,
					"animation": 2,
					"teinte": 0
				},
				{
					"nom": "AppelerUneCommande",
					"nomCommande": "Attendre",
					"nombreDeFrames": 1
				},
				{
					"nom": "ModifierApparence",
					"image": "rocher gris character",
					"direction": 3,
					"animation": 3,
					"teinte": 0
				}
				]
			},
			{
				"nom": "AppelerUnScript",
				"script": "wait_for_event(@event_id)"
			},
			{
				"nom": "JouerEffetMusical",
				"nomFichierSonore": "Fanfare (paquerette).ogg",
				"volume": 1.00,
				"tempo": 1.00
			},
			{
				"nom": "ModifierInterrupteurLocal",
				"numeroInterrupteurLocal": 0,
				"valeurADonner": true
			},
			{
				"nom": "ConditionFin",
				"numero": 0
			}
			],
			"image": "rocher gris character",
			"directionInitiale": 2,
			"vitesse": "moderee",
			"frequence": "basse",
			"animeEnMouvement": false,
			"animeALArret": false,
			"directionFixe": true,
			"traversable": false,
			"auDessusDeTout": false
		},
		{
			"conditions": [
			{
				"nom": "InterrupteurLocal",
				"numeroEvent": 7,
				"numeroInterrupteurLocal": 0,
				"valeurQuIlEstCenseAvoir": true
			}
			],
			"commandes": [
			{
				"nom": "SupprimerEvent"
			}
			],
			"vitesse": "moderee",
			"frequence": "basse",
			"animeEnMouvement": false,
			"animeALArret": false,
			"directionFixe": false,
			"traversable": true,
			"auDessusDeTout": false
		}
		]
	},
	{
		"id": 2,
		"nom": "Clone[446][2]",
		"x": 14,
		"y": 17
	},
	{
		"id": 8,
		"nom": "EV008",
		"x": 10,
		"y": 0,
		"pages": [
		{
			"conditions": [
			{
				"nom": "ArriveeAuContact"
			}
			],
			"commandes": [
			{
				"nom": "ChangerDeMap",
				"variable": false,
				"numeroNouvelleMap": 802,
				"xDebutHeros": 10,
				"yDebutHeros": 13
			}
			],
			"vitesse": "moderee",
			"frequence": "basse",
			"animeEnMouvement": true,
			"animeALArret": false,
			"directionFixe": false,
			"traversable": false,
			"auDessusDeTout": false
		}
		]
	},
	{
		"id": 3,
		"nom": "Clone[446][2]",
		"x": 6,
		"y": 12
	},
	{
		"id": 9,
		"nom": "EV009",
		"x": 3,
		"y": 0,
		"pages": [
		{
			"conditions": [
			{
				"nom": "ArriveeAuContact"
			}
			],
			"commandes": [
			{
				"nom": "ChangerDeMap",
				"variable": false,
				"numeroNouvelleMap": 802,
				"xDebutHeros": 3,
				"yDebutHeros": 13
			}
			],
			"vitesse": "moderee",
			"frequence": "basse",
			"animeEnMouvement": false,
			"animeALArret": false,
			"directionFixe": false,
			"traversable": true,
			"auDessusDeTout": false
		}
		]
	},
	{
		"id": 4,
		"nom": "Clone[446][2]",
		"x": 14,
		"y": 6
	},
	{
		"id": 10,
		"nom": "Clone[582][51]",
		"x": 5,
		"y": 27
	}
	]
}
